사용일자	호선명	역명	승차총승객수	하차총승객수	등록일자	승하차
20180119	2호선	강남	132511	136530	20180122	269041
20180112	2호선	강남	126847	128961	20180115	255808
20180117	2호선	강남	126236	124712	20180120	250948
20180118	2호선	강남	125701	124847	20180121	250548
20180126	2호선	강남	122901	124864	20180129	247765
20180212	2호선	강남	124090	122638	20180215	246728
20180115	2호선	강남	123197	121702	20180118	244899
20180201	2호선	강남	122868	122015	20180204	244883
20180207	2호선	강남	122977	121561	20180210	244538
20180208	2호선	강남	122226	121312	20180211	243538
20180206	2호선	강남	121007	119053	20180209	240060
20180122	2호선	강남	120786	118306	20180125	239092
20180123	2호선	강남	120455	118347	20180126	238802
20180131	2호선	강남	118418	117626	20180203	236044
20180125	2호선	강남	118124	116139	20180128	234263
20180130	2호선	강남	118692	114779	20180202	233471
20180205	2호선	강남	117603	115861	20180208	233464
20180124	2호선	강남	117879	115528	20180127	233407
20180129	2호선	강남	114995	113903	20180201	228898
20180120	2호선	홍대입구	95697	110514	20180123	206211
20180120	2호선	강남	97764	102876	20180123	200640
20180113	2호선	홍대입구	92958	107530	20180116	200488
20180203	2호선	홍대입구	93158	104744	20180206	197902
20180119	2호선	잠실(송파구청)	100251	94251	20180122	194502
20180113	2호선	강남	94095	99468	20180116	193563
20180203	2호선	강남	94467	97848	20180206	192315
20180118	2호선	잠실(송파구청)	96531	91632	20180121	188163
20180127	2호선	강남	90296	94262	20180130	184558
20180112	2호선	잠실(송파구청)	94960	89334	20180115	184294
20180117	2호선	잠실(송파구청)	94059	88997	20180120	183056
20180126	2호선	잠실(송파구청)	93995	88377	20180129	182372
20180130	2호선	잠실(송파구청)	93843	88506	20180202	182349
20180212	2호선	잠실(송파구청)	93256	88853	20180215	182109
20180119	2호선	홍대입구	84138	97476	20180122	181614
20180131	2호선	잠실(송파구청)	92705	88551	20180203	181256
20180127	2호선	홍대입구	84673	96204	20180130	180877
20180208	2호선	잠실(송파구청)	93263	87470	20180211	180733
20180201	2호선	잠실(송파구청)	92319	87072	20180204	179391
20180115	2호선	잠실(송파구청)	90730	86579	20180118	177309
20180207	2호선	잠실(송파구청)	90128	85571	20180210	175699
20180120	2호선	잠실(송파구청)	90831	84820	20180123	175651
20180123	2호선	잠실(송파구청)	90177	85030	20180126	175207
20180122	2호선	잠실(송파구청)	89884	84924	20180125	174808
20180206	2호선	잠실(송파구청)	89842	84738	20180209	174580
20180125	2호선	잠실(송파구청)	89626	84835	20180128	174461
20180129	2호선	잠실(송파구청)	88303	84425	20180201	172728
20180124	2호선	잠실(송파구청)	87934	83277	20180127	171211
20180113	2호선	잠실(송파구청)	87684	81824	20180116	169508
20180203	2호선	잠실(송파구청)	87449	81812	20180206	169261
20180205	2호선	잠실(송파구청)	86329	81762	20180208	168091
20180112	2호선	홍대입구	77700	88525	20180115	166225
20180127	2호선	잠실(송파구청)	85401	79007	20180130	164408
20180208	2호선	홍대입구	77794	83113	20180211	160907
20180201	2호선	홍대입구	78096	82259	20180204	160355
20180118	2호선	홍대입구	77787	81821	20180121	159608
20180126	2호선	홍대입구	74600	84223	20180129	158823
20180119	2호선	신림	79422	78918	20180122	158340
20180117	2호선	홍대입구	76594	81352	20180120	157946
20180212	2호선	홍대입구	77694	80216	20180215	157910
20180131	2호선	홍대입구	76006	79770	20180203	155776
20180207	2호선	홍대입구	74996	79151	20180210	154147
20180119	2호선	구로디지털단지	76902	76764	20180122	153666
20180117	2호선	신림	77335	76225	20180120	153560
20180211	2호선	홍대입구	77518	74614	20180214	152132
20180118	2호선	신림	76311	75469	20180121	151780
20180208	2호선	신림	76092	75039	20180211	151131
20180131	2호선	신림	76014	74775	20180203	150789
20180115	2호선	홍대입구	74022	76706	20180118	150728
20180117	2호선	구로디지털단지	75046	75313	20180120	150359
20180130	2호선	홍대입구	73382	76739	20180202	150121
20180207	2호선	신림	75315	74329	20180210	149644
20180112	2호선	신림	75219	74284	20180115	149503
20180118	2호선	구로디지털단지	74731	74732	20180121	149463
20180131	2호선	구로디지털단지	74454	75007	20180203	149461
20180201	2호선	신림	75420	73908	20180204	149328
20180130	2호선	신림	74194	75112	20180202	149306
20180212	2호선	신림	74912	73874	20180215	148786
20180115	2호선	신림	74551	73500	20180118	148051
20180208	2호선	구로디지털단지	73851	73885	20180211	147736
20180201	2호선	구로디지털단지	73952	73667	20180204	147619
20180130	2호선	구로디지털단지	73912	73585	20180202	147497
20180131	2호선	삼성(무역센터)	72557	74716	20180203	147273
20180212	2호선	구로디지털단지	73862	73381	20180215	147243
20180126	2호선	신림	73760	73356	20180129	147116
20180122	2호선	신림	73559	72828	20180125	146387
20180115	2호선	구로디지털단지	73204	73030	20180118	146234
20180207	2호선	구로디지털단지	72953	73209	20180210	146162
20180121	2호선	홍대입구	74298	71397	20180124	145695
20180206	2호선	신림	73145	72423	20180209	145568
20180203	3호선	고속터미널	74829	70415	20180206	145244
20180205	2호선	신림	72894	72154	20180208	145048
20180206	2호선	홍대입구	71273	73771	20180209	145044
20180114	2호선	홍대입구	73301	71718	20180117	145019
20180122	2호선	구로디지털단지	72369	72464	20180125	144833
20180129	2호선	홍대입구	71222	72976	20180201	144198
20180123	2호선	신림	72199	71475	20180126	143674
20180119	2호선	삼성(무역센터)	71135	72453	20180122	143588
20180122	2호선	홍대입구	70714	72570	20180125	143284
20180129	2호선	신림	72198	71050	20180201	143248
20180112	2호선	구로디지털단지	71539	71688	20180115	143227
20180120	3호선	고속터미널	73033	70191	20180123	143224
20180205	2호선	구로디지털단지	71556	71359	20180208	142915
20180206	2호선	구로디지털단지	71459	71444	20180209	142903
20180123	2호선	홍대입구	70032	72837	20180126	142869
20180201	2호선	삼성(무역센터)	70577	71999	20180204	142576
20180125	2호선	신림	71519	70806	20180128	142325
20180125	2호선	홍대입구	69345	72629	20180128	141974
20180123	2호선	구로디지털단지	70851	71117	20180126	141968
20180205	2호선	홍대입구	69840	72073	20180208	141913
20180113	3호선	고속터미널	72013	69502	20180116	141515
20180124	2호선	신림	71131	70288	20180127	141419
20180129	2호선	구로디지털단지	70503	70738	20180201	141241
20180126	2호선	구로디지털단지	70764	70424	20180129	141188
20180118	2호선	삼성(무역센터)	68910	70893	20180121	139803
20180125	2호선	구로디지털단지	69348	69418	20180128	138766
20180126	2호선	삼성(무역센터)	68709	69494	20180129	138203
20180124	2호선	구로디지털단지	68919	69284	20180127	138203
20180130	2호선	삼성(무역센터)	70226	67704	20180202	137930
20180128	2호선	홍대입구	70158	67286	20180131	137444
20180208	2호선	삼성(무역센터)	67680	69742	20180211	137422
20180124	2호선	홍대입구	67418	69992	20180127	137410
20180127	3호선	고속터미널	69301	66145	20180130	135446
20180112	2호선	삼성(무역센터)	66854	68340	20180115	135194
20180204	2호선	홍대입구	68951	66144	20180207	135095
20180119	2호선	신도림	66776	66683	20180122	133459
20180125	2호선	삼성(무역센터)	65911	67251	20180128	133162
20180130	2호선	역삼	65233	67101	20180202	132334
20180117	2호선	삼성(무역센터)	65316	66794	20180120	132110
20180207	2호선	삼성(무역센터)	65405	66646	20180210	132051
20180130	2호선	선릉	72099	59587	20180202	131686
20180207	2호선	역삼	63062	68449	20180210	131511
20180119	3호선	고속터미널	66001	65431	20180122	131432
20180212	2호선	선릉	70710	60441	20180215	131151
20180117	2호선	선릉	70431	60472	20180120	130903
20180131	2호선	역삼	62122	68536	20180203	130658
20180117	2호선	역삼	62453	68118	20180120	130571
20180131	2호선	선릉	70167	60400	20180203	130567
20180119	2호선	선릉	70000	60289	20180122	130289
20180206	2호선	역삼	62787	67327	20180209	130114
20180118	2호선	선릉	69847	60243	20180121	130090
20180119	2호선	역삼	61761	68283	20180122	130044
20180201	2호선	신도림	65470	64455	20180204	129925
20180120	2호선	신림	65529	64354	20180123	129883
20180115	2호선	선릉	69902	59908	20180118	129810
20180208	2호선	역삼	61676	67879	20180211	129555
20180115	2호선	역삼	61779	67580	20180118	129359
20180201	2호선	선릉	69617	59626	20180204	129243
20180118	2호선	신도림	65103	64107	20180121	129210
20180208	2호선	선릉	69559	59624	20180211	129183
20180207	2호선	선릉	69647	59387	20180210	129034
20180117	2호선	신도림	65010	63930	20180120	128940
20180123	2호선	역삼	62149	66767	20180126	128916
20180123	2호선	삼성(무역센터)	63508	65094	20180126	128602
20180212	2호선	삼성(무역센터)	63354	65077	20180215	128431
20180208	2호선	신도림	64763	63661	20180211	128424
20180122	2호선	선릉	69069	59316	20180125	128385
20180124	2호선	삼성(무역센터)	63709	64609	20180127	128318
20180113	2호선	신림	64562	63620	20180116	128182
20180118	2호선	역삼	60951	67045	20180121	127996
20180212	2호선	역삼	61197	66495	20180215	127692
20180121	2호선	잠실(송파구청)	66500	61173	20180124	127673
20180112	2호선	신도림	63962	63654	20180115	127616
20180129	2호선	삼성(무역센터)	62890	64501	20180201	127391
20180206	2호선	삼성(무역센터)	62853	64414	20180209	127267
20180203	2호선	신림	63807	63330	20180206	127137
20180122	2호선	역삼	61372	65738	20180125	127110
20180206	2호선	선릉	68475	58534	20180209	127009
20180115	2호선	삼성(무역센터)	62230	64313	20180118	126543
20180123	2호선	선릉	67735	58742	20180126	126477
20180131	2호선	신도림	64068	62227	20180203	126295
20180114	2호선	잠실(송파구청)	65850	60437	20180117	126287
20180205	2호선	선릉	67682	58592	20180208	126274
20180201	2호선	역삼	60145	65971	20180204	126116
20180122	2호선	삼성(무역센터)	62446	63546	20180125	125992
20180130	2호선	신도림	63349	62497	20180202	125846
20180205	2호선	역삼	60194	65255	20180208	125449
20180129	2호선	선릉	67282	58165	20180201	125447
20180207	2호선	신도림	63139	62224	20180210	125363
20180124	2호선	역삼	60640	64638	20180127	125278
20180125	2호선	역삼	60396	64594	20180128	124990
20180119	1호선	서울역	63754	60667	20180122	124421
20180126	3호선	고속터미널	62572	61828	20180129	124400
20180212	2호선	신도림	62895	61490	20180215	124385
20180115	2호선	신도림	62782	61350	20180118	124132
20180125	2호선	선릉	66847	57210	20180128	124057
20180205	2호선	삼성(무역센터)	61200	62833	20180208	124033
20180129	2호선	역삼	59434	64385	20180201	123819
20180126	2호선	선릉	66756	56878	20180129	123634
20180112	3호선	고속터미널	62396	61014	20180115	123410
20180126	2호선	신도림	61633	61332	20180129	122965
20180112	2호선	선릉	66123	56788	20180115	122911
20180124	2호선	선릉	65838	56943	20180127	122781
20180112	2호선	역삼	58857	63846	20180115	122703
20180126	2호선	역삼	58444	63642	20180129	122086
20180113	2호선	신도림	60691	61081	20180116	121772
20180203	2호선	신도림	60425	61032	20180206	121457
20180206	2호선	신도림	61222	60146	20180209	121368
20180122	2호선	신도림	61336	59632	20180125	120968
20180128	2호선	잠실(송파구청)	62918	57897	20180131	120815
20180211	2호선	잠실(송파구청)	62900	57592	20180214	120492
20180120	2호선	신도림	59863	60326	20180123	120189
20180127	2호선	신림	60828	59258	20180130	120086
20180123	2호선	신도림	60536	58942	20180126	119478
20180205	2호선	신도림	60480	58982	20180208	119462
20180125	2호선	신도림	60379	58995	20180128	119374
20180119	2호선	서울대입구(관악구청)	60685	57876	20180122	118561
20180113	경부선	영등포	57396	61000	20180116	118396
20180212	3호선	고속터미널	59765	58393	20180215	118158
20180129	2호선	신도림	59648	58058	20180201	117706
20180112	1호선	서울역	60507	57114	20180115	117621
20180120	경부선	영등포	56506	60756	20180123	117262
20180204	2호선	잠실(송파구청)	61076	55923	20180207	116999
20180124	2호선	신도림	58641	57418	20180127	116059
20180119	2호선	을지로입구	58198	57524	20180122	115722
20180126	1호선	서울역	58952	56299	20180129	115251
20180117	2호선	서울대입구(관악구청)	58390	56784	20180120	115174
20180130	2호선	을지로입구	58714	56001	20180202	114715
20180212	1호선	서울역	57630	56930	20180215	114560
20180208	2호선	서울대입구(관악구청)	57521	56191	20180211	113712
20180131	2호선	을지로입구	56680	56917	20180203	113597
20180118	2호선	서울대입구(관악구청)	57613	55599	20180121	113212
20180203	경부선	영등포	54885	58310	20180206	113195
20180201	2호선	을지로입구	56679	56472	20180204	113151
20180208	2호선	을지로입구	56398	56477	20180211	112875
20180118	2호선	을지로입구	56510	56321	20180121	112831
20180115	2호선	서울대입구(관악구청)	57053	55744	20180118	112797
20180212	2호선	서울대입구(관악구청)	57326	55447	20180215	112773
20180201	2호선	서울대입구(관악구청)	57285	55331	20180204	112616
20180207	2호선	을지로입구	56653	55960	20180210	112613
20180208	3호선	고속터미널	58039	54541	20180211	112580
20180117	2호선	을지로입구	56156	56202	20180120	112358
20180207	2호선	서울대입구(관악구청)	56646	55491	20180210	112137
20180131	2호선	서울대입구(관악구청)	56958	55133	20180203	112091
20180114	2호선	강남	56469	55592	20180117	112061
20180130	2호선	서울대입구(관악구청)	56325	55378	20180202	111703
20180118	1호선	서울역	56955	54677	20180121	111632
20180127	2호선	신도림	55676	55856	20180130	111532
20180112	2호선	을지로입구	55733	55746	20180115	111479
20180119	경부선	영등포	53330	58067	20180122	111397
20180112	2호선	서울대입구(관악구청)	57037	54243	20180115	111280
20180208	1호선	서울역	56825	54453	20180211	111278
20180121	2호선	강남	56352	54868	20180124	111220
20180211	2호선	강남	56538	54554	20180214	111092
20180212	2호선	을지로입구	55505	55578	20180215	111083
20180115	1호선	서울역	56046	54758	20180118	110804
20180122	2호선	서울대입구(관악구청)	56035	54680	20180125	110715
20180122	1호선	서울역	56266	54430	20180125	110696
20180126	2호선	을지로입구	55047	55098	20180129	110145
20180119	1호선	종각	55585	54527	20180122	110112
20180117	1호선	서울역	56290	53691	20180120	109981
20180114	3호선	고속터미널	56057	53741	20180117	109798
20180118	3호선	고속터미널	56359	53321	20180121	109680
20180119	2호선	신촌	53270	56298	20180122	109568
20180206	2호선	서울대입구(관악구청)	55433	53886	20180209	109319
20180121	3호선	고속터미널	55503	53767	20180124	109270
20180206	2호선	을지로입구	54429	54764	20180209	109193
20180207	3호선	고속터미널	56242	52846	20180210	109088
20180128	2호선	강남	54836	54083	20180131	108919
20180127	경부선	영등포	52657	56161	20180130	108818
20180126	2호선	서울대입구(관악구청)	55382	53100	20180129	108482
20180115	2호선	을지로입구	53925	54517	20180118	108442
20180130	1호선	서울역	55653	52614	20180202	108267
20180204	2호선	강남	55157	53099	20180207	108256
20180211	3호선	고속터미널	54320	53844	20180214	108164
20180205	2호선	서울대입구(관악구청)	54933	53045	20180208	107978
20180123	2호선	서울대입구(관악구청)	54965	52980	20180126	107945
20180117	1호선	종각	55139	52709	20180120	107848
20180201	3호선	고속터미널	55581	52213	20180204	107794
20180204	3호선	고속터미널	54577	53180	20180207	107757
20180130	3호선	고속터미널	55333	52253	20180202	107586
20180129	2호선	서울대입구(관악구청)	54394	52966	20180201	107360
20180205	2호선	을지로입구	53554	53683	20180208	107237
20180201	1호선	서울역	54880	52279	20180204	107159
20180122	2호선	을지로입구	53755	53323	20180125	107078
20180119	2호선	사당	49273	57775	20180122	107048
20180123	2호선	을지로입구	53592	53434	20180126	107026
20180124	2호선	을지로입구	53294	53653	20180127	106947
20180207	1호선	서울역	54675	52169	20180210	106844
20180128	3호선	고속터미널	54437	52406	20180131	106843
20180131	1호선	서울역	54026	52493	20180203	106519
20180118	1호선	종각	54591	51876	20180121	106467
20180115	3호선	고속터미널	54707	51648	20180118	106355
20180119	2호선	강변(동서울터미널)	53799	52470	20180122	106269
20180129	2호선	을지로입구	52797	53411	20180201	106208
20180122	3호선	고속터미널	55189	50924	20180125	106113
20180125	2호선	을지로입구	53016	53066	20180128	106082
20180112	1호선	종각	53585	52464	20180115	106049
20180212	2호선	신촌	52731	53234	20180215	105965
20180117	3호선	고속터미널	54349	51528	20180120	105877
20180206	3호선	고속터미널	54568	51189	20180209	105757
20180125	2호선	서울대입구(관악구청)	53706	51727	20180128	105433
20180112	2호선	신촌	51341	53968	20180115	105309
20180124	2호선	서울대입구(관악구청)	53380	51514	20180127	104894
20180131	3호선	고속터미널	54052	50802	20180203	104854
20180129	1호선	서울역	53487	51317	20180201	104804
20180205	3호선	고속터미널	54242	50552	20180208	104794
20180119	2호선	건대입구	48610	56029	20180122	104639
20180123	1호선	서울역	53210	51334	20180126	104544
20180125	1호선	서울역	53271	51113	20180128	104384
20180130	1호선	종각	54759	49526	20180202	104285
20180205	1호선	서울역	52828	51197	20180208	104025
20180129	3호선	고속터미널	53621	50114	20180201	103735
20180112	경부선	영등포	49541	53949	20180115	103490
20180113	2호선	신촌	51136	52333	20180116	103469
20180208	1호선	종각	52848	50570	20180211	103418
20180125	3호선	고속터미널	53463	49899	20180128	103362
20180117	2호선	신촌	50983	52350	20180120	103333
20180123	3호선	고속터미널	53395	49920	20180126	103315
20180131	1호선	종각	52802	50179	20180203	102981
20180119	3호선	양재(서초구청)	50612	52367	20180122	102979
20180120	2호선	강변(동서울터미널)	51711	51062	20180123	102773
20180212	1호선	종각	52718	49997	20180215	102715
20180206	1호선	서울역	52348	50184	20180209	102532
20180126	1호선	종각	52056	50291	20180129	102347
20180130	7호선	가산디지털단지	52269	50067	20180202	102336
20180207	1호선	종각	52441	49777	20180210	102218
20180212	7호선	가산디지털단지	51115	51056	20180215	102171
20180120	1호선	서울역	50808	51224	20180123	102032
20180131	7호선	가산디지털단지	50423	51410	20180203	101833
20180122	1호선	종각	52335	49489	20180125	101824
20180115	1호선	종각	51904	49891	20180118	101795
20180120	2호선	신촌	50308	51469	20180123	101777
20180208	2호선	신촌	50418	51095	20180211	101513
20180120	경부선	수원	48351	52887	20180123	101238
20180201	1호선	종각	51662	49526	20180204	101188
20180113	1호선	서울역	51110	49921	20180116	101031
20180118	2호선	신촌	49828	51079	20180121	100907
20180117	7호선	가산디지털단지	50468	50437	20180120	100905
20180206	7호선	가산디지털단지	50600	50211	20180209	100811
20180207	7호선	가산디지털단지	50529	50273	20180210	100802
20180208	7호선	가산디지털단지	50356	50411	20180211	100767
20180123	1호선	종각	51506	49198	20180126	100704
20180207	2호선	신촌	49734	50934	20180210	100668
20180118	2호선	사당	46395	54152	20180121	100547
20180124	1호선	서울역	51281	49221	20180127	100502
20180113	경부선	수원	47644	52814	20180116	100458
20180205	7호선	가산디지털단지	50369	49852	20180208	100221
20180122	7호선	가산디지털단지	50561	49647	20180125	100208
20180119	7호선	가산디지털단지	50283	49890	20180122	100173
20180203	2호선	신촌	49219	50903	20180206	100122
20180115	7호선	가산디지털단지	49945	50156	20180118	100101
20180118	7호선	가산디지털단지	49838	50104	20180121	99942
20180201	7호선	가산디지털단지	49902	50017	20180204	99919
20180131	2호선	신촌	49102	50781	20180203	99883
20180115	2호선	신촌	49038	50746	20180118	99784
20180124	3호선	고속터미널	51379	48349	20180127	99728
20180208	2호선	사당	46047	53600	20180211	99647
20180120	2호선	건대입구	46066	53488	20180123	99554
20180206	1호선	종각	50821	48554	20180209	99375
20180208	3호선	양재(서초구청)	47834	51448	20180211	99282
20180130	2호선	신촌	49272	49996	20180202	99268
20180126	경부선	영등포	47710	51296	20180129	99006
20180112	2호선	사당	45285	53564	20180115	98849
20180123	7호선	가산디지털단지	49441	49379	20180126	98820
20180129	7호선	가산디지털단지	49391	49425	20180201	98816
20180125	1호선	종각	50899	47813	20180128	98712
20180205	1호선	종각	50544	48130	20180208	98674
20180117	2호선	사당	45351	53252	20180120	98603
20180126	2호선	신촌	47928	50641	20180129	98569
20180113	2호선	강변(동서울터미널)	49550	48972	20180116	98522
20180117	경부선	영등포	47888	50569	20180120	98457
20180118	3호선	양재(서초구청)	47695	50753	20180121	98448
20180124	1호선	종각	50716	47613	20180127	98329
20180212	경부선	영등포	47644	50485	20180215	98129
20180119	2호선	교대(법원.검찰청)	45861	52264	20180122	98125
20180118	경부선	영등포	47917	50080	20180121	97997
20180207	3호선	양재(서초구청)	47258	50737	20180210	97995
20180129	1호선	종각	50011	47935	20180201	97946
20180201	2호선	신촌	48377	49425	20180204	97802
20180117	3호선	양재(서초구청)	47293	50499	20180120	97792
20180201	2호선	사당	45076	52670	20180204	97746
20180112	2호선	건대입구	45092	52575	20180115	97667
20180130	3호선	양재(서초구청)	47489	49932	20180202	97421
20180113	2호선	건대입구	44853	52416	20180116	97269
20180208	경부선	영등포	47328	49906	20180211	97234
20180120	경부선	용산	47444	49787	20180123	97231
20180122	2호선	신촌	47964	49187	20180125	97151
20180117	2호선	건대입구	46322	50694	20180120	97016
20180112	2호선	강변(동서울터미널)	49068	47879	20180115	96947
20180113	경부선	용산	47383	49539	20180116	96922
20180125	7호선	가산디지털단지	48438	48483	20180128	96921
20180112	7호선	가산디지털단지	48738	48140	20180115	96878
20180203	2호선	강변(동서울터미널)	48544	48310	20180206	96854
20180120	2호선	삼성(무역센터)	47896	48745	20180123	96641
20180124	7호선	가산디지털단지	48524	48094	20180127	96618
20180131	3호선	양재(서초구청)	46365	50143	20180203	96508
20180131	경부선	영등포	46762	49706	20180203	96468
20180113	4호선	혜화	46871	49582	20180116	96453
20180201	3호선	양재(서초구청)	46506	49923	20180204	96429
20180114	2호선	신림	48512	47895	20180117	96407
20180126	7호선	가산디지털단지	48586	47763	20180129	96349
20180118	2호선	교대(법원.검찰청)	45303	51015	20180121	96318
20180121	2호선	신림	48403	47819	20180124	96222
20180206	3호선	양재(서초구청)	46556	49657	20180209	96213
20180112	3호선	양재(서초구청)	47529	48681	20180115	96210
20180130	2호선	사당	45245	50836	20180202	96081
20180205	2호선	신촌	47622	48422	20180208	96044
20180203	2호선	건대입구	44323	51572	20180206	95895
20180206	2호선	신촌	47448	48411	20180209	95859
20180118	2호선	건대입구	45927	49893	20180121	95820
20180115	경부선	영등포	46655	49039	20180118	95694
20180131	2호선	사당	44112	51410	20180203	95522
20180117	2호선	교대(법원.검찰청)	45046	50464	20180120	95510
20180201	경부선	영등포	46664	48834	20180204	95498
20180207	2호선	사당	44241	51190	20180210	95431
20180212	3호선	양재(서초구청)	45767	49590	20180215	95357
20180119	경부선	용산	47856	47339	20180122	95195
20180115	3호선	양재(서초구청)	45660	49328	20180118	94988
20180126	2호선	강변(동서울터미널)	48101	46872	20180129	94973
20180123	2호선	신촌	46903	48033	20180126	94936
20180126	3호선	양재(서초구청)	47126	47796	20180129	94922
20180208	2호선	건대입구	45408	49498	20180211	94906
20180203	1호선	서울역	47186	47389	20180206	94575
20180119	4호선	혜화	46441	48126	20180122	94567
20180203	경부선	수원	45407	49131	20180206	94538
20180130	2호선	건대입구	45382	48996	20180202	94378
20180127	2호선	신촌	46696	47563	20180130	94259
20180122	경부선	영등포	46150	48055	20180125	94205
20180122	3호선	양재(서초구청)	45528	48671	20180125	94199
20180126	2호선	사당	43192	50971	20180129	94163
20180125	2호선	신촌	46510	47631	20180128	94141
20180115	2호선	사당	43312	50751	20180118	94063
20180130	경부선	영등포	45937	47991	20180202	93928
20180208	2호선	교대(법원.검찰청)	44152	49725	20180211	93877
20180212	2호선	사당	42878	50754	20180215	93632
20180123	3호선	양재(서초구청)	45304	48293	20180126	93597
20180205	3호선	양재(서초구청)	45145	48451	20180208	93596
20180211	2호선	신림	47306	46123	20180214	93429
20180207	경부선	영등포	45675	47754	20180210	93429
20180212	2호선	교대(법원.검찰청)	44043	49291	20180215	93334
20180119	경부선	수원	44535	48786	20180122	93321
20180212	2호선	강변(동서울터미널)	46656	46605	20180215	93261
20180130	4호선	혜화	48260	44977	20180202	93237
20180119	3호선	연신내	47460	45767	20180122	93227
20180115	2호선	강변(동서울터미널)	46920	46287	20180118	93207
20180127	2호선	강변(동서울터미널)	46803	46398	20180130	93201
20180122	2호선	강변(동서울터미널)	46628	46407	20180125	93035
20180212	2호선	건대입구	44649	48365	20180215	93014
20180118	2호선	강변(동서울터미널)	47178	45738	20180121	92916
20180128	2호선	신림	46612	46209	20180131	92821
20180126	2호선	건대입구	43451	49269	20180129	92720
20180130	5호선	광화문(세종문화회관)	47747	44866	20180202	92613
20180204	2호선	신림	46554	45994	20180207	92548
20180131	2호선	건대입구	44314	48192	20180203	92506
20180120	2호선	구로디지털단지	46472	46011	20180123	92483
20180207	2호선	건대입구	44332	47972	20180210	92304
20180112	2호선	교대(법원.검찰청)	43516	48741	20180115	92257
20180201	2호선	건대입구	44097	48134	20180204	92231
20180207	2호선	교대(법원.검찰청)	43306	48924	20180210	92230
20180129	2호선	신촌	45403	46629	20180201	92032
20180208	3호선	연신내	47254	44734	20180211	91988
20180122	2호선	사당	42110	49877	20180125	91987
20180115	2호선	건대입구	44130	47843	20180118	91973
20180124	2호선	신촌	45554	46343	20180127	91897
20180117	2호선	강변(동서울터미널)	46491	45398	20180120	91889
20180115	2호선	교대(법원.검찰청)	43610	48257	20180118	91867
20180130	2호선	교대(법원.검찰청)	43574	48288	20180202	91862
20180120	2호선	서울대입구(관악구청)	47040	44761	20180123	91801
20180117	4호선	혜화	45066	46707	20180120	91773
20180205	경부선	영등포	44779	46890	20180208	91669
20180206	2호선	사당	42649	48992	20180209	91641
20180123	2호선	사당	42756	48878	20180126	91634
20180203	2호선	구로디지털단지	45741	45863	20180206	91604
20180125	3호선	양재(서초구청)	44024	47411	20180128	91435
20180131	2호선	교대(법원.검찰청)	42912	48408	20180203	91320
20180114	경부선	영등포	46020	45266	20180117	91286
20180113	2호선	구로디지털단지	45753	45410	20180116	91163
20180201	2호선	교대(법원.검찰청)	42978	48148	20180204	91126
20180129	3호선	양재(서초구청)	43895	47207	20180201	91102
20180122	2호선	교대(법원.검찰청)	42951	48137	20180125	91088
20180131	4호선	혜화	44610	46436	20180203	91046
20180117	3호선	연신내	46380	44476	20180120	90856
20180120	4호선	혜화	43740	47114	20180123	90854
20180113	2호선	삼성(무역센터)	45072	45751	20180116	90823
20180206	경부선	영등포	44246	46469	20180209	90715
20180121	경부선	영등포	45477	45142	20180124	90619
20180203	경부선	용산	44844	45771	20180206	90615
20180208	2호선	강변(동서울터미널)	45813	44651	20180211	90464
20180129	경부선	영등포	44219	46188	20180201	90407
20180131	5호선	광화문(세종문화회관)	43821	46568	20180203	90389
20180113	2호선	서울대입구(관악구청)	46130	44143	20180116	90273
20180112	경부선	용산	45561	44696	20180115	90257
20180203	2호선	서울대입구(관악구청)	46044	44121	20180206	90165
20180207	3호선	연신내	46199	43956	20180210	90155
20180123	경부선	영등포	44194	45932	20180126	90126
20180123	2호선	교대(법원.검찰청)	42493	47560	20180126	90053
20180124	3호선	양재(서초구청)	43796	46243	20180127	90039
20180206	2호선	교대(법원.검찰청)	42434	47439	20180209	89873
20180201	3호선	연신내	46035	43628	20180204	89663
20180127	2호선	건대입구	41399	48209	20180130	89608
20180131	2호선	강변(동서울터미널)	45100	44491	20180203	89591
20180125	2호선	사당	41311	48271	20180128	89582
20180126	2호선	교대(법원.검찰청)	42132	47398	20180129	89530
20180131	3호선	연신내	46073	43447	20180203	89520
20180127	경부선	수원	42720	46766	20180130	89486
20180201	2호선	강변(동서울터미널)	45647	43715	20180204	89362
20180130	3호선	연신내	44775	44321	20180202	89096
20180119	5호선	광화문(세종문화회관)	43407	45526	20180122	88933
20180130	2호선	강변(동서울터미널)	44350	44477	20180202	88827
20180205	2호선	사당	40698	48128	20180208	88826
20180119	경인선	부천	44065	44666	20180122	88731
20180205	2호선	교대(법원.검찰청)	41866	46787	20180208	88653
20180129	2호선	강변(동서울터미널)	44735	43891	20180201	88626
20180118	3호선	연신내	45341	43142	20180121	88483
20180117	5호선	광화문(세종문화회관)	43073	45370	20180120	88443
20180125	2호선	교대(법원.검찰청)	41585	46819	20180128	88404
20180118	4호선	혜화	43332	45068	20180121	88400
20180115	3호선	연신내	45264	43106	20180118	88370
20180129	2호선	교대(법원.검찰청)	41859	46479	20180201	88338
20180119	경인선	부평	41079	47137	20180122	88216
20180125	경부선	영등포	43137	44992	20180128	88129
20180212	3호선	연신내	45009	43017	20180215	88026
20180119	4호선	수유(강북구청)	43972	44024	20180122	87996
20180203	4호선	혜화	42863	45005	20180206	87868
20180120	2호선	사당	40608	47218	20180123	87826
20180118	5호선	광화문(세종문화회관)	42708	44962	20180121	87670
20180206	2호선	건대입구	42014	45654	20180209	87668
20180206	3호선	연신내	44842	42624	20180209	87466
20180129	2호선	사당	40069	47356	20180201	87425
20180122	3호선	연신내	44647	42737	20180125	87384
20180126	경부선	용산	44149	43223	20180129	87372
20180207	2호선	강변(동서울터미널)	44013	43346	20180210	87359
20180205	3호선	연신내	44747	42544	20180208	87291
20180205	2호선	강변(동서울터미널)	43994	43239	20180208	87233
20180207	5호선	광화문(세종문화회관)	42754	44354	20180210	87108
20180123	5호선	광화문(세종문화회관)	42925	44166	20180126	87091
20180124	2호선	교대(법원.검찰청)	40967	45796	20180127	86763
20180124	2호선	사당	39853	46868	20180127	86721
20180119	3호선	압구정	41362	45351	20180122	86713
20180208	5호선	광화문(세종문화회관)	42186	44402	20180211	86588
20180203	2호선	삼성(무역센터)	43396	43153	20180206	86549
20180122	2호선	건대입구	41765	44775	20180125	86540
20180113	경인선	부평	39927	46399	20180116	86326
20180112	4호선	혜화	42581	43621	20180115	86202
20180127	경부선	용산	42033	44160	20180130	86193
20180127	1호선	서울역	43795	42379	20180130	86174
20180127	2호선	삼성(무역센터)	42849	43250	20180130	86099
20180208	4호선	혜화	42447	43616	20180211	86063
20180201	5호선	광화문(세종문화회관)	42062	43976	20180204	86038
20180205	2호선	건대입구	41324	44704	20180208	86028
20180124	경부선	영등포	41927	44049	20180127	85976
20180114	경부선	수원	42547	43359	20180117	85906
20180127	2호선	서울대입구(관악구청)	43814	41933	20180130	85747
20180112	경부선	수원	41007	44711	20180115	85718
20180206	5호선	광화문(세종문화회관)	42137	43510	20180209	85647
20180112	5호선	광화문(세종문화회관)	41765	43861	20180115	85626
20180128	경부선	영등포	43303	42314	20180131	85617
20180127	2호선	구로디지털단지	42921	42535	20180130	85456
20180207	4호선	혜화	42178	43276	20180210	85454
20180113	2호선	사당	39382	45872	20180116	85254
20180122	5호선	광화문(세종문화회관)	42407	42838	20180125	85245
20180129	2호선	건대입구	40973	44123	20180201	85096
20180211	경부선	영등포	42754	42158	20180214	84912
20180212	5호선	광화문(세종문화회관)	41948	42939	20180215	84887
20180112	3호선	연신내	43309	41564	20180115	84873
20180117	4호선	수유(강북구청)	42659	42194	20180120	84853
20180130	4호선	수유(강북구청)	41688	43157	20180202	84845
20180120	경인선	부평	39236	45549	20180123	84785
20180117	3호선	압구정	40495	44289	20180120	84784
20180201	4호선	혜화	41686	43097	20180204	84783
20180130	3호선	압구정	42071	42683	20180202	84754
20180119	3호선	남부터미널(예술의전당)	42227	42427	20180122	84654
20180121	경부선	수원	42059	42540	20180124	84599
20180204	경부선	영등포	42815	41664	20180207	84479
20180123	2호선	건대입구	40671	43805	20180126	84476
20180131	4호선	수유(강북구청)	42454	42002	20180203	84456
20180115	5호선	광화문(세종문화회관)	41245	43178	20180118	84423
20180123	3호선	연신내	43175	41056	20180126	84231
20180129	3호선	연신내	43007	41216	20180201	84223
20180126	3호선	남부터미널(예술의전당)	41929	42085	20180129	84014
20180125	2호선	강변(동서울터미널)	43029	40960	20180128	83989
20180212	경부선	수원	40598	43309	20180215	83907
20180208	경부선	수원	40645	43217	20180211	83862
20180206	2호선	강변(동서울터미널)	42469	41384	20180209	83853
20180123	2호선	강변(동서울터미널)	42067	41688	20180126	83755
20180117	경인선	부천	41982	41771	20180120	83753
20180212	경인선	부천	41994	41673	20180215	83667
20180125	2호선	건대입구	40212	43416	20180128	83628
20180126	3호선	연신내	42361	40972	20180129	83333
20180118	4호선	수유(강북구청)	41803	41491	20180121	83294
20180207	4호선	수유(강북구청)	41915	41291	20180210	83206
20180208	경인선	부천	41738	41454	20180211	83192
20180131	경인선	부천	41583	41583	20180203	83166
20180208	4호선	수유(강북구청)	41791	41336	20180211	83127
20180115	4호선	수유(강북구청)	41827	41217	20180118	83044
20180124	5호선	광화문(세종문화회관)	40958	42079	20180127	83037
20180126	4호선	혜화	40701	42230	20180129	82931
20180201	4호선	수유(강북구청)	41725	41194	20180204	82919
20180118	경인선	부천	41467	41275	20180121	82742
20180212	3호선	압구정	39528	43213	20180215	82741
20180117	경부선	수원	39796	42852	20180120	82648
20180115	경인선	부천	41509	41137	20180118	82646
20180212	4호선	수유(강북구청)	41634	40916	20180215	82550
20180201	경인선	부천	41371	41123	20180204	82494
20180125	3호선	연신내	42137	40310	20180128	82447
20180125	5호선	광화문(세종문화회관)	40476	41911	20180128	82387
20180206	4호선	혜화	40784	41602	20180209	82386
20180126	5호선	광화문(세종문화회관)	40322	42043	20180129	82365
20180122	4호선	수유(강북구청)	41286	41071	20180125	82357
20180118	경부선	수원	39829	42519	20180121	82348
20180131	3호선	압구정	39177	42972	20180203	82149
20180124	2호선	강변(동서울터미널)	41824	40311	20180127	82135
20180127	4호선	혜화	39760	42352	20180130	82112
20180129	5호선	광화문(세종문화회관)	40498	41591	20180201	82089
20180124	2호선	건대입구	39248	42713	20180127	81961
20180115	경부선	수원	39646	42300	20180118	81946
20180123	4호선	혜화	40602	41330	20180126	81932
20180205	5호선	광화문(세종문화회관)	40455	41460	20180208	81915
20180212	경인선	부평	39477	42419	20180215	81896
20180122	경부선	수원	39689	42187	20180125	81876
20180119	1호선	종로3가	41802	40008	20180122	81810
20180114	2호선	신도림	41310	40482	20180117	81792
20180203	2호선	사당	37241	44498	20180206	81739
20180113	경인선	부천	40158	41540	20180116	81698
20180207	경인선	부천	40707	40703	20180210	81410
20180203	경인선	부평	38142	43259	20180206	81401
20180119	2호선	합정	38393	42892	20180122	81285
20180117	경인선	부평	38927	42300	20180120	81227
20180122	경인선	부천	40882	40330	20180125	81212
20180124	4호선	혜화	40080	41093	20180127	81173
20180131	경부선	수원	39286	41826	20180203	81112
20180112	4호선	수유(강북구청)	40608	40495	20180115	81103
20180120	경인선	부천	40041	40980	20180123	81021
20180112	3호선	압구정	38670	42326	20180115	80996
20180119	3호선	신사	38402	42586	20180122	80988
20180118	3호선	압구정	38455	42522	20180121	80977
20180208	경인선	부평	38766	42076	20180211	80842
20180112	경인선	부천	39994	40842	20180115	80836
20180112	경인선	부평	37700	43073	20180115	80773
20180118	경인선	부평	38799	41881	20180121	80680
20180115	3호선	압구정	38637	41979	20180118	80616
20180125	4호선	혜화	39814	40785	20180128	80599
20180118	경부선	용산	40166	40311	20180121	80477
20180126	경부선	수원	38688	41734	20180129	80422
20180205	4호선	수유(강북구청)	40569	39779	20180208	80348
20180124	3호선	연신내	41129	39160	20180127	80289
20180112	3호선	남부터미널(예술의전당)	40049	40218	20180115	80267
20180207	3호선	압구정	38517	41719	20180210	80236
20180206	4호선	수유(강북구청)	40461	39774	20180209	80235
20180130	경인선	부천	39863	40314	20180202	80177
20180128	경부선	수원	40147	39959	20180131	80106
20180121	2호선	신도림	40047	40007	20180124	80054
20180131	경인선	부평	38331	41690	20180203	80021
20180201	3호선	압구정	38217	41731	20180204	79948
20180208	3호선	압구정	37994	41776	20180211	79770
20180201	경부선	수원	38434	41321	20180204	79755
20180126	4호선	수유(강북구청)	39684	39938	20180129	79622
20180119	4호선	명동	38512	41090	20180122	79602
20180207	경부선	수원	38627	40953	20180210	79580
20180122	3호선	압구정	37970	41552	20180125	79522
20180115	경부선	용산	39184	40312	20180118	79496
20180201	경인선	부평	38199	41289	20180204	79488
20180129	4호선	수유(강북구청)	39788	39382	20180201	79170
20180122	경부선	용산	39063	40087	20180125	79150
20180114	2호선	강변(동서울터미널)	38464	40655	20180117	79119
20180212	경부선	용산	38207	40793	20180215	79000
20180117	경부선	용산	39378	39603	20180120	78981
20180121	2호선	강변(동서울터미널)	38405	40422	20180124	78827
20180115	경인선	부평	38076	40751	20180118	78827
20180211	경부선	수원	39251	39573	20180214	78824
20180131	3호선	남부터미널(예술의전당)	38791	40010	20180203	78801
20180126	3호선	압구정	37550	41181	20180129	78731
20180203	경인선	부천	38840	39801	20180206	78641
20180123	4호선	수유(강북구청)	39137	39247	20180126	78384
20180120	4호선	명동	37459	40904	20180123	78363
20180121	경부선	용산	40192	38144	20180124	78336
20180205	경인선	부천	39510	38773	20180208	78283
20180207	경인선	부평	37652	40551	20180210	78203
20180212	4호선	혜화	38811	39341	20180215	78152
20180130	경부선	수원	37687	40442	20180202	78129
20180114	경부선	용산	40129	37974	20180117	78103
20180117	3호선	남부터미널(예술의전당)	38681	39297	20180120	77978
20180130	3호선	남부터미널(예술의전당)	38476	39487	20180202	77963
20180203	2호선	을지로입구	40482	37436	20180206	77918
20180129	경인선	부천	39385	38487	20180201	77872
20180128	2호선	신도림	38867	38982	20180131	77849
20180206	3호선	압구정	37151	40695	20180209	77846
20180123	3호선	압구정	37286	40401	20180126	77687
20180122	경인선	부평	37722	39941	20180125	77663
20180212	3호선	남부터미널(예술의전당)	37926	39721	20180215	77647
20180205	경부선	수원	37524	40111	20180208	77635
20180204	경부선	수원	38548	39041	20180207	77589
20180122	3호선	남부터미널(예술의전당)	38317	39250	20180125	77567
20180126	경인선	부천	38354	39011	20180129	77365
20180208	3호선	남부터미널(예술의전당)	38028	39295	20180211	77323
20180131	경부선	용산	38396	38927	20180203	77323
20180127	2호선	사당	35652	41670	20180130	77322
20180115	3호선	남부터미널(예술의전당)	38079	39187	20180118	77266
20180205	3호선	압구정	36782	40433	20180208	77215
20180115	4호선	혜화	37943	39260	20180118	77203
20180113	4호선	명동	36740	40430	20180116	77170
20180125	4호선	수유(강북구청)	38794	38294	20180128	77088
20180206	경인선	부천	38818	38254	20180209	77072
20180204	2호선	신도림	38530	38434	20180207	76964
20180211	2호선	신도림	38627	38310	20180214	76937
20180118	3호선	남부터미널(예술의전당)	37970	38955	20180121	76925
20180201	3호선	남부터미널(예술의전당)	37955	38909	20180204	76864
20180123	경인선	부천	38578	38265	20180126	76843
20180127	경인선	부평	35839	40956	20180130	76795
20180129	경부선	수원	37055	39620	20180201	76675
20180129	3호선	압구정	36609	40045	20180201	76654
20180203	4호선	명동	36701	39948	20180206	76649
20180123	경부선	수원	37127	39462	20180126	76589
20180126	경인선	부평	35764	40813	20180129	76577
20180119	9호선	신논현	37029	39468	20180122	76497
20180208	경부선	용산	37950	38450	20180211	76400
20180124	4호선	수유(강북구청)	38278	38097	20180127	76375
20180122	4호선	혜화	37991	38344	20180125	76335
20180207	3호선	남부터미널(예술의전당)	37492	38730	20180210	76222
20180130	경인선	부평	36560	39606	20180202	76166
20180206	경부선	수원	36845	39267	20180209	76112
20180113	2호선	을지로입구	39131	36809	20180116	75940
20180130	3호선	신사	37475	38432	20180202	75907
20180117	1호선	종로3가	39010	36804	20180120	75814
20180115	1호선	종로3가	39106	36611	20180118	75717
20180205	경인선	부평	36684	38988	20180208	75672
20180120	2호선	을지로입구	39232	36358	20180123	75590
20180201	4호선	명동	36421	39074	20180204	75495
20180129	경인선	부평	36306	39090	20180201	75396
20180118	1호선	종로3가	38705	36549	20180121	75254
20180208	3호선	신사	36321	38915	20180211	75236
20180124	3호선	압구정	35848	39320	20180127	75168
20180123	경부선	용산	37444	37660	20180126	75104
20180127	경인선	부천	37151	37933	20180130	75084
20180123	3호선	남부터미널(예술의전당)	37107	37969	20180126	75076
20180212	3호선	신사	36604	38460	20180215	75064
20180117	2호선	합정	36416	38599	20180120	75015
20180118	2호선	합정	36179	38771	20180121	74950
20180112	2호선	합정	35645	39303	20180115	74948
20180208	4호선	명동	36292	38514	20180211	74806
20180201	3호선	신사	36004	38781	20180204	74785
20180112	3호선	신사	35475	39197	20180115	74672
20180131	3호선	신사	35932	38580	20180203	74512
20180125	3호선	압구정	35509	38846	20180128	74355
20180205	3호선	남부터미널(예술의전당)	36548	37703	20180208	74251
20180120	3호선	연신내	38064	36129	20180123	74193
20180118	3호선	신사	35776	38406	20180121	74182
20180201	경부선	용산	36850	37260	20180204	74110
20180206	경인선	부평	35805	38290	20180209	74095
20180125	경인선	부천	37214	36832	20180128	74046
20180115	4호선	명동	35906	38078	20180118	73984
20180121	1호선	서울역	37832	36111	20180124	73943
20180119	4호선	충무로	36154	37764	20180122	73918
20180129	경부선	용산	36405	37433	20180201	73838
20180117	4호선	충무로	36230	37553	20180120	73783
20180125	3호선	남부터미널(예술의전당)	36432	37307	20180128	73739
20180206	3호선	남부터미널(예술의전당)	36157	37571	20180209	73728
20180130	경부선	용산	36924	36799	20180202	73723
20180130	4호선	명동	36090	37579	20180202	73669
20180118	4호선	명동	35710	37953	20180121	73663
20180205	4호선	명동	35735	37883	20180208	73618
20180125	경부선	용산	36904	36628	20180128	73532
20180117	4호선	명동	35723	37763	20180120	73486
20180131	4호선	명동	35586	37899	20180203	73485
20180205	4호선	혜화	36454	37005	20180208	73459
20180201	2호선	합정	35802	37652	20180204	73454
20180207	4호선	명동	35680	37721	20180210	73401
20180129	3호선	남부터미널(예술의전당)	36138	37261	20180201	73399
20180114	2호선	건대입구	35738	37640	20180117	73378
20180125	경부선	수원	35748	37618	20180128	73366
20180207	4호선	충무로	36247	37060	20180210	73307
20180126	2호선	합정	35015	38202	20180129	73217
20180112	4호선	명동	35486	37726	20180115	73212
20180130	4호선	충무로	36621	36539	20180202	73160
20180208	2호선	합정	35753	37395	20180211	73148
20180131	2호선	합정	35509	37632	20180203	73141
20180113	1호선	종각	37564	35534	20180116	73098
20180131	4호선	충무로	35994	37002	20180203	72996
20180126	3호선	신사	34526	38460	20180129	72986
20180117	3호선	신사	35272	37704	20180120	72976
20180124	경인선	부천	36513	36457	20180127	72970
20180120	1호선	종로3가	36900	36042	20180123	72942
20180123	경인선	부평	35464	37437	20180126	72901
20180211	2호선	신촌	37750	35142	20180214	72892
20180129	4호선	혜화	35928	36857	20180201	72785
20180208	4호선	충무로	36012	36771	20180211	72783
20180206	4호선	명동	35430	37343	20180209	72773
20180128	2호선	강변(동서울터미널)	35542	37229	20180131	72771
20180114	1호선	서울역	37230	35443	20180117	72673
20180124	3호선	남부터미널(예술의전당)	35957	36705	20180127	72662
20180118	4호선	충무로	35486	37127	20180121	72613
20180207	3호선	신사	35118	37364	20180210	72482
20180212	4호선	명동	35218	37231	20180215	72449
20180208	1호선	종로3가	37487	34929	20180211	72416
20180212	2호선	합정	35351	36998	20180215	72349
20180126	4호선	명동	35089	37226	20180129	72315
20180207	2호선	합정	35249	37061	20180210	72310
20180115	3호선	신사	34952	37330	20180118	72282
20180130	2호선	성수	36361	35903	20180202	72264
20180128	경부선	용산	37236	34905	20180131	72141
20180203	3호선	연신내	36765	35368	20180206	72133
20180121	2호선	건대입구	35049	37005	20180124	72054
20180125	경인선	부평	34564	37418	20180128	71982
20180120	1호선	종각	37248	34688	20180123	71936
20180207	경부선	용산	35961	35966	20180210	71927
20180122	1호선	종로3가	36883	35035	20180125	71918
20180115	4호선	충무로	35297	36606	20180118	71903
20180131	1호선	종로3가	37214	34655	20180203	71869
20180124	경부선	수원	35004	36803	20180127	71807
20180112	4호선	충무로	35116	36533	20180115	71649
20180201	1호선	종로3가	37141	34501	20180204	71642
20180112	9호선	신논현	34595	37003	20180115	71598
20180206	3호선	신사	34536	37007	20180209	71543
20180206	4호선	충무로	35462	36046	20180209	71508
20180113	3호선	연신내	36264	35203	20180116	71467
20180119	경인선	송내	36239	35199	20180122	71438
20180114	4호선	혜화	35021	36403	20180117	71424
20180205	경부선	용산	35046	36336	20180208	71382
20180124	경부선	용산	35651	35712	20180127	71363
20180212	4호선	충무로	34978	36315	20180215	71293
20180211	2호선	건대입구	34762	36496	20180214	71258
20180121	2호선	삼성(무역센터)	35763	35251	20180124	71014
20180201	4호선	충무로	34828	36158	20180204	70986
20180115	2호선	합정	34666	36304	20180118	70970
20180204	경부선	용산	36093	34868	20180207	70961
20180204	2호선	강변(동서울터미널)	34514	36418	20180207	70932
20180131	4호선	쌍문	37553	33245	20180203	70798
20180114	2호선	신촌	36177	34594	20180117	70771
20180130	2호선	합정	34602	36158	20180202	70760
20180131	2호선	성수	33267	37380	20180203	70647
20180119	4호선	쌍문	37841	32778	20180122	70619
20180127	4호선	명동	33569	36931	20180130	70500
20180124	경인선	부평	33995	36359	20180127	70354
20180130	4호선	쌍문	36181	34109	20180202	70290
20180122	4호선	충무로	34643	35644	20180125	70287
20180129	3호선	신사	34067	36103	20180201	70170
20180121	2호선	신촌	35997	34150	20180124	70147
20180126	9호선	신논현	33948	36164	20180129	70112
20180206	경부선	용산	34880	35230	20180209	70110
20180207	4호선	쌍문	36908	33178	20180210	70086
20180120	2호선	합정	33147	36936	20180123	70083
20180129	4호선	명동	34073	36008	20180201	70081
20180205	3호선	신사	33932	36134	20180208	70066
20180122	4호선	명동	33826	36128	20180125	69954
20180123	4호선	충무로	34535	35327	20180126	69862
20180117	2호선	성수	33563	36291	20180120	69854
20180122	3호선	신사	34102	35750	20180125	69852
20180208	4호선	쌍문	37057	32791	20180211	69848
20180117	4호선	쌍문	36887	32839	20180120	69726
20180205	4호선	충무로	34235	35425	20180208	69660
20180119	2호선	성수	33475	36173	20180122	69648
20180117	경인선	송내	34901	34663	20180120	69564
20180118	4호선	쌍문	36844	32707	20180121	69551
20180119	분당선	야탑	34009	35540	20180122	69549
20180211	2호선	삼성(무역센터)	35176	34364	20180214	69540
20180126	4호선	충무로	34481	35032	20180129	69513
20180211	2호선	강변(동서울터미널)	33238	36145	20180214	69383
20180207	1호선	종로3가	35846	33526	20180210	69372
20180119	4호선	회현(남대문시장)	33710	35631	20180122	69341
20180113	1호선	종로3가	35656	33625	20180116	69281
20180118	2호선	성수	33166	36061	20180121	69227
20180201	4호선	쌍문	36520	32704	20180204	69224
20180125	4호선	명동	33448	35758	20180128	69206
20180122	4호선	쌍문	36343	32816	20180125	69159
20180203	1호선	종각	35943	33092	20180206	69035
20180118	경인선	송내	34760	34266	20180121	69026
20180115	4호선	쌍문	36417	32504	20180118	68921
20180127	2호선	을지로입구	34755	34162	20180130	68917
20180131	경인선	송내	34840	34049	20180203	68889
20180125	4호선	충무로	33888	34925	20180128	68813
20180123	3호선	신사	33287	35524	20180126	68811
20180208	2호선	성수	33029	35765	20180211	68794
20180119	분당선	서현	33922	34852	20180122	68774
20180207	2호선	성수	33160	35582	20180210	68742
20180208	경인선	송내	34673	34068	20180211	68741
20180212	9호선	신논현	34010	34703	20180215	68713
20180212	1호선	종로3가	35540	33167	20180215	68707
20180122	2호선	합정	33454	35147	20180125	68601
20180125	2호선	합정	33377	35202	20180128	68579
20180122	4호선	회현(남대문시장)	33734	34831	20180125	68565
20180201	경인선	송내	34499	34049	20180204	68548
20180204	2호선	신촌	35291	33220	20180207	68511
20180119	4호선	창동	33182	35258	20180122	68440
20180115	경인선	송내	34560	33834	20180118	68394
20180201	2호선	성수	32867	35525	20180204	68392
20180123	2호선	합정	33382	34990	20180126	68372
20180122	경인선	송내	34389	33980	20180125	68369
20180129	4호선	충무로	33544	34785	20180201	68329
20180128	2호선	신촌	35149	33155	20180131	68304
20180203	2호선	합정	32131	36130	20180206	68261
20180206	2호선	합정	33418	34830	20180209	68248
20180121	4호선	혜화	33624	34615	20180124	68239
20180212	4호선	쌍문	36202	32026	20180215	68228
20180123	4호선	명동	33088	35092	20180126	68180
20180125	3호선	신사	32865	35306	20180128	68171
20180212	2호선	성수	32792	35369	20180215	68161
20180115	2호선	성수	32943	35214	20180118	68157
20180113	2호선	합정	31979	36176	20180116	68155
20180120	4호선	수유(강북구청)	34226	33907	20180123	68133
20180117	9호선	신논현	33769	34330	20180120	68099
20180119	과천선	범계	34302	33790	20180122	68092
20180112	1호선	종로3가	34401	33674	20180115	68075
20180212	4호선	회현(남대문시장)	33337	34696	20180215	68033
20180122	2호선	성수	32869	35146	20180125	68015
20180118	9호선	신논현	33806	34157	20180121	67963
20180130	4호선	회현(남대문시장)	33848	34039	20180202	67887
20180201	9호선	신논현	33635	34231	20180204	67866
20180208	4호선	회현(남대문시장)	32809	35027	20180211	67836
20180205	2호선	합정	33155	34642	20180208	67797
20180130	경인선	송내	34011	33783	20180202	67794
20180129	2호선	합정	33065	34702	20180201	67767
20180212	경인선	송내	34247	33515	20180215	67762
20180206	4호선	쌍문	35510	32243	20180209	67753
20180205	2호선	성수	32706	35035	20180208	67741
20180128	2호선	건대입구	32916	34798	20180131	67714
20180201	4호선	회현(남대문시장)	32721	34975	20180204	67696
20180124	4호선	충무로	33482	34129	20180127	67611
20180207	경인선	송내	34091	33388	20180210	67479
20180123	2호선	성수	32333	35132	20180126	67465
20180128	1호선	서울역	34822	32569	20180131	67391
20180205	4호선	쌍문	35432	31943	20180208	67375
20180131	4호선	회현(남대문시장)	32445	34868	20180203	67313
20180208	9호선	신논현	33185	34067	20180211	67252
20180204	2호선	건대입구	32618	34622	20180207	67240
20180117	2호선	대림(구로구청)	33130	34034	20180120	67164
20180206	2호선	성수	32271	34858	20180209	67129
20180208	4호선	창동	32587	34487	20180211	67074
20180208	2호선	낙성대	34132	32898	20180211	67030
20180118	2호선	낙성대	34136	32889	20180121	67025
20180130	9호선	신논현	33468	33444	20180202	66912
20180123	4호선	쌍문	35046	31783	20180126	66829
20180113	4호선	수유(강북구청)	33561	33184	20180116	66745
20180207	9호선	신논현	33101	33513	20180210	66614
20180119	4호선	미아사거리	33756	32837	20180122	66593
20180112	2호선	성수	31994	34598	20180115	66592
20180124	2호선	합정	32395	34163	20180127	66558
20180201	2호선	낙성대	33743	32785	20180204	66528
20180121	2호선	구로디지털단지	33386	33133	20180124	66519
20180203	4호선	수유(강북구청)	33238	33267	20180206	66505
20180115	2호선	대림(구로구청)	33105	33365	20180118	66470
20180127	3호선	연신내	34058	32406	20180130	66464
20180118	4호선	회현(남대문시장)	32206	34208	20180121	66414
20180124	4호선	명동	32362	34044	20180127	66406
20180204	1호선	서울역	33991	32406	20180207	66397
20180117	4호선	회현(남대문시장)	32144	34246	20180120	66390
20180119	경인선	역곡	33902	32456	20180122	66358
20180115	4호선	회현(남대문시장)	32138	34208	20180118	66346
20180119	5호선	까치산	34268	32071	20180122	66339
20180129	2호선	성수	31909	34423	20180201	66332
20180211	경부선	용산	33456	32842	20180214	66298
20180131	9호선	신논현	32936	33360	20180203	66296
20180129	4호선	쌍문	34936	31350	20180201	66286
20180126	2호선	성수	31824	34429	20180129	66253
20180207	4호선	창동	32161	34075	20180210	66236
20180130	1호선	종로3가	34633	31594	20180202	66227
20180112	경인선	송내	33554	32664	20180115	66218
20180119	2호선	낙성대	34357	31824	20180122	66181
20180121	2호선	서울대입구(관악구청)	32969	33206	20180124	66175
20180124	3호선	신사	32035	34137	20180127	66172
20180115	9호선	신논현	32807	33349	20180118	66156
20180119	2호선	대림(구로구청)	32629	33514	20180122	66143
20180203	3호선	남부터미널(예술의전당)	33399	32742	20180206	66141
20180130	4호선	미아사거리	32869	33268	20180202	66137
20180114	2호선	서울대입구(관악구청)	32849	33239	20180117	66088
20180203	3호선	신사	32142	33896	20180206	66038
20180117	4호선	창동	32115	33870	20180120	65985
20180117	분당선	야탑	32250	33727	20180120	65977
20180208	5호선	까치산	33740	32199	20180211	65939
20180124	2호선	성수	31722	33992	20180127	65714
20180119	9호선	노량진	31920	33782	20180122	65702
20180205	경인선	송내	33069	32622	20180208	65691
20180131	5호선	까치산	33816	31785	20180203	65601
20180131	4호선	창동	31856	33741	20180203	65597
20180207	5호선	까치산	33466	32092	20180210	65558
20180129	경인선	송내	33141	32381	20180201	65522
20180201	4호선	창동	31800	33713	20180204	65513
20180211	2호선	서울대입구(관악구청)	33069	32412	20180214	65481
20180125	2호선	성수	31214	34240	20180128	65454
20180207	4호선	회현(남대문시장)	31805	33606	20180210	65411
20180117	2호선	낙성대	33318	32079	20180120	65397
20180201	5호선	까치산	33424	31959	20180204	65383
20180211	1호선	서울역	33073	32249	20180214	65322
20180203	1호선	종로3가	33006	32316	20180206	65322
20180122	9호선	신논현	32718	32583	20180125	65301
20180112	4호선	쌍문	34954	30333	20180115	65287
20180206	1호선	종로3가	33610	31641	20180209	65251
20180120	3호선	남부터미널(예술의전당)	32796	32439	20180123	65235
20180126	4호선	쌍문	34690	30528	20180129	65218
20180114	2호선	구로디지털단지	32996	32214	20180117	65210
20180206	경인선	송내	32664	32458	20180209	65122
20180211	4호선	혜화	32180	32921	20180214	65101
20180128	4호선	혜화	32314	32784	20180131	65098
20180130	4호선	창동	31063	34027	20180202	65090
20180115	4호선	창동	31570	33508	20180118	65078
20180131	분당선	야탑	31852	33189	20180203	65041
20180123	경인선	송내	32641	32395	20180126	65036
20180113	3호선	압구정	31400	33623	20180116	65023
20180123	9호선	신논현	32332	32655	20180126	64987
20180208	4호선	미아사거리	33193	31787	20180211	64980
20180130	5호선	까치산	32646	32322	20180202	64968
20180131	경인선	역곡	32829	32112	20180203	64941
20180118	2호선	대림(구로구청)	31940	32989	20180121	64929
20180117	5호선	까치산	33184	31742	20180120	64926
20180119	5호선	화곡	33984	30905	20180122	64889
20180118	4호선	창동	31453	33421	20180121	64874
20180212	4호선	창동	31337	33510	20180215	64847
20180117	5호선	화곡	33584	31254	20180120	64838
20180207	4호선	미아사거리	33017	31820	20180210	64837
20180205	4호선	회현(남대문시장)	31396	33437	20180208	64833
20180205	1호선	종로3가	33327	31498	20180208	64825
20180131	4호선	미아사거리	32929	31831	20180203	64760
20180204	2호선	서울대입구(관악구청)	32376	32330	20180207	64706
20180206	9호선	신논현	32100	32602	20180209	64702
20180125	4호선	쌍문	34192	30497	20180128	64689
20180120	3호선	신사	31630	33044	20180123	64674
20180117	경인선	역곡	32749	31901	20180120	64650
20180203	3호선	압구정	31412	33223	20180206	64635
20180117	과천선	범계	32744	31855	20180120	64599
20180130	2호선	낙성대	32557	32035	20180202	64592
20180131	2호선	대림(구로구청)	32001	32538	20180203	64539
20180208	2호선	대림(구로구청)	31903	32611	20180211	64514
20180117	4호선	미아사거리	32672	31817	20180120	64489
20180208	5호선	화곡	33660	30794	20180211	64454
20180206	4호선	회현(남대문시장)	31470	32942	20180209	64412
20180212	5호선	까치산	33032	31342	20180215	64374
20180131	5호선	화곡	33573	30800	20180203	64373
20180115	5호선	까치산	33095	31277	20180118	64372
20180124	4호선	쌍문	33918	30452	20180127	64370
20180131	2호선	낙성대	32896	31428	20180203	64324
20180120	3호선	압구정	31368	32951	20180123	64319
20180212	5호선	화곡	33333	30969	20180215	64302
20180118	분당선	야탑	31460	32833	20180121	64293
20180201	2호선	대림(구로구청)	31621	32635	20180204	64256
20180207	5호선	화곡	33336	30897	20180210	64233
20180207	2호선	낙성대	32645	31563	20180210	64208
20180113	3호선	남부터미널(예술의전당)	32517	31691	20180116	64208
20180118	5호선	까치산	32985	31220	20180121	64205
20180122	2호선	대림(구로구청)	31841	32351	20180125	64192
20180122	4호선	창동	31058	33131	20180125	64189
20180205	5호선	까치산	32779	31348	20180208	64127
20180130	5호선	화곡	32717	31379	20180202	64096
20180118	경인선	역곡	32470	31592	20180121	64062
20180122	5호선	까치산	32692	31318	20180125	64010
20180212	경인선	역곡	32407	31560	20180215	63967
20180201	4호선	미아사거리	32540	31412	20180204	63952
20180205	9호선	신논현	31651	32252	20180208	63903
20180118	5호선	화곡	33022	30847	20180121	63869
20180206	5호선	까치산	32750	31104	20180209	63854
20180130	5호선	여의도	32261	31571	20180202	63832
20180211	2호선	구로디지털단지	32367	31449	20180214	63816
20180212	분당선	서현	31913	31901	20180215	63814
20180128	2호선	서울대입구(관악구청)	31879	31909	20180131	63788
20180208	경인선	역곡	32418	31350	20180211	63768
20180131	분당선	서현	31639	32071	20180203	63710
20180212	분당선	야탑	31260	32447	20180215	63707
20180131	과천선	범계	32345	31352	20180203	63697
20180208	분당선	서현	31786	31864	20180211	63650
20180112	분당선	야탑	31193	32402	20180115	63595
20180118	4호선	미아사거리	32285	31287	20180121	63572
20180119	분당선	모란	31206	32319	20180122	63525
20180115	2호선	낙성대	32133	31388	20180118	63521
20180201	경인선	역곡	32249	31258	20180204	63507
20180115	5호선	화곡	32944	30552	20180118	63496
20180130	경인선	역곡	31692	31770	20180202	63462
20180201	5호선	화곡	33008	30452	20180204	63460
20180204	2호선	구로디지털단지	31976	31469	20180207	63445
20180129	4호선	회현(남대문시장)	30848	32548	20180201	63396
20180201	분당선	야탑	31170	32214	20180204	63384
20180122	분당선	야탑	31069	32314	20180125	63383
20180126	경인선	송내	32000	31378	20180129	63378
20180114	2호선	삼성(무역센터)	31942	31435	20180117	63377
20180129	1호선	종로3가	32628	30741	20180201	63369
20180112	2호선	낙성대	32730	30604	20180115	63334
20180122	경인선	역곡	32010	31307	20180125	63317
20180207	분당선	야탑	30868	32433	20180210	63301
20180129	9호선	신논현	31510	31785	20180201	63295
20180212	2호선	낙성대	32149	31131	20180215	63280
20180115	경인선	역곡	31899	31362	20180118	63261
20180212	4호선	미아사거리	32203	31049	20180215	63252
20180208	분당선	야탑	31100	32137	20180211	63237
20180127	3호선	신사	30857	32377	20180130	63234
20180212	2호선	대림(구로구청)	31295	31902	20180215	63197
20180122	5호선	화곡	32734	30462	20180125	63196
20180112	분당선	서현	31181	31973	20180115	63154
20180123	1호선	종로3가	32369	30708	20180126	63077
20180118	과천선	범계	32056	30992	20180121	63048
20180206	4호선	창동	30375	32671	20180209	63046
20180125	2호선	낙성대	31970	31045	20180128	63015
20180125	9호선	신논현	31173	31786	20180128	62959
20180122	4호선	미아사거리	31840	31118	20180125	62958
20180128	2호선	삼성(무역센터)	31838	31106	20180131	62944
20180208	과천선	범계	32212	30731	20180211	62943
20180128	2호선	구로디지털단지	32014	30929	20180131	62943
20180119	4호선	사당	33664	29259	20180122	62923
20180122	2호선	낙성대	31842	31075	20180125	62917
20180206	2호선	낙성대	31965	30945	20180209	62910
20180207	2호선	대림(구로구청)	31147	31751	20180210	62898
20180204	4호선	혜화	31141	31756	20180207	62897
20180130	2호선	대림(구로구청)	30994	31901	20180202	62895
20180212	과천선	범계	31937	30955	20180215	62892
20180130	분당선	야탑	30678	32199	20180202	62877
20180205	5호선	화곡	32662	30121	20180208	62783
20180201	분당선	서현	31224	31500	20180204	62724
20180115	분당선	야탑	30651	32051	20180118	62702
20180123	2호선	낙성대	31905	30788	20180126	62693
20180205	4호선	창동	30367	32324	20180208	62691
20180206	4호선	미아사거리	31794	30886	20180209	62680
20180207	경인선	역곡	31876	30796	20180210	62672
20180112	9호선	노량진	30781	31888	20180115	62669
20180114	경인선	부평	30725	31897	20180117	62622
20180119	2호선	잠실새내	30898	31676	20180122	62574
20180121	경인선	부평	30833	31712	20180124	62545
20180125	경인선	송내	31521	31023	20180128	62544
20180208	1호선	청량리(서울시립대입구)	30643	31888	20180211	62531
20180117	5호선	여의도	30332	32153	20180120	62485
20180129	5호선	까치산	31960	30519	20180201	62479
20180201	과천선	범계	31773	30680	20180204	62453
20180207	과천선	범계	31681	30762	20180210	62443
20180130	과천선	범계	31753	30646	20180202	62399
20180117	분당선	서현	30981	31356	20180120	62337
20180126	분당선	야탑	30513	31774	20180129	62287
20180112	과천선	범계	31456	30819	20180115	62275
20180117	9호선	노량진	30372	31898	20180120	62270
20180126	1호선	종로3가	31601	30647	20180129	62248
20180205	4호선	미아사거리	31725	30501	20180208	62226
20180203	3호선	양재(서초구청)	30083	32116	20180206	62199
20180112	4호선	창동	30060	32133	20180115	62193
20180118	분당선	서현	30822	31370	20180121	62192
20180205	2호선	낙성대	31570	30615	20180208	62185
20180125	1호선	종로3가	31794	30379	20180128	62173
20180127	4호선	수유(강북구청)	31223	30926	20180130	62149
20180130	2호선	시청	32609	29503	20180202	62112
20180131	5호선	여의도	29583	32498	20180203	62081
20180114	4호선	명동	30044	32001	20180117	62045
20180211	4호선	명동	29590	32451	20180214	62041
20180121	4호선	명동	30191	31829	20180124	62020
20180127	1호선	종각	31430	30547	20180130	61977
20180115	4호선	미아사거리	31577	30390	20180118	61967
20180124	9호선	신논현	30866	31093	20180127	61959
20180207	분당선	서현	30767	31189	20180210	61956
20180206	2호선	대림(구로구청)	30501	31427	20180209	61928
20180205	2호선	대림(구로구청)	30638	31280	20180208	61918
20180127	3호선	압구정	30142	31762	20180130	61904
20180127	2호선	합정	29079	32800	20180130	61879
20180123	5호선	까치산	31658	30206	20180126	61864
20180206	5호선	화곡	32041	29805	20180209	61846
20180123	2호선	대림(구로구청)	30322	31455	20180126	61777
20180118	9호선	노량진	30226	31528	20180121	61754
20180119	경부선	금정	30884	30815	20180122	61699
20180123	4호선	회현(남대문시장)	30194	31478	20180126	61672
20180124	경인선	송내	31065	30601	20180127	61666
20180130	분당선	서현	30511	31128	20180202	61639
20180119	2호선	신대방	31926	29651	20180122	61577
20180131	9호선	노량진	30510	30999	20180203	61509
20180122	분당선	서현	30623	30848	20180125	61471
20180118	5호선	여의도	29809	31662	20180121	61471
20180205	경인선	역곡	31077	30318	20180208	61395
20180129	5호선	화곡	31776	29611	20180201	61387
20180119	1호선	청량리(서울시립대입구)	30188	31198	20180122	61386
20180129	경인선	역곡	31090	30278	20180201	61368
20180121	경인선	부천	31027	30331	20180124	61358
20180126	분당선	서현	30056	31298	20180129	61354
20180129	2호선	대림(구로구청)	30508	30831	20180201	61339
20180117	2호선	신대방	31467	29853	20180120	61320
20180119	5호선	여의도	29368	31938	20180122	61306
20180112	4호선	미아사거리	30857	30394	20180115	61251
20180112	5호선	까치산	31385	29812	20180115	61197
20180115	과천선	범계	31146	30040	20180118	61186
20180115	분당선	서현	30276	30899	20180118	61175
20180206	분당선	야탑	29871	31158	20180209	61029
20180126	2호선	낙성대	31750	29274	20180129	61024
20180115	9호선	노량진	29916	31094	20180118	61010
20180208	9호선	노량진	29917	31087	20180211	61004
20180130	9호선	노량진	29729	31211	20180202	60940
20180129	4호선	창동	29487	31445	20180201	60932
20180129	2호선	낙성대	30820	30079	20180201	60899
20180129	분당선	야탑	29755	31123	20180201	60878
20180123	5호선	화곡	31580	29287	20180126	60867
20180208	5호선	여의도	29248	31616	20180211	60864
20180131	2호선	잠실새내	30635	30221	20180203	60856
20180211	경인선	부평	29872	30967	20180214	60839
20180207	5호선	여의도	29583	31249	20180210	60832
20180127	3호선	남부터미널(예술의전당)	30618	30206	20180130	60824
20180115	5호선	여의도	29500	31285	20180118	60785
20180208	2호선	시청	30684	30004	20180211	60688
20180123	4호선	창동	29422	31261	20180126	60683
20180131	2호선	시청	30561	30106	20180203	60667
20180123	4호선	미아사거리	30768	29858	20180126	60626
20180112	2호선	대림(구로구청)	30017	30606	20180115	60623
20180206	경인선	역곡	30592	29977	20180209	60569
20180128	경인선	부평	29977	30590	20180131	60567
20180113	3호선	신사	29121	31436	20180116	60557
20180126	4호선	창동	29178	31372	20180129	60550
20180212	9호선	노량진	29846	30677	20180215	60523
20180207	9호선	노량진	30019	30448	20180210	60467
20180123	분당선	야탑	29433	31028	20180126	60461
20180208	2호선	신대방	31059	29401	20180211	60460
20180126	5호선	까치산	31111	29340	20180129	60451
20180201	9호선	노량진	29753	30697	20180204	60450
20180122	과천선	범계	30837	29606	20180125	60443
20180212	5호선	여의도	29333	31108	20180215	60441
20180122	5호선	여의도	29596	30842	20180125	60438
20180131	2호선	신대방	30974	29428	20180203	60402
20180201	5호선	여의도	29327	31037	20180204	60364
20180129	4호선	미아사거리	30582	29775	20180201	60357
20180119	과천선	인덕원	30665	29688	20180122	60353
20180126	4호선	미아사거리	30386	29959	20180129	60345
20180207	2호선	시청	30466	29846	20180210	60312
20180119	5호선	오목교(목동운동장앞)	29061	31237	20180122	60298
20180205	분당선	야탑	29501	30796	20180208	60297
20180112	경인선	역곡	30819	29474	20180115	60293
20180124	2호선	낙성대	30532	29658	20180127	60190
20180201	2호선	신대방	30932	29243	20180204	60175
20180124	1호선	종로3가	30813	29355	20180127	60168
20180205	분당선	서현	30087	30058	20180208	60145
20180123	경인선	역곡	30384	29739	20180126	60123
20180130	2호선	신대방	30477	29645	20180202	60122
20180126	과천선	범계	30292	29756	20180129	60048
20180201	1호선	청량리(서울시립대입구)	29535	30502	20180204	60037
20180123	5호선	여의도	29084	30932	20180126	60016
20180112	5호선	화곡	31237	28764	20180115	60001
20180206	분당선	서현	29915	30072	20180209	59987
20180206	5호선	여의도	29164	30805	20180209	59969
20180120	3호선	양재(서초구청)	29325	30632	20180123	59957
20180112	4호선	회현(남대문시장)	29054	30902	20180115	59956
20180131	경부선	금정	29866	30079	20180203	59945
20180115	2호선	신대방	30772	29167	20180118	59939
20180204	2호선	삼성(무역센터)	30514	29415	20180207	59929
20180118	2호선	신대방	30760	29141	20180121	59901
20180124	5호선	까치산	30627	29220	20180127	59847
20180117	경부선	금정	29851	29983	20180120	59834
20180119	2호선	시청	30292	29514	20180122	59806
20180207	2호선	신대방	30497	29297	20180210	59794
20180208	1호선	종로5가	29979	29708	20180211	59687
20180125	5호선	까치산	30496	29183	20180128	59679
20180120	2호선	선릉	32176	27482	20180123	59658
20180212	2호선	신대방	30669	28944	20180215	59613
20180126	4호선	회현(남대문시장)	29185	30400	20180129	59585
20180206	과천선	범계	30177	29386	20180209	59563
20180128	4호선	명동	28813	30749	20180131	59562
20180212	경부선	금정	29683	29855	20180215	59538
20180119	1호선	종로5가	29829	29705	20180122	59534
20180129	분당선	서현	29757	29762	20180201	59519
20180119	7호선	광명사거리	30060	29456	20180122	59516
20180125	분당선	야탑	29191	30322	20180128	59513
20180203	2호선	선릉	32177	27288	20180206	59465
20180205	5호선	여의도	28902	30524	20180208	59426
20180122	9호선	노량진	29314	30077	20180125	59391
20180123	과천선	범계	30099	29266	20180126	59365
20180126	9호선	노량진	29232	30123	20180129	59355
20180130	2호선	잠실새내	29397	29934	20180202	59331
20180124	분당선	야탑	29010	30252	20180127	59262
20180205	과천선	범계	30050	29209	20180208	59259
20180201	2호선	시청	29882	29339	20180204	59221
20180128	5호선	광화문(세종문화회관)	28761	30450	20180131	59211
20180112	5호선	여의도	28655	30552	20180115	59207
20180125	5호선	화곡	30710	28467	20180128	59177
20180208	경부선	금정	29541	29578	20180211	59119
20180124	5호선	화곡	30606	28440	20180127	59046
20180115	경부선	금정	29420	29625	20180118	59045
20180123	분당선	서현	29248	29784	20180126	59032
20180125	4호선	회현(남대문시장)	28880	30146	20180128	59026
20180127	1호선	종로3가	29640	29374	20180130	59014
20180124	5호선	여의도	28775	30197	20180127	58972
20180125	4호선	창동	28372	30580	20180128	58952
20180114	경인선	부천	29865	29084	20180117	58949
20180114	2호선	사당	27631	31316	20180117	58947
20180130	경부선	금정	29383	29556	20180202	58939
20180122	2호선	신대방	30207	28727	20180125	58934
20180126	5호선	화곡	30844	28083	20180129	58927
20180118	경부선	금정	29296	29625	20180121	58921
20180204	4호선	명동	28685	30216	20180207	58901
20180118	4호선	사당	32217	26672	20180121	58889
20180118	2호선	시청	29693	29165	20180121	58858
20180126	2호선	대림(구로구청)	29052	29794	20180129	58846
20180212	2호선	시청	29573	29263	20180215	58836
20180119	3호선	안국	28800	29993	20180122	58793
20180122	1호선	종로5가	29821	28890	20180125	58711
20180113	2호선	선릉	31840	26867	20180116	58707
20180130	1호선	종로5가	30565	28138	20180202	58703
20180131	7호선	광명사거리	29663	29015	20180203	58678
20180119	중앙선	회기	30048	28616	20180122	58664
20180124	4호선	회현(남대문시장)	28685	29959	20180127	58644
20180117	2호선	시청	29593	29050	20180120	58643
20180212	1호선	청량리(서울시립대입구)	28894	29741	20180215	58635
20180113	3호선	양재(서초구청)	28712	29910	20180116	58622
20180203	4호선	회현(남대문시장)	29399	29173	20180206	58572
20180120	4호선	회현(남대문시장)	28818	29748	20180123	58566
20180117	5호선	오목교(목동운동장앞)	28305	30259	20180120	58564
20180208	7호선	광명사거리	29591	28949	20180211	58540
20180206	2호선	시청	29565	28963	20180209	58528
20180129	과천선	범계	29891	28608	20180201	58499
20180204	경인선	부평	28820	29671	20180207	58491
20180212	1호선	종로5가	29413	29073	20180215	58486
20180208	2호선	잠실새내	29436	29022	20180211	58458
20180126	경인선	역곡	29889	28542	20180129	58431
20180122	경부선	금정	28945	29483	20180125	58428
20180125	2호선	대림(구로구청)	28931	29481	20180128	58412
20180130	1호선	청량리(서울시립대입구)	28814	29589	20180202	58403
20180201	2호선	잠실새내	29211	29130	20180204	58341
20180130	5호선	오목교(목동운동장앞)	28257	30083	20180202	58340
20180112	2호선	잠실새내	28501	29831	20180115	58332
20180118	5호선	오목교(목동운동장앞)	28216	30113	20180121	58329
20180129	5호선	여의도	28428	29887	20180201	58315
20180112	4호선	사당	31431	26845	20180115	58276
20180121	2호선	사당	27234	31016	20180124	58250
20180117	4호선	사당	31521	26728	20180120	58249
20180201	경부선	금정	28929	29265	20180204	58194
20180117	7호선	광명사거리	29377	28812	20180120	58189
20180126	5호선	여의도	28212	29969	20180129	58181
20180115	1호선	종로5가	29129	29051	20180118	58180
20180123	9호선	노량진	28772	29406	20180126	58178
20180206	2호선	신대방	29832	28318	20180209	58150
20180125	5호선	여의도	28240	29903	20180128	58143
20180205	9호선	노량진	28815	29299	20180208	58114
20180212	2호선	잠실새내	29084	29011	20180215	58095
20180208	4호선	사당	31524	26570	20180211	58094
20180124	4호선	창동	27991	30100	20180127	58091
20180120	1호선	청량리(서울시립대입구)	28076	30011	20180123	58087
20180117	2호선	잠실새내	29076	29009	20180120	58085
20180131	5호선	오목교(목동운동장앞)	27998	30082	20180203	58080
20180212	7호선	광명사거리	29344	28725	20180215	58069
20180113	5호선	광화문(세종문화회관)	29115	28952	20180116	58067
20180131	1호선	청량리(서울시립대입구)	28694	29363	20180203	58057
20180205	2호선	신대방	29776	28249	20180208	58025
20180206	9호선	노량진	28723	29274	20180209	57997
20180115	1호선	청량리(서울시립대입구)	28747	29237	20180118	57984
20180118	중앙선	회기	29457	28520	20180121	57977
20180208	5호선	오목교(목동운동장앞)	28132	29825	20180211	57957
20180125	경인선	역곡	29312	28641	20180128	57953
20180123	2호선	신대방	29678	28250	20180126	57928
20180204	경인선	부천	29324	28598	20180207	57922
20180124	2호선	대림(구로구청)	28658	29211	20180127	57869
20180122	1호선	청량리(서울시립대입구)	28407	29436	20180125	57843
20180125	4호선	미아사거리	29343	28494	20180128	57837
20180207	경부선	금정	28784	29030	20180210	57814
20180205	2호선	시청	29201	28586	20180208	57787
20180123	2호선	시청	29372	28403	20180126	57775
20180119	1호선	시청	28884	28886	20180122	57770
20180130	3호선	안국	29891	27867	20180202	57758
20180201	1호선	종로5가	28993	28750	20180204	57743
20180118	2호선	잠실새내	28894	28844	20180121	57738
20180118	7호선	광명사거리	29118	28595	20180121	57713
20180201	7호선	광명사거리	29086	28617	20180204	57703
20180118	1호선	종로5가	28951	28745	20180121	57696
20180125	분당선	서현	28645	28995	20180128	57640
20180124	4호선	미아사거리	29295	28333	20180127	57628
20180129	2호선	신대방	29641	27908	20180201	57549
20180117	중앙선	회기	29072	28449	20180120	57521
20180124	경인선	역곡	29132	28335	20180127	57467
20180118	1호선	청량리(서울시립대입구)	28118	29347	20180121	57465
20180124	과천선	범계	29057	28404	20180127	57461
20180126	2호선	시청	29259	28174	20180129	57433
20180131	1호선	종로5가	28754	28665	20180203	57419
20180130	7호선	광명사거리	28605	28802	20180202	57407
20180129	9호선	노량진	28411	28969	20180201	57380
20180207	2호선	잠실새내	28726	28651	20180210	57377
20180127	2호선	선릉	30999	26374	20180130	57373
20180119	4호선	동대문	28367	28962	20180122	57329
20180117	1호선	청량리(서울시립대입구)	28071	29211	20180120	57282
20180122	7호선	광명사거리	28849	28406	20180125	57255
20180212	5호선	오목교(목동운동장앞)	27765	29457	20180215	57222
20180207	5호선	오목교(목동운동장앞)	27676	29515	20180210	57191
20180122	중앙선	회기	28559	28618	20180125	57177
20180112	2호선	시청	29111	28066	20180115	57177
20180130	1호선	시청	29266	27906	20180202	57172
20180124	2호선	시청	28938	28226	20180127	57164
20180117	과천선	인덕원	28838	28324	20180120	57162
20180207	1호선	청량리(서울시립대입구)	28125	29032	20180210	57157
20180124	분당선	서현	28330	28813	20180127	57143
20180131	과천선	인덕원	28911	28227	20180203	57138
20180130	중앙선	회기	28773	28362	20180202	57135
20180122	2호선	시청	29064	28071	20180125	57135
20180125	과천선	범계	29040	28079	20180128	57119
20180207	7호선	광명사거리	28793	28271	20180210	57064
20180201	4호선	사당	31059	25948	20180204	57007
20180118	과천선	인덕원	28751	28253	20180121	57004
20180112	2호선	신대방	29497	27507	20180115	57004
20180115	2호선	잠실새내	28565	28418	20180118	56983
20180117	3호선	안국	27880	29085	20180120	56965
20180208	중앙선	회기	28671	28285	20180211	56956
20180115	7호선	광명사거리	28812	28141	20180118	56953
20180125	9호선	노량진	28089	28852	20180128	56941
20180211	경인선	부천	28792	28111	20180214	56903
20180131	4호선	사당	31177	25711	20180203	56888
20180125	2호선	시청	28916	27970	20180128	56886
20180126	2호선	잠실새내	27921	28961	20180129	56882
20180117	1호선	종로5가	28463	28385	20180120	56848
20180201	중앙선	회기	28696	28072	20180204	56768
20180120	9호선	노량진	27107	29627	20180123	56734
20180115	중앙선	회기	28572	28158	20180118	56730
20180206	경부선	금정	28231	28456	20180209	56687
20180130	과천선	인덕원	28283	28400	20180202	56683
20180130	7호선	학동	27825	28821	20180202	56646
20180128	경인선	부천	28733	27860	20180131	56593
20180112	경부선	금정	28275	28311	20180115	56586
20180130	4호선	동대문	28616	27968	20180202	56584
20180115	2호선	시청	28549	28026	20180118	56575
20180123	경부선	금정	28212	28352	20180126	56564
20180124	9호선	노량진	27962	28545	20180127	56507
20180126	4호선	사당	30916	25528	20180129	56444
20180205	경부선	금정	27989	28438	20180208	56427
20180119	7호선	철산	27680	28743	20180122	56423
20180208	3호선	안국	27231	29080	20180211	56311
20180120	2호선	역삼	27214	29061	20180123	56275
20180122	2호선	잠실새내	28224	28038	20180125	56262
20180205	7호선	광명사거리	28261	27964	20180208	56225
20180131	중앙선	회기	28509	27715	20180203	56224
20180120	9호선	신논현	27593	28594	20180123	56187
20180201	5호선	오목교(목동운동장앞)	27255	28869	20180204	56124
20180207	4호선	사당	30414	25680	20180210	56094
20180131	1호선	시청	28116	27968	20180203	56084
20180208	1호선	시청	27952	28130	20180211	56082
20180129	경부선	금정	27825	28229	20180201	56054
20180112	5호선	오목교(목동운동장앞)	26919	29100	20180115	56019
20180115	과천선	인덕원	28285	27715	20180118	56000
20180208	과천선	인덕원	28130	27865	20180211	55995
20180122	과천선	인덕원	27975	28018	20180125	55993
20180126	2호선	신대방	28996	26993	20180129	55989
20180127	3호선	양재(서초구청)	27532	28455	20180130	55987
20180124	2호선	신대방	28471	27515	20180127	55986
20180129	2호선	시청	28419	27561	20180201	55980
20180118	1호선	시청	27931	28020	20180121	55951
20180125	2호선	신대방	28763	27179	20180128	55942
20180115	5호선	오목교(목동운동장앞)	27065	28863	20180118	55928
20180201	4호선	동대문	27561	28340	20180204	55901
20180122	5호선	오목교(목동운동장앞)	27090	28766	20180125	55856
20180206	2호선	잠실새내	27967	27860	20180209	55827
20180113	9호선	노량진	26983	28790	20180116	55773
20180208	1호선	제기동	27208	28530	20180211	55738
20180203	9호선	신논현	27524	28206	20180206	55730
20180201	과천선	인덕원	27935	27764	20180204	55699
20180119	4호선	노원	25781	29869	20180122	55650
20180117	1호선	시청	27765	27863	20180120	55628
20180131	3호선	안국	26890	28712	20180203	55602
20180212	4호선	사당	30206	25385	20180215	55591
20180120	4호선	미아사거리	28255	27325	20180123	55580
20180114	2호선	을지로입구	28564	27014	20180117	55578
20180212	과천선	인덕원	27991	27578	20180215	55569
20180207	3호선	안국	26955	28599	20180210	55554
20180212	중앙선	회기	28205	27281	20180215	55486
20180207	과천선	인덕원	27869	27602	20180210	55471
20180118	3호선	안국	26809	28641	20180121	55450
20180203	9호선	노량진	26851	28591	20180206	55442
20180131	4호선	동대문	27220	28203	20180203	55423
20180122	4호선	동대문	27773	27641	20180125	55414
20180115	4호선	사당	30300	25082	20180118	55382
20180211	2호선	을지로입구	28336	27030	20180214	55366
20180122	4호선	사당	30249	25094	20180125	55343
20180207	1호선	종로5가	27823	27512	20180210	55335
20180112	과천선	인덕원	27976	27346	20180115	55322
20180117	4호선	동대문	27398	27922	20180120	55320
20180118	4호선	동대문	27187	28072	20180121	55259
20180206	7호선	광명사거리	27867	27329	20180209	55196
20180207	1호선	시청	27689	27501	20180210	55190
20180201	1호선	시청	27565	27594	20180204	55159
20180206	5호선	오목교(목동운동장앞)	26633	28452	20180209	55085
20180129	7호선	광명사거리	27779	27280	20180201	55059
20180113	9호선	신논현	26769	28287	20180116	55056
20180120	과천선	범계	27915	27137	20180123	55052
20180203	1호선	청량리(서울시립대입구)	26669	28301	20180206	54970
20180128	2호선	을지로입구	28351	26619	20180131	54970
20180205	2호선	잠실새내	27607	27332	20180208	54939
20180113	1호선	청량리(서울시립대입구)	26549	28382	20180116	54931
20180123	2호선	잠실새내	27630	27293	20180126	54923
20180207	중앙선	회기	27652	27207	20180210	54859
20180115	4호선	동대문	27194	27625	20180118	54819
20180113	과천선	범계	27922	26856	20180116	54778
20180117	2호선	구의(광진구청)	27778	26990	20180120	54768
20180126	5호선	오목교(목동운동장앞)	26358	28403	20180129	54761
20180206	4호선	사당	29809	24922	20180209	54731
20180121	2호선	을지로입구	28283	26444	20180124	54727
20180130	2호선	영등포구청	27470	27221	20180202	54691
20180211	2호선	사당	25497	29186	20180214	54683
20180129	2호선	잠실새내	27454	27218	20180201	54672
20180117	7호선	학동	25980	28689	20180120	54669
20180208	4호선	동대문	27093	27573	20180211	54666
20180123	5호선	오목교(목동운동장앞)	26520	28125	20180126	54645
20180130	2호선	구의(광진구청)	27119	27474	20180202	54593
20180128	2호선	사당	25450	29131	20180131	54581
20180126	경부선	금정	27395	27176	20180129	54571
20180112	1호선	시청	27364	27202	20180115	54566
20180212	4호선	동대문	27079	27476	20180215	54555
20180123	7호선	광명사거리	27465	27042	20180126	54507
20180201	3호선	안국	26407	28033	20180204	54440
20180204	2호선	사당	25584	28848	20180207	54432
20180123	과천선	인덕원	27152	27256	20180126	54408
20180119	2호선	구의(광진구청)	27686	26694	20180122	54380
20180129	분당선	모란	26903	27469	20180201	54372
20180206	중앙선	회기	27401	26950	20180209	54351
20180118	7호선	학동	25729	28611	20180121	54340
20180131	7호선	학동	25592	28745	20180203	54337
20180119	7호선	학동	25391	28943	20180122	54334
20180201	7호선	학동	25705	28589	20180204	54294
20180112	7호선	광명사거리	27490	26803	20180115	54293
20180113	4호선	미아사거리	27524	26768	20180116	54292
20180208	7호선	철산	26940	27344	20180211	54284
20180206	3호선	안국	26525	27617	20180209	54142
20180130	4호선	사당	28402	25738	20180202	54140
20180212	1호선	시청	27093	27045	20180215	54138
20180205	5호선	오목교(목동운동장앞)	26221	27912	20180208	54133
20180117	7호선	철산	26648	27447	20180120	54095
20180205	중앙선	회기	27322	26740	20180208	54062
20180130	7호선	철산	26328	27701	20180202	54029
20180208	7호선	학동	25556	28415	20180211	53971
20180131	2호선	영등포구청	26594	27346	20180203	53940
20180206	과천선	인덕원	26952	26983	20180209	53935
20180129	중앙선	회기	27157	26765	20180201	53922
20180119	경부선	안양	26879	27036	20180122	53915
20180118	7호선	철산	26785	27106	20180121	53891
20180205	과천선	인덕원	27016	26873	20180208	53889
20180124	5호선	오목교(목동운동장앞)	26103	27775	20180127	53878
20180131	7호선	철산	26710	27151	20180203	53861
20180207	2호선	구의(광진구청)	27204	26646	20180210	53850
20180126	7호선	학동	25634	28205	20180129	53839
20180118	2호선	구의(광진구청)	27160	26660	20180121	53820
20180212	7호선	학동	25649	28163	20180215	53812
20180112	중앙선	회기	27331	26451	20180115	53782
20180123	4호선	사당	29465	24306	20180126	53771
20180117	2호선	영등포구청	26715	27043	20180120	53758
20180119	3호선	경복궁(정부서울청사)	26651	27103	20180122	53754
20180208	2호선	구의(광진구청)	27209	26534	20180211	53743
20180207	4호선	동대문	26568	27160	20180210	53728
20180125	2호선	잠실새내	26878	26847	20180128	53725
20180208	2호선	영등포구청	26662	27061	20180211	53723
20180203	4호선	미아사거리	27280	26443	20180206	53723
20180121	3호선	연신내	27452	26202	20180124	53654
20180126	과천선	인덕원	27091	26559	20180129	53650
20180129	5호선	오목교(목동운동장앞)	25976	27660	20180201	53636
20180123	1호선	시청	26901	26692	20180126	53593
20180126	7호선	광명사거리	26990	26590	20180129	53580
20180125	경부선	금정	26605	26968	20180128	53573
20180125	4호선	사당	29392	24178	20180128	53570
20180131	2호선	구의(광진구청)	27356	26207	20180203	53563
20180206	7호선	학동	25493	28057	20180209	53550
20180119	2호선	영등포구청	26745	26795	20180122	53540
20180124	경부선	금정	26652	26886	20180127	53538
20180126	1호선	시청	27040	26497	20180129	53537
20180207	7호선	학동	25487	28047	20180210	53534
20180118	2호선	영등포구청	26512	26944	20180121	53456
20180206	1호선	종로5가	26865	26588	20180209	53453
20180129	1호선	종로5가	26793	26644	20180201	53437
20180205	4호선	동대문	26396	27038	20180208	53434
20180201	2호선	구의(광진구청)	26965	26457	20180204	53422
20180212	2호선	구의(광진구청)	26750	26662	20180215	53412
20180212	7호선	철산	26363	27048	20180215	53411
20180204	2호선	을지로입구	27231	26172	20180207	53403
20180115	1호선	시청	26714	26689	20180118	53403
20180114	3호선	연신내	27224	26141	20180117	53365
20180205	4호선	사당	29269	24083	20180208	53352
20180122	3호선	안국	26419	26932	20180125	53351
20180205	3호선	안국	26015	27309	20180208	53324
20180122	1호선	시청	26678	26643	20180125	53321
20180122	7호선	학동	25540	27763	20180125	53303
20180125	7호선	학동	25388	27887	20180128	53275
20180123	7호선	학동	25403	27834	20180126	53237
20180130	7호선	청담	25752	27463	20180202	53215
20180115	2호선	영등포구청	26237	26965	20180118	53202
20180113	4호선	회현(남대문시장)	26536	26658	20180116	53194
20180120	6호선	이태원	23522	29660	20180123	53182
20180206	1호선	시청	26946	26212	20180209	53158
20180203	과천선	범계	26846	26311	20180206	53157
20180212	2호선	영등포구청	26299	26811	20180215	53110
20180119	4호선	총신대입구(이수)	24906	28176	20180122	53082
20180129	과천선	인덕원	26453	26626	20180201	53079
20180115	2호선	구의(광진구청)	26782	26285	20180118	53067
20180115	7호선	학동	25285	27761	20180118	53046
20180207	7호선	철산	26263	26770	20180210	53033
20180122	7호선	철산	26202	26804	20180125	53006
20180125	5호선	오목교(목동운동장앞)	25571	27375	20180128	52946
20180117	4호선	노원	24756	28190	20180120	52946
20180115	7호선	철산	26293	26652	20180118	52945
20180201	2호선	영등포구청	26285	26581	20180204	52866
20180112	7호선	학동	24984	27868	20180115	52852
20180201	7호선	철산	26205	26636	20180204	52841
20180205	1호선	종로5가	26655	26180	20180208	52835
20180129	4호선	사당	28837	23988	20180201	52825
20180122	2호선	구의(광진구청)	26500	26296	20180125	52796
20180123	중앙선	회기	26749	26030	20180126	52779
20180129	7호선	학동	25133	27643	20180201	52776
20180206	4호선	동대문	26124	26632	20180209	52756
20180117	2호선	서초	26169	26576	20180120	52745
20180124	4호선	사당	28856	23855	20180127	52711
20180118	3호선	경복궁(정부서울청사)	26078	26603	20180121	52681
20180207	2호선	영등포구청	26148	26522	20180210	52670
20180119	경인선	개봉	26367	26302	20180122	52669
20180113	분당선	서현	26204	26439	20180116	52643
20180120	4호선	쌍문	28255	24382	20180123	52637
20180207	2호선	서초	26160	26439	20180210	52599
20180125	7호선	광명사거리	26521	26071	20180128	52592
20180205	7호선	학동	25081	27482	20180208	52563
20180119	4호선	성신여대입구(돈암)	26477	26066	20180122	52543
20180206	1호선	청량리(서울시립대입구)	25924	26593	20180209	52517
20180115	3호선	안국	25544	26971	20180118	52515
20180127	9호선	신논현	25724	26786	20180130	52510
20180131	7호선	청담	24030	28392	20180203	52422
20180120	2호선	교대(법원.검찰청)	24588	27813	20180123	52401
20180123	3호선	안국	25510	26856	20180126	52366
20180212	3호선	안국	25630	26726	20180215	52356
20180113	경인선	송내	26794	25548	20180116	52342
20180203	2호선	역삼	25518	26816	20180206	52334
20180122	2호선	영등포구청	26106	26227	20180125	52333
20180120	경인선	송내	26726	25599	20180123	52325
20180211	3호선	연신내	26835	25477	20180214	52312
20180120	4호선	사당	27277	25019	20180123	52296
20180112	7호선	철산	25693	26603	20180115	52296
20180125	1호선	시청	26232	26029	20180128	52261
20180113	2호선	교대(법원.검찰청)	24718	27518	20180116	52236
20180124	7호선	광명사거리	26347	25886	20180127	52233
20180130	3호선	경복궁(정부서울청사)	27970	24242	20180202	52212
20180206	2호선	구의(광진구청)	26376	25829	20180209	52205
20180205	1호선	청량리(서울시립대입구)	25715	26487	20180208	52202
20180205	1호선	시청	26200	25964	20180208	52164
20180124	2호선	잠실새내	26355	25808	20180127	52163
20180212	2호선	서초	26004	26156	20180215	52160
20180203	분당선	서현	25892	26259	20180206	52151
20180125	과천선	인덕원	26053	26095	20180128	52148
20180113	2호선	역삼	25129	27018	20180116	52147
20180120	1호선	종로5가	26136	25955	20180123	52091
20180124	과천선	인덕원	25902	26187	20180127	52089
20180123	4호선	동대문	25847	26221	20180126	52068
20180118	2호선	서초	25727	26331	20180121	52058
20180129	4호선	동대문	25727	26315	20180201	52042
20180207	4호선	노원	24462	27552	20180210	52014
20180129	1호선	청량리(서울시립대입구)	25670	26342	20180201	52012
20180124	7호선	학동	24828	27146	20180127	51974
20180208	3호선	경복궁(정부서울청사)	25843	26093	20180211	51936
20180119	2호선	당산	24537	27399	20180122	51936
20180131	4호선	노원	24371	27538	20180203	51909
20180208	2호선	서초	25777	26087	20180211	51864
20180115	4호선	노원	24455	27355	20180118	51810
20180201	7호선	청담	24066	27726	20180204	51792
20180117	3호선	경복궁(정부서울청사)	25828	25950	20180120	51778
20180118	4호선	노원	24543	27233	20180121	51776
20180206	2호선	영등포구청	25812	25933	20180209	51745
20180130	4호선	성신여대입구(돈암)	25274	26469	20180202	51743
20180119	7호선	노원	24654	27079	20180122	51733
20180208	4호선	노원	24414	27312	20180211	51726
20180207	3호선	경복궁(정부서울청사)	25895	25829	20180210	51724
20180120	경인선	역곡	26422	25277	20180123	51699
20180205	2호선	구의(광진구청)	26106	25589	20180208	51695
20180112	4호선	동대문	25419	26270	20180115	51689
20180131	2호선	을지로3가	25839	25829	20180203	51668
20180126	중앙선	회기	26103	25557	20180129	51660
20180203	4호선	쌍문	27658	23978	20180206	51636
20180117	경인선	개봉	25503	26129	20180120	51632
20180131	3호선	경복궁(정부서울청사)	25757	25860	20180203	51617
20180126	7호선	철산	25218	26396	20180129	51614
20180120	분당선	서현	25575	26018	20180123	51593
20180120	4호선	창동	25180	26396	20180123	51576
20180119	7호선	청담	23789	27770	20180122	51559
20180112	1호선	종로5가	25750	25799	20180115	51549
20180208	경인선	개봉	25483	26041	20180211	51524
20180113	경인선	역곡	26421	25084	20180116	51505
20180206	7호선	철산	25458	26037	20180209	51495
20180131	2호선	서초	25178	26297	20180203	51475
20180131	경인선	개봉	25645	25828	20180203	51473
20180204	3호선	연신내	26322	25120	20180207	51442
20180124	1호선	시청	26093	25349	20180127	51442
20180123	1호선	종로5가	25882	25525	20180126	51407
20180123	7호선	철산	25620	25769	20180126	51389
20180203	중앙선	회기	25867	25520	20180206	51387
20180201	1호선	제기동	25221	26148	20180204	51369
20180205	2호선	영등포구청	25474	25886	20180208	51360
20180118	경인선	개봉	25293	26044	20180121	51337
20180205	7호선	철산	25381	25939	20180208	51320
20180119	2호선	서초	25395	25886	20180122	51281
20180127	9호선	노량진	24819	26444	20180130	51263
20180208	7호선	청담	23628	27624	20180211	51252
20180129	2호선	구의(광진구청)	25827	25419	20180201	51246
20180130	4호선	길음	25125	26112	20180202	51237
20180113	1호선	종로5가	26947	24229	20180116	51176
20180207	경부선	안양	25597	25529	20180210	51126
20180129	1호선	시청	25613	25468	20180201	51081
20180130	2호선	서초	25524	25544	20180202	51068
20180130	경인선	개봉	24700	26353	20180202	51053
20180129	2호선	영등포구청	25263	25781	20180201	51044
20180117	2호선	을지로3가	25591	25429	20180120	51020
20180113	4호선	쌍문	27519	23489	20180116	51008
20180112	3호선	안국	24987	26020	20180115	51007
20180119	2호선	을지로3가	25443	25554	20180122	50997
20180208	2호선	봉천	26365	24629	20180211	50994
20180130	4호선	노원	23935	27036	20180202	50971
20180120	분당선	야탑	24754	26202	20180123	50956
20180122	경인선	개봉	24954	25986	20180125	50940
20180124	3호선	안국	25214	25719	20180127	50933
20180120	2호선	대림(구로구청)	24466	26466	20180123	50932
20180126	1호선	종로5가	25464	25458	20180129	50922
20180112	2호선	구의(광진구청)	25880	25023	20180115	50903
20180115	경인선	개봉	25115	25774	20180118	50889
20180117	4호선	총신대입구(이수)	24038	26846	20180120	50884
20180123	2호선	구의(광진구청)	25569	25308	20180126	50877
20180129	7호선	철산	25099	25775	20180201	50874
20180115	2호선	서초	25306	25565	20180118	50871
20180118	7호선	청담	23499	27371	20180121	50870
20180119	7호선	논현	23865	26986	20180122	50851
20180123	2호선	영등포구청	25297	25526	20180126	50823
20180201	경인선	개봉	25192	25612	20180204	50804
20180128	3호선	연신내	25825	24976	20180131	50801
20180125	중앙선	회기	25674	25118	20180128	50792
20180130	2호선	을지로3가	26012	24770	20180202	50782
20180208	4호선	총신대입구(이수)	23916	26833	20180211	50749
20180119	2호선	봉천	26768	23973	20180122	50741
20180117	경부선	안양	25455	25281	20180120	50736
20180125	1호선	종로5가	25473	25252	20180128	50725
20180117	2호선	봉천	26288	24434	20180120	50722
20180117	7호선	청담	23528	27172	20180120	50700
20180212	경인선	개봉	25091	25606	20180215	50697
20180207	7호선	청담	23596	27097	20180210	50693
20180201	4호선	노원	23866	26783	20180204	50649
20180121	4호선	수유(강북구청)	25949	24694	20180124	50643
20180129	3호선	안국	24826	25809	20180201	50635
20180201	2호선	봉천	26248	24368	20180204	50616
20180203	2호선	교대(법원.검찰청)	23816	26734	20180206	50550
20180120	2호선	잠실새내	24691	25805	20180123	50496
20180212	4호선	노원	23739	26739	20180215	50478
20180113	분당선	야탑	24655	25818	20180116	50473
20180117	4호선	성신여대입구(돈암)	25521	24928	20180120	50449
20180131	4호선	성신여대입구(돈암)	25672	24776	20180203	50448
20180201	2호선	을지로3가	25323	25117	20180204	50440
20180127	4호선	미아사거리	25558	24865	20180130	50423
20180207	2호선	을지로3가	25411	24994	20180210	50405
20180122	2호선	봉천	25888	24498	20180125	50386
20180208	2호선	을지로3가	25386	24984	20180211	50370
20180115	2호선	봉천	26033	24319	20180118	50352
20180125	3호선	안국	24722	25628	20180128	50350
20180201	3호선	경복궁(정부서울청사)	25170	25161	20180204	50331
20180212	2호선	봉천	26048	24272	20180215	50320
20180207	경인선	개봉	24825	25495	20180210	50320
20180118	경부선	안양	25301	25012	20180121	50313
20180208	경부선	안양	25461	24851	20180211	50312
20180118	2호선	을지로3가	25130	25172	20180121	50302
20180201	2호선	서초	24758	25526	20180204	50284
20180203	4호선	창동	24189	26070	20180206	50259
20180112	4호선	노원	23013	27225	20180115	50238
20180212	경부선	안양	25366	24871	20180215	50237
20180212	1호선	제기동	24411	25814	20180215	50225
20180131	경부선	안양	25383	24830	20180203	50213
20180126	4호선	동대문	24646	25554	20180129	50200
20180207	2호선	봉천	25954	24238	20180210	50192
20180113	4호선	창동	24384	25795	20180116	50179
20180130	2호선	봉천	25639	24534	20180202	50173
20180117	2호선	당산	23531	26629	20180120	50160
20180131	2호선	봉천	26182	23971	20180203	50153
20180125	7호선	철산	24862	25257	20180128	50119
20180212	4호선	총신대입구(이수)	23501	26592	20180215	50093
20180113	4호선	사당	26231	23860	20180116	50091
20180122	4호선	노원	23550	26535	20180125	50085
20180118	2호선	당산	23544	26537	20180121	50081
20180206	2호선	서초	24788	25292	20180209	50080
20180212	2호선	을지로3가	25227	24845	20180215	50072
20180115	7호선	청담	23425	26616	20180118	50041
20180120	경원선	의정부	23815	26222	20180123	50037
20180118	2호선	봉천	26139	23886	20180121	50025
20180203	2호선	낙성대	26114	23910	20180206	50024
20180120	2호선	낙성대	26276	23727	20180123	50003
20180123	2호선	서초	24619	25383	20180126	50002
20180126	2호선	구의(광진구청)	25441	24559	20180129	50000
20180112	1호선	청량리(서울시립대입구)	24493	25487	20180115	49980
20180120	5호선	까치산	25741	24207	20180123	49948
20180115	경부선	안양	25102	24820	20180118	49922
20180112	2호선	영등포구청	24831	25081	20180115	49912
20180125	2호선	구의(광진구청)	25163	24742	20180128	49905
20180115	4호선	총신대입구(이수)	23594	26311	20180118	49905
20180131	4호선	총신대입구(이수)	23664	26223	20180203	49887
20180207	4호선	총신대입구(이수)	23383	26495	20180210	49878
20180201	4호선	총신대입구(이수)	23432	26444	20180204	49876
20180118	4호선	총신대입구(이수)	23522	26340	20180121	49862
20180113	6호선	이태원	21905	27953	20180116	49858
20180118	4호선	성신여대입구(돈암)	25262	24591	20180121	49853
20180122	7호선	청담	23244	26607	20180125	49851
20180113	2호선	대림(구로구청)	23970	25866	20180116	49836
20180130	4호선	총신대입구(이수)	23242	26568	20180202	49810
20180212	7호선	청담	23044	26758	20180215	49802
20180206	7호선	청담	23036	26755	20180209	49791
20180125	4호선	동대문	24508	25266	20180128	49774
20180203	경인선	역곡	25426	24329	20180206	49755
20180201	경부선	안양	24985	24754	20180204	49739
20180124	중앙선	회기	25103	24612	20180127	49715
20180206	4호선	노원	23457	26229	20180209	49686
20180126	3호선	안국	24470	25188	20180129	49658
20180124	2호선	구의(광진구청)	25045	24591	20180127	49636
20180205	7호선	청담	23060	26569	20180208	49629
20180203	1호선	종로5가	25333	24296	20180206	49629
20180208	4호선	성신여대입구(돈암)	25326	24300	20180211	49626
20180122	2호선	서초	24684	24941	20180125	49625
20180203	경인선	송내	25179	24419	20180206	49598
20180201	4호선	성신여대입구(돈암)	25099	24483	20180204	49582
20180114	4호선	수유(강북구청)	25227	24351	20180117	49578
20180127	과천선	범계	25106	24471	20180130	49577
20180206	경인선	개봉	24303	25240	20180209	49543
20180208	4호선	길음	25042	24466	20180211	49508
20180203	6호선	이태원	22216	27274	20180206	49490
20180208	2호선	당산	23082	26407	20180211	49489
20180113	중앙선	회기	25250	24232	20180116	49482
20180206	2호선	을지로3가	24878	24588	20180209	49466
20180205	2호선	봉천	25598	23850	20180208	49448
20180119	4호선	길음	25649	23760	20180122	49409
20180124	4호선	동대문	24542	24864	20180127	49406
20180131	2호선	당산	23036	26349	20180203	49385
20180117	7호선	논현	23585	25795	20180120	49380
20180119	경인선	주안	25768	23576	20180122	49344
20180127	1호선	청량리(서울시립대입구)	24211	25121	20180130	49332
20180205	경인선	개봉	24256	25056	20180208	49312
20180212	3호선	경복궁(정부서울청사)	24341	24955	20180215	49296
20180131	4호선	길음	25379	23870	20180203	49249
20180123	1호선	청량리(서울시립대입구)	24296	24945	20180126	49241
20180123	7호선	청담	22891	26317	20180126	49208
20180126	2호선	영등포구청	24533	24654	20180129	49187
20180124	2호선	영등포구청	24596	24587	20180127	49183
20180128	4호선	수유(강북구청)	25145	24037	20180131	49182
20180201	2호선	당산	22788	26391	20180204	49179
20180121	2호선	합정	24055	25122	20180124	49177
20180113	2호선	잠실새내	23733	25397	20180116	49130
20180124	7호선	철산	24187	24942	20180127	49129
20180122	경부선	안양	24666	24463	20180125	49129
20180120	5호선	광화문(세종문화회관)	24483	24637	20180123	49120
20180130	2호선	당산	23028	26076	20180202	49104
20180115	2호선	당산	22975	26108	20180118	49083
20180113	5호선	까치산	25219	23851	20180116	49070
20180117	7호선	노원	23798	25259	20180120	49057
20180207	4호선	성신여대입구(돈암)	24757	24292	20180210	49049
20180120	경부선	안양	24461	24552	20180123	49013
20180112	경부선	안양	24364	24643	20180115	49007
20180117	4호선	길음	25042	23949	20180120	48991
20180211	4호선	수유(강북구청)	24988	23990	20180214	48978
20180130	7호선	논현	23474	25499	20180202	48973
20180119	분당선	미금	23731	25239	20180122	48970
20180113	2호선	낙성대	25791	23156	20180116	48947
20180115	4호선	성신여대입구(돈암)	24626	24302	20180118	48928
20180203	분당선	야탑	24041	24851	20180206	48892
20180122	2호선	을지로3가	24708	24183	20180125	48891
20180206	2호선	봉천	25327	23542	20180209	48869
20180125	2호선	영등포구청	24281	24586	20180128	48867
20180203	5호선	까치산	24957	23907	20180206	48864
20180205	2호선	서초	24259	24586	20180208	48845
20180205	2호선	을지로3가	24490	24344	20180208	48834
20180119	4호선	동대문역사문화공원	25208	23622	20180122	48830
20180204	4호선	수유(강북구청)	24806	24001	20180207	48807
20180203	2호선	대림(구로구청)	23575	25232	20180206	48807
20180120	3호선	경복궁(정부서울청사)	24352	24451	20180123	48803
20180212	4호선	성신여대입구(돈암)	24521	24238	20180215	48759
20180203	4호선	사당	25529	23225	20180206	48754
20180122	4호선	총신대입구(이수)	22759	25935	20180125	48694
20180212	7호선	노원	23647	25046	20180215	48693
20180130	경부선	안양	24276	24403	20180202	48679
20180203	2호선	잠실새내	23579	25084	20180206	48663
20180115	7호선	논현	23168	25466	20180118	48634
20180117	경인선	주안	25406	23199	20180120	48605
20180131	7호선	논현	23065	25515	20180203	48580
20180129	7호선	청담	22619	25957	20180201	48576
20180129	2호선	봉천	25102	23448	20180201	48550
20180118	7호선	논현	22974	25559	20180121	48533
20180123	2호선	봉천	24862	23670	20180126	48532
20180123	2호선	을지로3가	24487	24030	20180126	48517
20180115	2호선	을지로3가	24130	24370	20180118	48500
20180126	2호선	서초	24091	24395	20180129	48486
20180120	중앙선	회기	24735	23747	20180123	48482
20180130	7호선	노원	23561	24901	20180202	48462
20180205	4호선	노원	23023	25438	20180208	48461
20180119	5호선	천호(풍납토성)	23475	24981	20180122	48456
20180112	7호선	청담	22267	26175	20180115	48442
20180212	7호선	논현	23043	25367	20180215	48410
20180115	7호선	노원	23519	24882	20180118	48401
20180118	4호선	길음	24872	23518	20180121	48390
20180125	2호선	서초	23925	24450	20180128	48375
20180114	2호선	합정	23855	24508	20180117	48363
20180129	2호선	서초	24073	24272	20180201	48345
20180122	2호선	당산	22610	25718	20180125	48328
20180127	4호선	회현(남대문시장)	23803	24484	20180130	48287
20180126	4호선	노원	22439	25846	20180129	48285
20180124	2호선	서초	23859	24422	20180127	48281
20180207	2호선	당산	22417	25854	20180210	48271
20180203	5호선	광화문(세종문화회관)	24874	23394	20180206	48268
20180201	7호선	논현	22884	25296	20180204	48180
20180129	경인선	개봉	23765	24382	20180201	48147
20180131	7호선	노원	23236	24895	20180203	48131
20180118	경인선	주안	25218	22911	20180121	48129
20180130	9호선	여의도	25442	22681	20180202	48123
20180201	4호선	길음	24508	23614	20180204	48122
20180115	4호선	길음	24769	23334	20180118	48103
20180208	7호선	노원	23475	24626	20180211	48101
20180122	7호선	노원	23400	24695	20180125	48095
20180123	4호선	노원	22826	25258	20180126	48084
20180112	7호선	논현	22359	25711	20180115	48070
20180112	4호선	성신여대입구(돈암)	24282	23788	20180115	48070
20180119	경부선	구로	23440	24629	20180122	48069
20180113	경부선	안양	23898	24163	20180116	48061
20180112	2호선	을지로3가	24075	23950	20180115	48025
20180118	7호선	노원	23241	24782	20180121	48023
20180129	2호선	을지로3가	24311	23683	20180201	47994
20180207	4호선	길음	24346	23645	20180210	47991
20180206	4호선	총신대입구(이수)	22487	25495	20180209	47982
20180113	경인선	구일	22661	25315	20180116	47976
20180127	4호선	쌍문	25712	22234	20180130	47946
20180113	경원선	의정부	22509	25426	20180116	47935
20180124	2호선	을지로3가	24025	23902	20180127	47927
20180123	경인선	개봉	23522	24385	20180126	47907
20180125	7호선	청담	21946	25958	20180128	47904
20180112	2호선	봉천	25007	22897	20180115	47904
20180127	분당선	서현	23883	24018	20180130	47901
20180126	1호선	청량리(서울시립대입구)	23380	24513	20180129	47893
20180206	4호선	성신여대입구(돈암)	24200	23689	20180209	47889
20180129	4호선	노원	22538	25340	20180201	47878
20180131	9호선	여의도	24137	23717	20180203	47854
20180125	1호선	청량리(서울시립대입구)	23414	24435	20180128	47849
20180119	9호선	여의도	24662	23156	20180122	47818
20180206	3호선	경복궁(정부서울청사)	24044	23763	20180209	47807
20180122	7호선	논현	22623	25156	20180125	47779
20180212	2호선	당산	22234	25535	20180215	47769
20180112	4호선	총신대입구(이수)	22256	25508	20180115	47764
20180112	2호선	서초	23725	24022	20180115	47747
20180124	1호선	종로5가	24041	23702	20180127	47743
20180122	4호선	성신여대입구(돈암)	23993	23725	20180125	47718
20180211	2호선	합정	23606	24110	20180214	47716
20180208	분당선	모란	23810	23887	20180211	47697
20180125	2호선	을지로3가	23809	23881	20180128	47690
20180112	경인선	개봉	23674	23976	20180115	47650
20180112	2호선	당산	22372	25273	20180115	47645
20180131	경인선	주안	24949	22687	20180203	47636
20180207	7호선	논현	22593	25030	20180210	47623
20180112	3호선	경복궁(정부서울청사)	23774	23842	20180115	47616
20180212	4호선	길음	24339	23262	20180215	47601
20180126	2호선	을지로3가	23969	23631	20180129	47600
20180126	4호선	성신여대입구(돈암)	23956	23642	20180129	47598
20180208	7호선	논현	22561	24997	20180211	47558
20180122	4호선	길음	24221	23305	20180125	47526
20180124	분당선	모란	23696	23787	20180127	47483
20180126	7호선	청담	21771	25697	20180129	47468
20180207	1호선	제기동	23283	24142	20180210	47425
20180124	7호선	청담	21843	25544	20180127	47387
20180120	5호선	화곡	24578	22809	20180123	47387
20180115	경인선	주안	24848	22526	20180118	47374
20180206	4호선	길음	23992	23309	20180209	47301
20180212	분당선	미금	22716	24578	20180215	47294
20180129	경부선	안양	23741	23549	20180201	47290
20180119	2호선	문래	23505	23757	20180122	47262
20180205	4호선	성신여대입구(돈암)	23859	23399	20180208	47258
20180207	7호선	노원	22981	24267	20180210	47248
20180201	7호선	노원	22919	24306	20180204	47225
20180205	경부선	안양	23891	23323	20180208	47214
20180212	분당선	모란	23620	23583	20180215	47203
20180205	4호선	총신대입구(이수)	22086	25085	20180208	47171
20180126	경부선	안양	23496	23672	20180129	47168
20180125	2호선	봉천	24394	22772	20180128	47166
20180206	2호선	당산	21932	25232	20180209	47164
20180208	2호선	문래	23472	23658	20180211	47130
20180112	7호선	노원	22476	24632	20180115	47108
20180131	2호선	문래	23237	23859	20180203	47096
20180203	경원선	의정부	22487	24583	20180206	47070
20180117	9호선	여의도	24057	22970	20180120	47027
20180129	4호선	성신여대입구(돈암)	23618	23377	20180201	46995
20180127	2호선	교대(법원.검찰청)	22121	24873	20180130	46994
20180127	2호선	낙성대	24670	22306	20180130	46976
20180208	분당선	미금	22630	24327	20180211	46957
20180117	2호선	문래	23330	23613	20180120	46943
20180119	1호선	제기동	23218	23719	20180122	46937
20180208	경인선	주안	24361	22560	20180211	46921
20180130	2호선	문래	23540	23376	20180202	46916
20180123	4호선	총신대입구(이수)	22118	24794	20180126	46912
20180118	분당선	모란	23465	23440	20180121	46905
20180123	4호선	성신여대입구(돈암)	23592	23312	20180126	46904
20180126	4호선	총신대입구(이수)	21972	24923	20180129	46895
20180120	7호선	광명사거리	23565	23314	20180123	46879
20180205	3호선	경복궁(정부서울청사)	23535	23339	20180208	46874
20180119	8호선	천호(풍납토성)	21918	24932	20180122	46850
20180212	2호선	문래	23294	23544	20180215	46838
20180130	1호선	제기동	23215	23609	20180202	46824
20180201	분당선	모란	23446	23371	20180204	46817
20180206	경부선	안양	23630	23185	20180209	46815
20180120	2호선	신대방	24167	22622	20180123	46789
20180205	7호선	논현	22134	24649	20180208	46783
20180127	분당선	야탑	22982	23801	20180130	46783
20180129	4호선	총신대입구(이수)	21827	24952	20180201	46779
20180117	분당선	미금	22495	24281	20180120	46776
20180118	9호선	여의도	23722	23053	20180121	46775
20180117	분당선	모란	23377	23377	20180120	46754
20180118	4호선	동대문역사문화공원	24114	22596	20180121	46710
20180123	7호선	논현	22035	24656	20180126	46691
20180131	분당선	모란	23392	23295	20180203	46687
20180123	2호선	당산	21624	25057	20180126	46681
20180203	5호선	화곡	24363	22317	20180206	46680
20180130	9호선	가양	23478	23200	20180202	46678
20180131	경부선	구로	22770	23906	20180203	46676
20180117	5호선	천호(풍납토성)	22755	23919	20180120	46674
20180122	3호선	경복궁(정부서울청사)	23512	23140	20180125	46652
20180126	3호선	경복궁(정부서울청사)	23429	23217	20180129	46646
20180115	3호선	경복궁(정부서울청사)	23112	23519	20180118	46631
20180206	7호선	논현	22076	24537	20180209	46613
20180126	2호선	봉천	24176	22431	20180129	46607
20180201	2호선	문래	23184	23407	20180204	46591
20180115	1호선	제기동	22962	23626	20180118	46588
20180207	9호선	여의도	23834	22750	20180210	46584
20180207	2호선	문래	23198	23381	20180210	46579
20180115	분당선	모란	23201	23377	20180118	46578
20180117	경부선	구로	22918	23657	20180120	46575
20180118	경부선	구로	22770	23774	20180121	46544
20180131	4호선	동대문역사문화공원	24024	22519	20180203	46543
20180127	4호선	창동	22533	24009	20180130	46542
20180122	경인선	주안	24242	22300	20180125	46542
20180208	9호선	여의도	23833	22697	20180211	46530
20180126	7호선	논현	21635	24881	20180129	46516
20180122	1호선	제기동	23111	23403	20180125	46514
20180118	2호선	문래	23116	23395	20180121	46511
20180201	4호선	동대문역사문화공원	24132	22372	20180204	46504
20180206	7호선	노원	22636	23861	20180209	46497
20180113	5호선	화곡	24221	22266	20180116	46487
20180205	4호선	길음	23562	22917	20180208	46479
20180131	분당선	미금	22369	24096	20180203	46465
20180115	분당선	미금	22312	24122	20180118	46434
20180118	분당선	미금	22402	24010	20180121	46412
20180115	2호선	문래	23055	23347	20180118	46402
20180127	2호선	역삼	22469	23931	20180130	46400
20180129	7호선	논현	21874	24500	20180201	46374
20180119	경원선	의정부	22302	24048	20180122	46350
20180123	경부선	안양	23340	23009	20180126	46349
20180122	분당선	모란	23082	23252	20180125	46334
20180129	7호선	노원	22665	23636	20180201	46301
20180120	경부선	금정	23445	22850	20180123	46295
20180131	1호선	제기동	22803	23461	20180203	46264
20180204	2호선	합정	22892	23363	20180207	46255
20180126	경인선	개봉	22957	23281	20180129	46238
20180212	9호선	여의도	23662	22575	20180215	46237
20180203	7호선	광명사거리	23198	23032	20180206	46230
20180203	경부선	안양	22976	23250	20180206	46226
20180125	경인선	개봉	22746	23479	20180128	46225
20180207	경인선	주안	24042	22165	20180210	46207
20180201	경인선	주안	24110	22094	20180204	46204
20180125	4호선	노원	21719	24483	20180128	46202
20180117	4호선	동대문역사문화공원	23734	22452	20180120	46186
20180130	분당선	모란	23103	23076	20180202	46179
20180115	경부선	구로	22903	23258	20180118	46161
20180212	경인선	주안	24238	21918	20180215	46156
20180130	5호선	천호(풍납토성)	22670	23480	20180202	46150
20180207	분당선	모란	22989	23155	20180210	46144
20180122	분당선	미금	22152	23991	20180125	46143
20180207	분당선	미금	22163	23970	20180210	46133
20180122	2호선	문래	22852	23234	20180125	46086
20180205	2호선	당산	21472	24568	20180208	46040
20180124	4호선	노원	21566	24468	20180127	46034
20180208	5호선	천호(풍납토성)	22568	23457	20180211	46025
20180127	4호선	사당	24262	21758	20180130	46020
20180201	분당선	미금	22199	23818	20180204	46017
20180128	2호선	합정	22684	23331	20180131	46015
20180201	9호선	여의도	23375	22629	20180204	46004
20180129	2호선	당산	21313	24676	20180201	45989
20180119	9호선	가양	23624	22347	20180122	45971
20180123	4호선	길음	23463	22485	20180126	45948
20180205	7호선	노원	22415	23512	20180208	45927
20180128	1호선	종각	24642	21282	20180131	45924
20180118	5호선	천호(풍납토성)	22383	23537	20180121	45920
20180124	2호선	봉천	23574	22335	20180127	45909
20180126	2호선	당산	21343	24547	20180129	45890
20180131	4호선	상계	24198	21690	20180203	45888
20180123	2호선	방배	22566	23286	20180126	45852
20180206	2호선	문래	22831	22972	20180209	45803
20180126	7호선	노원	21997	23803	20180129	45800
20180115	9호선	여의도	23421	22378	20180118	45799
20180120	4호선	노원	21438	24339	20180123	45777
20180112	9호선	여의도	23831	21935	20180115	45766
20180127	2호선	대림(구로구청)	21999	23765	20180130	45764
20180112	4호선	길음	23434	22326	20180115	45760
20180112	경인선	주안	23862	21896	20180115	45758
20180123	9호선	여의도	23422	22318	20180126	45740
20180120	4호선	동대문	23570	22150	20180123	45720
20180131	5호선	천호(풍납토성)	22362	23348	20180203	45710
20180130	분당선	미금	21837	23828	20180202	45665
20180203	2호선	신대방	23379	22284	20180206	45663
20180123	3호선	경복궁(정부서울청사)	22949	22697	20180126	45646
20180208	경부선	구로	22371	23256	20180211	45627
20180113	2호선	신대방	23589	22025	20180116	45614
20180129	4호선	길음	23360	22252	20180201	45612
20180112	분당선	모란	22670	22940	20180115	45610
20180130	4호선	동대문역사문화공원	24138	21464	20180202	45602
20180117	9호선	가양	23207	22386	20180120	45593
20180125	4호선	성신여대입구(돈암)	23091	22501	20180128	45592
20180113	경부선	금정	23081	22480	20180116	45561
20180126	9호선	여의도	23791	21769	20180129	45560
20180130	경부선	구로	22385	23173	20180202	45558
20180124	경인선	개봉	22232	23292	20180127	45524
20180205	2호선	문래	22643	22865	20180208	45508
20180122	9호선	여의도	23313	22181	20180125	45494
20180127	경인선	송내	23268	22193	20180130	45461
20180130	경인선	주안	23660	21792	20180202	45452
20180201	5호선	천호(풍납토성)	22293	23155	20180204	45448
20180127	2호선	잠실새내	21970	23465	20180130	45435
20180124	7호선	논현	21453	23972	20180127	45425
20180125	2호선	당산	21092	24325	20180128	45417
20180129	3호선	경복궁(정부서울청사)	22617	22796	20180201	45413
20180120	3호선	안국	21740	23607	20180123	45347
20180122	경부선	구로	22451	22866	20180125	45317
20180208	9호선	가양	23067	22240	20180211	45307
20180124	1호선	청량리(서울시립대입구)	22144	23154	20180127	45298
20180206	9호선	여의도	23120	22152	20180209	45272
20180131	9호선	가양	23248	22016	20180203	45264
20180127	경인선	역곡	23126	22118	20180130	45244
20180212	5호선	천호(풍납토성)	22096	23111	20180215	45207
20180127	5호선	까치산	23198	22003	20180130	45201
20180124	3호선	경복궁(정부서울청사)	22882	22307	20180127	45189
20180113	4호선	노원	21088	24090	20180116	45178
20180127	중앙선	회기	22923	22253	20180130	45176
20180212	경부선	구로	22319	22842	20180215	45161
20180115	5호선	천호(풍납토성)	22025	23132	20180118	45157
20180112	4호선	동대문역사문화공원	23323	21822	20180115	45145
20180130	4호선	상계	23424	21716	20180202	45140
20180124	4호선	총신대입구(이수)	21205	23921	20180127	45126
20180201	경부선	구로	22034	23072	20180204	45106
20180119	7호선	고속터미널	24503	20557	20180122	45060
20180205	분당선	모란	22581	22452	20180208	45033
20180119	분당선	정자	21684	23338	20180122	45022
20180124	4호선	성신여대입구(돈암)	22798	22216	20180127	45014
20180114	3호선	남부터미널(예술의전당)	21449	23551	20180117	45000
20180207	5호선	천호(풍납토성)	22136	22839	20180210	44975
20180206	분당선	모란	22597	22374	20180209	44971
20180120	5호선	오목교(목동운동장앞)	21905	23028	20180123	44933
20180205	9호선	여의도	22940	21985	20180208	44925
20180125	4호선	총신대입구(이수)	21137	23781	20180128	44918
20180207	9호선	가양	22787	22102	20180210	44889
20180118	9호선	가양	22835	22054	20180121	44889
20180113	7호선	광명사거리	22650	22234	20180116	44884
20180125	3호선	경복궁(정부서울청사)	22596	22287	20180128	44883
20180131	일산선	화정	21989	22873	20180203	44862
20180123	7호선	노원	22035	22826	20180126	44861
20180130	9호선	국회의사당	23857	20995	20180202	44852
20180123	2호선	문래	22237	22611	20180126	44848
20180125	7호선	논현	21115	23691	20180128	44806
20180207	4호선	상계	23557	21240	20180210	44797
20180212	9호선	가양	22895	21882	20180215	44777
20180113	5호선	오목교(목동운동장앞)	21692	23048	20180116	44740
20180117	2호선	방배	22253	22483	20180120	44736
20180115	9호선	가양	22742	21990	20180118	44732
20180126	4호선	길음	23006	21723	20180129	44729
20180125	4호선	길음	22714	22002	20180128	44716
20180201	9호선	가양	22676	22039	20180204	44715
20180129	2호선	문래	22176	22539	20180201	44715
20180201	4호선	상계	23529	21184	20180204	44713
20180126	분당선	모란	22341	22360	20180129	44701
20180206	9호선	가양	22761	21936	20180209	44697
20180112	분당선	미금	21663	23004	20180115	44667
20180117	1호선	제기동	22123	22537	20180120	44660
20180208	4호선	동대문역사문화공원	23264	21381	20180211	44645
20180205	경인선	주안	23243	21396	20180208	44639
20180124	9호선	여의도	22871	21766	20180127	44637
20180124	2호선	당산	20698	23911	20180127	44609
20180119	3호선	불광	21572	23032	20180122	44604
20180113	3호선	경복궁(정부서울청사)	21966	22636	20180116	44602
20180123	분당선	모란	22435	22165	20180126	44600
20180112	5호선	천호(풍납토성)	21951	22646	20180115	44597
20180125	경부선	안양	22397	22157	20180128	44554
20180208	2호선	방배	22057	22493	20180211	44550
20180117	4호선	상계	23457	21077	20180120	44534
20180115	4호선	동대문역사문화공원	23131	21403	20180118	44534
20180117	일산선	화정	21692	22808	20180120	44500
20180119	5호선	장한평	22167	22296	20180122	44463
20180207	경부선	구로	21938	22507	20180210	44445
20180130	7호선	하계	22333	22108	20180202	44441
20180119	4호선	상계	23555	20880	20180122	44435
20180119	5호선	목동	21540	22878	20180122	44418
20180203	경부선	금정	22406	21953	20180206	44359
20180122	5호선	천호(풍납토성)	21627	22724	20180125	44351
20180119	일산선	화정	21656	22692	20180122	44348
20180206	분당선	미금	21420	22927	20180209	44347
20180122	9호선	가양	22491	21854	20180125	44345
20180118	2호선	방배	22094	22247	20180121	44341
20180128	3호선	남부터미널(예술의전당)	21347	22956	20180131	44303
20180120	경인선	개봉	22351	21937	20180123	44288
20180130	2호선	방배	21779	22506	20180202	44285
20180123	경부선	구로	21779	22493	20180126	44272
20180205	분당선	미금	21312	22913	20180208	44225
20180129	경인선	주안	23071	21137	20180201	44208
20180119	2호선	방배	22143	22054	20180122	44197
20180124	4호선	길음	22447	21743	20180127	44190
20180208	4호선	상계	23249	20939	20180211	44188
20180131	7호선	하계	22796	21348	20180203	44144
20180117	8호선	천호(풍납토성)	20808	23292	20180120	44100
20180121	2호선	대림(구로구청)	21824	22265	20180124	44089
20180121	3호선	남부터미널(예술의전당)	21219	22853	20180124	44072
20180118	8호선	천호(풍납토성)	20999	23062	20180121	44061
20180208	8호선	천호(풍납토성)	20780	23266	20180211	44046
20180118	4호선	상계	23173	20846	20180121	44019
20180131	2호선	방배	21893	22110	20180203	44003
20180212	4호선	동대문역사문화공원	22982	21018	20180215	44000
20180124	경부선	안양	22270	21725	20180127	43995
20180125	9호선	여의도	22551	21439	20180128	43990
20180129	9호선	여의도	22295	21689	20180201	43984
20180203	4호선	동대문	22627	21342	20180206	43969
20180206	4호선	상계	23161	20806	20180209	43967
20180126	4호선	동대문역사문화공원	22809	21107	20180129	43916
20180123	분당선	미금	21179	22727	20180126	43906
20180113	경인선	개봉	22471	21421	20180116	43892
20180112	2호선	문래	21881	22000	20180115	43881
20180114	2호선	대림(구로구청)	21652	22224	20180117	43876
20180123	경인선	주안	22922	20929	20180126	43851
20180122	4호선	상계	22927	20911	20180125	43838
20180205	9호선	가양	22347	21486	20180208	43833
20180206	경인선	주안	22736	21086	20180209	43822
20180113	4호선	동대문	22514	21307	20180116	43821
20180115	4호선	상계	23119	20694	20180118	43813
20180201	2호선	방배	21845	21952	20180204	43797
20180212	2호선	방배	21666	22122	20180215	43788
20180124	2호선	문래	21718	22066	20180127	43784
20180130	5호선	장한평	21807	21965	20180202	43772
20180130	일산선	화정	21068	22702	20180202	43770
20180131	5호선	장한평	21807	21948	20180203	43755
20180205	4호선	상계	22922	20819	20180208	43741
20180129	분당선	미금	21020	22698	20180201	43718
20180212	4호선	상계	23152	20564	20180215	43716
20180203	4호선	노원	20560	23153	20180206	43713
20180207	8호선	천호(풍납토성)	20512	23199	20180210	43711
20180126	경인선	주안	22871	20834	20180129	43705
20180112	경부선	구로	21226	22476	20180115	43702
20180118	1호선	제기동	21583	22113	20180121	43696
20180130	8호선	천호(풍납토성)	20561	23129	20180202	43690
20180205	경부선	구로	21740	21949	20180208	43689
20180125	2호선	문래	21742	21945	20180128	43687
20180212	8호선	천호(풍납토성)	20644	23012	20180215	43656
20180117	5호선	목동	20902	22732	20180120	43634
20180118	5호선	목동	20956	22677	20180121	43633
20180125	4호선	동대문역사문화공원	22485	21143	20180128	43628
20180119	안산선	상록수	22271	21357	20180122	43628
20180207	4호선	동대문역사문화공원	22733	20892	20180210	43625
20180131	8호선	천호(풍납토성)	20619	23005	20180203	43624
20180119	안산선	산본	20930	22639	20180122	43569
20180127	6호선	이태원	19132	24395	20180130	43527
20180203	2호선	종합운동장	20967	22531	20180206	43498
20180125	분당선	모란	21723	21745	20180128	43468
20180123	9호선	가양	21925	21541	20180126	43466
20180130	5호선	목동	20566	22885	20180202	43451
20180119	6호선	공덕	21830	21618	20180122	43448
20180130	5호선	서대문	22194	21242	20180202	43436
20180117	5호선	장한평	21695	21723	20180120	43418
20180127	1호선	종로5가	22167	21238	20180130	43405
20180127	2호선	신대방	22316	21055	20180130	43371
20180206	2호선	방배	21386	21978	20180209	43364
20180122	4호선	동대문역사문화공원	22523	20806	20180125	43329
20180129	경부선	구로	21517	21807	20180201	43324
20180115	2호선	방배	21715	21609	20180118	43324
20180117	3호선	불광	20763	22536	20180120	43299
20180117	경원선	의정부	21045	22240	20180120	43285
20180206	5호선	천호(풍납토성)	21222	22062	20180209	43284
20180203	4호선	성신여대입구(돈암)	21578	21693	20180206	43271
20180207	5호선	서대문	21253	21972	20180210	43225
20180131	5호선	목동	21007	22217	20180203	43224
20180201	8호선	천호(풍납토성)	20523	22689	20180204	43212
20180124	2호선	방배	21526	21651	20180127	43177
20180208	경원선	의정부	21358	21817	20180211	43175
20180208	3호선	불광	20926	22247	20180211	43173
20180118	5호선	장한평	21571	21580	20180121	43151
20180115	8호선	천호(풍납토성)	20329	22792	20180118	43121
20180121	1호선	청량리(서울시립대입구)	21170	21941	20180124	43111
20180115	5호선	목동	20775	22330	20180118	43105
20180203	5호선	오목교(목동운동장앞)	21101	22000	20180206	43101
20180126	2호선	문래	21461	21638	20180129	43099
20180205	4호선	동대문역사문화공원	22492	20605	20180208	43097
20180125	7호선	노원	20919	22175	20180128	43094
20180207	일산선	화정	20976	22112	20180210	43088
20180118	일산선	화정	21139	21943	20180121	43082
20180124	7호선	노원	20967	22104	20180127	43071
20180112	8호선	천호(풍납토성)	19975	23061	20180115	43036
20180207	2호선	방배	21350	21680	20180210	43030
20180203	1호선	제기동	21208	21822	20180206	43030
20180123	5호선	천호(풍납토성)	21058	21961	20180126	43019
20180208	5호선	목동	20867	22141	20180211	43008
20180126	5호선	천호(풍납토성)	20952	22036	20180129	42988
20180206	경부선	구로	21104	21882	20180209	42986
20180122	2호선	방배	21392	21593	20180125	42985
20180127	경원선	의정부	20546	22428	20180130	42974
20180120	1호선	제기동	21210	21760	20180123	42970
20180130	2호선	뚝섬	21162	21807	20180202	42969
20180203	3호선	안국	20777	22171	20180206	42948
20180207	9호선	국회의사당	21671	21265	20180210	42936
20180120	경인선	주안	22668	20262	20180123	42930
20180126	분당선	미금	20640	22285	20180129	42925
20180112	9호선	가양	21966	20956	20180115	42922
20180129	9호선	가양	21870	21037	20180201	42907
20180201	5호선	목동	20657	22249	20180204	42906
20180122	5호선	목동	20514	22388	20180125	42902
20180130	6호선	공덕	21839	21055	20180202	42894
20180120	4호선	성신여대입구(돈암)	21753	21141	20180123	42894
20180206	7호선	하계	21882	21010	20180209	42892
20180208	일산선	화정	20984	21876	20180211	42860
20180131	분당선	정자	20648	22190	20180203	42838
20180117	7호선	하계	21944	20892	20180120	42836
20180206	4호선	동대문역사문화공원	22387	20446	20180209	42833
20180114	분당선	모란	20918	21890	20180117	42808
20180125	2호선	방배	21205	21554	20180128	42759
20180208	6호선	공덕	21662	21090	20180211	42752
20180122	일산선	화정	20841	21903	20180125	42744
20180115	경원선	의정부	20912	21828	20180118	42740
20180119	6호선	이태원	18226	24475	20180122	42701
20180123	4호선	동대문역사문화공원	22138	20523	20180126	42661
20180113	4호선	충무로	21197	21446	20180116	42643
20180119	7호선	하계	22185	20451	20180122	42636
20180207	7호선	하계	21818	20810	20180210	42628
20180205	5호선	서대문	20983	21638	20180208	42621
20180208	7호선	하계	21979	20632	20180211	42611
20180118	분당선	정자	20501	22096	20180121	42597
20180124	경인선	주안	22148	20445	20180127	42593
20180127	5호선	화곡	22056	20536	20180130	42592
20180208	분당선	정자	20493	22091	20180211	42584
20180124	분당선	미금	20499	22075	20180127	42574
20180129	4호선	동대문역사문화공원	22195	20372	20180201	42567
20180127	경부선	안양	21132	21418	20180130	42550
20180131	3호선	불광	20405	22093	20180203	42498
20180119	3호선	구파발	22738	19748	20180122	42486
20180128	2호선	대림(구로구청)	20954	21525	20180131	42479
20180125	분당선	미금	20340	22134	20180128	42474
20180126	8호선	천호(풍납토성)	19715	22754	20180129	42469
20180113	4호선	성신여대입구(돈암)	21387	21077	20180116	42464
20180126	경부선	구로	20869	21593	20180129	42462
20180130	3호선	불광	20053	22395	20180202	42448
20180118	경원선	의정부	20872	21556	20180121	42428
20180205	1호선	제기동	20900	21526	20180208	42426
20180212	경원선	의정부	20972	21446	20180215	42418
20180205	5호선	천호(풍납토성)	20757	21639	20180208	42396
20180117	5호선	서대문	20855	21538	20180120	42393
20180114	1호선	청량리(서울시립대입구)	21075	21318	20180117	42393
20180206	8호선	천호(풍납토성)	20130	22261	20180209	42391
20180208	5호선	장한평	21233	21152	20180211	42385
20180120	7호선	철산	21093	21288	20180123	42381
20180212	5호선	목동	20404	21961	20180215	42365
20180201	일산선	화정	20764	21592	20180204	42356
20180201	3호선	불광	20397	21955	20180204	42352
20180117	3호선	구파발	22300	20050	20180120	42350
20180131	6호선	공덕	21348	20966	20180203	42314
20180113	경인선	주안	22357	19933	20180116	42290
20180129	4호선	상계	22210	20070	20180201	42280
20180117	안산선	상록수	21247	21029	20180120	42276
20180119	3호선	홍제	21845	20409	20180122	42254
20180201	5호선	장한평	21128	21124	20180204	42252
20180131	9호선	국회의사당	20942	21309	20180203	42251
20180130	분당선	정자	20214	22024	20180202	42238
20180207	5호선	장한평	21009	21228	20180210	42237
20180114	1호선	종로3가	22311	19922	20180117	42233
20180115	일산선	화정	20643	21564	20180118	42207
20180131	경원선	의정부	20570	21628	20180203	42198
20180118	3호선	불광	20283	21915	20180121	42198
20180206	5호선	서대문	20941	21248	20180209	42189
20180203	경인선	주안	22140	20039	20180206	42179
20180207	5호선	목동	20332	21843	20180210	42175
20180125	경인선	주안	21978	20188	20180128	42166
20180117	분당선	정자	20197	21950	20180120	42147
20180212	일산선	화정	20619	21508	20180215	42127
20180201	7호선	하계	21574	20537	20180204	42111
20180122	8호선	천호(풍납토성)	19994	22115	20180125	42109
20180129	5호선	천호(풍납토성)	20602	21496	20180201	42098
20180117	6호선	공덕	21352	20733	20180120	42085
20180118	안산선	상록수	21184	20868	20180121	42052
20180123	4호선	상계	22021	20025	20180126	42046
20180124	4호선	동대문역사문화공원	21664	20338	20180127	42002
20180212	분당선	정자	20369	21631	20180215	42000
20180119	3호선	수서	21317	20680	20180122	41997
20180118	7호선	하계	21648	20348	20180121	41996
20180207	3호선	불광	20308	21687	20180210	41995
20180211	3호선	남부터미널(예술의전당)	19791	22202	20180214	41993
20180203	경인선	개봉	20965	21027	20180206	41992
20180125	경부선	구로	20457	21523	20180128	41980
20180127	7호선	광명사거리	21170	20805	20180130	41975
20180131	안산선	상록수	21248	20714	20180203	41962
20180119	경인선	동암	20953	21009	20180122	41962
20180122	경원선	의정부	20910	21050	20180125	41960
20180114	경인선	구일	20179	21779	20180117	41958
20180120	7호선	고속터미널	23435	18499	20180123	41934
20180204	3호선	남부터미널(예술의전당)	20295	21631	20180207	41926
20180130	3호선	홍제	20902	21015	20180202	41917
20180201	안산선	상록수	21128	20788	20180204	41916
20180121	1호선	종로3가	22051	19818	20180124	41869
20180208	안산선	상록수	20970	20869	20180211	41839
20180212	3호선	불광	20240	21597	20180215	41837
20180208	3호선	구파발	22033	19781	20180211	41814
20180205	7호선	하계	21422	20336	20180208	41758
20180208	5호선	서대문	20559	21195	20180211	41754
20180212	6호선	공덕	21109	20642	20180215	41751
20180206	9호선	국회의사당	20970	20773	20180209	41743
20180211	2호선	대림(구로구청)	20298	21438	20180214	41736
20180112	2호선	방배	20825	20891	20180115	41716
20180206	5호선	목동	20048	21645	20180209	41693
20180122	3호선	불광	20007	21685	20180125	41692
20180207	6호선	공덕	21050	20630	20180210	41680
20180207	분당선	정자	20120	21557	20180210	41677
20180117	9호선	국회의사당	20922	20753	20180120	41675
20180131	5호선	서대문	20421	21244	20180203	41665
20180131	3호선	구파발	21948	19711	20180203	41659
20180115	안산선	상록수	21037	20621	20180118	41658
20180201	분당선	정자	20033	21623	20180204	41656
20180118	5호선	서대문	20466	21176	20180121	41642
20180118	6호선	공덕	21124	20500	20180121	41624
20180126	9호선	가양	21200	20422	20180129	41622
20180122	안산선	상록수	20932	20688	20180125	41620
20180201	6호선	공덕	21118	20490	20180204	41608
20180129	2호선	방배	20644	20934	20180201	41578
20180129	8호선	천호(풍납토성)	19757	21820	20180201	41577
20180112	분당선	정자	20223	21354	20180115	41577
20180119	5호선	강동	22652	18915	20180122	41567
20180115	3호선	불광	20018	21546	20180118	41564
20180211	1호선	청량리(서울시립대입구)	20579	20980	20180214	41559
20180113	7호선	철산	20735	20802	20180116	41537
20180123	5호선	목동	19992	21543	20180126	41535
20180118	3호선	구파발	21904	19613	20180121	41517
20180212	7호선	하계	21453	20044	20180215	41497
20180123	8호선	천호(풍납토성)	19716	21776	20180126	41492
20180201	5호선	서대문	20324	21165	20180204	41489
20180123	7호선	하계	21130	20346	20180126	41476
20180115	5호선	장한평	20736	20729	20180118	41465
20180112	경원선	의정부	20037	21428	20180115	41465
20180205	8호선	천호(풍납토성)	19747	21710	20180208	41457
20180115	7호선	하계	21376	20074	20180118	41450
20180127	경부선	금정	20889	20556	20180130	41445
20180205	2호선	방배	20552	20892	20180208	41444
20180119	5호선	서대문	20368	21069	20180122	41437
20180122	5호선	장한평	20675	20751	20180125	41426
20180113	3호선	안국	19747	21678	20180116	41425
20180124	경부선	구로	20305	21115	20180127	41420
20180119	9호선	국회의사당	20835	20581	20180122	41416
20180112	5호선	장한평	20549	20853	20180115	41402
20180130	5호선	강동	21911	19466	20180202	41377
20180207	3호선	구파발	21794	19582	20180210	41376
20180212	5호선	장한평	20736	20622	20180215	41358
20180212	5호선	서대문	20351	21000	20180215	41351
20180207	5호선	강동	22164	19171	20180210	41335
20180112	5호선	목동	19963	21372	20180115	41335
20180125	9호선	가양	20999	20328	20180128	41327
20180201	경원선	의정부	20206	21119	20180204	41325
20180130	3호선	구파발	21582	19729	20180202	41311
20180117	3호선	홍제	21110	20180	20180120	41290
20180131	5호선	강동	22329	18960	20180203	41289
20180212	3호선	구파발	21924	19360	20180215	41284
20180126	7호선	고속터미널	22517	18759	20180129	41276
20180127	4호선	노원	19253	22011	20180130	41264
20180203	7호선	철산	20500	20746	20180206	41246
20180112	4호선	상계	21754	19482	20180115	41236
20180126	9호선	국회의사당	20759	20460	20180129	41219
20180206	6호선	공덕	20795	20418	20180209	41213
20180205	5호선	목동	19786	21419	20180208	41205
20180201	3호선	구파발	21685	19509	20180204	41194
20180131	2호선	뚝섬	19680	21484	20180203	41164
20180114	1호선	종각	22032	19126	20180117	41158
20180118	5호선	강동	22230	18921	20180121	41151
20180130	경원선	의정부	20131	21008	20180202	41139
20180122	5호선	강동	21969	19168	20180125	41137
20180117	안산선	산본	19871	21259	20180120	41130
20180119	2호선	동대문역사문화공원	18932	22172	20180122	41104
20180126	5호선	장한평	20530	20561	20180129	41091
20180212	안산선	상록수	20695	20393	20180215	41088
20180125	5호선	천호(풍납토성)	20122	20958	20180128	41080
20180131	3호선	홍제	21181	19880	20180203	41061
20180201	2호선	뚝섬	19769	21267	20180204	41036
20180123	9호선	국회의사당	20595	20430	20180126	41025
20180112	7호선	고속터미널	22222	18791	20180115	41013
20180117	경부선	가산디지털단지	18883	22129	20180120	41012
20180206	1호선	제기동	20193	20816	20180209	41009
20180122	7호선	하계	20929	20079	20180125	41008
20180208	2호선	뚝섬	19713	21290	20180211	41003
20180122	3호선	홍제	20829	20154	20180125	40983
20180119	2호선	뚝섬	19926	21051	20180122	40977
20180124	9호선	국회의사당	20656	20312	20180127	40968
20180212	8호선	문정	20023	20940	20180215	40963
20180122	분당선	정자	19664	21297	20180125	40961
20180115	5호선	서대문	20102	20857	20180118	40959
20180124	9호선	가양	20837	20115	20180127	40952
20180208	3호선	홍제	21001	19945	20180211	40946
20180130	안산선	상록수	20298	20639	20180202	40937
20180206	5호선	장한평	20485	20433	20180209	40918
20180117	5호선	강동	22103	18794	20180120	40897
20180131	경부선	가산디지털단지	18664	22231	20180203	40895
20180122	5호선	서대문	20336	20548	20180125	40884
20180115	6호선	공덕	20663	20215	20180118	40878
20180115	분당선	정자	19785	21092	20180118	40877
20180120	과천선	인덕원	21317	19542	20180123	40859
20180207	2호선	뚝섬	19654	21198	20180210	40852
20180120	4호선	총신대입구(이수)	19232	21620	20180123	40852
20180122	6호선	공덕	20660	20179	20180125	40839
20180205	5호선	장한평	20377	20461	20180208	40838
20180119	4호선	서울역	15495	25342	20180122	40837
20180208	9호선	국회의사당	20390	20444	20180211	40834
20180117	2호선	뚝섬	19709	21110	20180120	40819
20180204	2호선	대림(구로구청)	20272	20539	20180207	40811
20180131	8호선	문정	19854	20953	20180203	40807
20180124	5호선	천호(풍납토성)	20024	20734	20180127	40758
20180120	분당선	모란	20285	20464	20180123	40749
20180119	경부선	독산	19961	20781	20180122	40742
20180113	5호선	천호(풍납토성)	20233	20500	20180116	40733
20180203	7호선	고속터미널	22692	18027	20180206	40719
20180122	3호선	구파발	21469	19237	20180125	40706
20180207	3호선	홍제	20906	19791	20180210	40697
20180206	3호선	불광	19689	20993	20180209	40682
20180115	3호선	구파발	21618	19064	20180118	40682
20180115	경부선	가산디지털단지	18781	21884	20180118	40665
20180127	5호선	광화문(세종문화회관)	20092	20565	20180130	40657
20180212	경부선	가산디지털단지	18671	21983	20180215	40654
20180129	7호선	하계	20833	19821	20180201	40654
20180119	9호선	당산	21148	19506	20180122	40654
20180120	4호선	충무로	20105	20542	20180123	40647
20180120	5호선	천호(풍납토성)	20095	20550	20180123	40645
20180130	9호선	당산	20750	19888	20180202	40638
20180125	8호선	천호(풍납토성)	19220	21408	20180128	40628
20180212	3호선	홍제	20883	19736	20180215	40619
20180115	5호선	강동	21928	18689	20180118	40617
20180201	5호선	강동	21784	18797	20180204	40581
20180115	3호선	홍제	20822	19756	20180118	40578
20180119	경부선	가산디지털단지	18566	22003	20180122	40569
20180207	안산선	상록수	20267	20297	20180210	40564
20180205	6호선	공덕	20557	19996	20180208	40553
20180117	8호선	문정	19838	20712	20180120	40550
20180131	안산선	산본	19723	20810	20180203	40533
20180119	과천선	평촌	20530	19995	20180122	40525
20180118	안산선	산본	19602	20914	20180121	40516
20180129	1호선	제기동	19912	20598	20180201	40510
20180126	2호선	방배	20160	20330	20180129	40490
20180212	경부선	독산	19690	20789	20180215	40479
20180123	분당선	정자	19321	21148	20180126	40469
20180125	4호선	상계	21277	19176	20180128	40453
20180208	5호선	강동	21828	18617	20180211	40445
20180201	8호선	문정	19406	21028	20180204	40434
20180203	분당선	모란	20120	20307	20180206	40427
20180212	안산선	산본	19577	20843	20180215	40420
20180113	4호선	총신대입구(이수)	19123	21291	20180116	40414
20180131	경부선	독산	19588	20824	20180203	40412
20180122	경부선	가산디지털단지	18461	21946	20180125	40407
20180207	경원선	의정부	19868	20536	20180210	40404
20180208	안산선	산본	19629	20758	20180211	40387
20180206	3호선	구파발	21323	19060	20180209	40383
20180205	일산선	화정	19710	20669	20180208	40379
20180205	3호선	불광	19548	20826	20180208	40374
20180118	2호선	뚝섬	19440	20931	20180121	40371
20180120	경원선	청량리(서울시립대입구)	19434	20933	20180123	40367
20180204	분당선	모란	19706	20659	20180207	40365
20180203	5호선	천호(풍납토성)	20032	20325	20180206	40357
20180126	분당선	정자	19498	20858	20180129	40356
20180119	8호선	암사	21618	18735	20180122	40353
20180113	과천선	인덕원	21081	19268	20180116	40349
20180126	5호선	목동	19485	20863	20180129	40348
20180126	4호선	상계	21310	19028	20180129	40338
20180123	5호선	서대문	19902	20434	20180126	40336
20180125	5호선	목동	19312	21018	20180128	40330
20180118	8호선	문정	19776	20538	20180121	40314
20180117	경인선	동암	20252	20060	20180120	40312
20180206	경원선	의정부	19863	20437	20180209	40300
20180121	1호선	종각	21711	18589	20180124	40300
20180122	경부선	독산	19630	20663	20180125	40293
20180206	일산선	화정	19710	20577	20180209	40287
20180118	경인선	동암	20199	20087	20180121	40286
20180127	4호선	성신여대입구(돈암)	20474	19803	20180130	40277
20180123	5호선	강동	21578	18695	20180126	40273
20180129	5호선	목동	19503	20762	20180201	40265
20180205	3호선	구파발	21328	18933	20180208	40261
20180123	5호선	장한평	20077	20178	20180126	40255
20180112	3호선	수서	20651	19576	20180115	40227
20180115	안산선	산본	19570	20648	20180118	40218
20180203	4호선	충무로	19986	20226	20180206	40212
20180206	분당선	정자	19236	20968	20180209	40204
20180201	안산선	산본	19519	20684	20180204	40203
20180118	경부선	가산디지털단지	18508	21686	20180121	40194
20180129	일산선	화정	19622	20560	20180201	40182
20180125	5호선	장한평	19997	20183	20180128	40180
20180204	3호선	양재(서초구청)	19110	21061	20180207	40171
20180208	8호선	문정	19679	20485	20180211	40164
20180117	경부선	독산	19465	20683	20180120	40148
20180131	8호선	장지	20328	19819	20180203	40147
20180206	2호선	뚝섬	19238	20872	20180209	40110
20180118	3호선	홍제	20565	19539	20180121	40104
20180131	8호선	암사	21515	18584	20180203	40099
20180205	경원선	의정부	19942	20156	20180208	40098
20180112	6호선	공덕	20117	19979	20180115	40096
20180208	경부선	가산디지털단지	18424	21671	20180211	40095
20180130	경부선	가산디지털단지	18529	21563	20180202	40092
20180124	5호선	장한평	19940	20143	20180127	40083
20180208	7호선	고속터미널	21204	18875	20180211	40079
20180119	8호선	장지	20384	19695	20180122	40079
20180118	7호선	고속터미널	21389	18686	20180121	40075
20180205	5호선	강동	21498	18563	20180208	40061
20180119	2호선	왕십리(성동구청)	21897	18148	20180122	40045
20180201	3호선	홍제	20575	19461	20180204	40036
20180113	4호선	동대문역사문화공원	21399	18614	20180116	40013
20180126	경원선	의정부	19380	20632	20180129	40012
20180127	5호선	오목교(목동운동장앞)	19537	20471	20180130	40008
20180124	4호선	상계	20974	19032	20180127	40006
20180115	8호선	문정	19571	20407	20180118	39978
20180119	2호선	잠실나루	20669	19302	20180122	39971
20180208	3호선	수서	19944	20020	20180211	39964
20180130	경부선	독산	19338	20626	20180202	39964
20180208	8호선	암사	21206	18754	20180211	39960
20180118	9호선	국회의사당	19688	20271	20180121	39959
20180115	경부선	독산	19482	20469	20180118	39951
20180130	8호선	문정	19739	20193	20180202	39932
20180212	5호선	강동	21498	18433	20180215	39931
20180122	8호선	문정	19713	20205	20180125	39918
20180201	경부선	가산디지털단지	18204	21713	20180204	39917
20180117	과천선	평촌	20135	19782	20180120	39917
20180117	7호선	고속터미널	21315	18585	20180120	39900
20180130	7호선	고속터미널	21215	18684	20180202	39899
20180206	5호선	강동	21436	18462	20180209	39898
20180208	경부선	독산	19346	20549	20180211	39895
20180123	2호선	뚝섬	19240	20654	20180126	39894
20180129	5호선	장한평	19978	19903	20180201	39881
20180117	2호선	잠실나루	20370	19510	20180120	39880
20180122	안산선	산본	19215	20652	20180125	39867
20180113	7호선	고속터미널	22305	17557	20180116	39862
20180114	9호선	노량진	18694	21160	20180117	39854
20180207	8호선	장지	20171	19673	20180210	39844
20180131	과천선	평촌	20119	19724	20180203	39843
20180130	6호선	응암	19626	20214	20180202	39840
20180117	8호선	장지	20248	19576	20180120	39824
20180112	5호선	서대문	19618	20201	20180115	39819
20180208	8호선	장지	20203	19611	20180211	39814
20180123	6호선	공덕	20107	19676	20180126	39783
20180113	7호선	노원	19135	20644	20180116	39779
20180112	일산선	화정	19317	20458	20180115	39775
20180129	6호선	공덕	20176	19594	20180201	39770
20180113	분당선	모란	19644	20117	20180116	39761
20180205	8호선	문정	19514	20236	20180208	39750
20180119	8호선	문정	19611	20129	20180122	39740
20180204	중앙선	회기	19874	19865	20180207	39739
20180130	8호선	암사	20762	18973	20180202	39735
20180205	3호선	홍제	20205	19521	20180208	39726
20180112	3호선	불광	19227	20491	20180115	39718
20180128	1호선	청량리(서울시립대입구)	19509	20198	20180131	39707
20180118	경부선	독산	19301	20402	20180121	39703
20180208	9호선	당산	20323	19376	20180211	39699
20180212	2호선	뚝섬	19099	20595	20180215	39694
20180131	9호선	당산	20317	19365	20180203	39682
20180118	2호선	잠실나루	20323	19358	20180121	39681
20180130	안산선	산본	19066	20613	20180202	39679
20180201	2호선	동대문역사문화공원	18317	21347	20180204	39664
20180115	7호선	고속터미널	21384	18267	20180118	39651
20180129	3호선	불광	19087	20557	20180201	39644
20180206	3호선	홍제	20222	19418	20180209	39640
20180211	분당선	서현	20052	19582	20180214	39634
20180117	8호선	암사	21103	18525	20180120	39628
20180119	6호선	응암	20220	19405	20180122	39625
20180131	경인선	동암	19872	19751	20180203	39623
20180129	분당선	정자	19110	20513	20180201	39623
20180205	분당선	정자	19015	20585	20180208	39600
20180112	안산선	상록수	20192	19407	20180115	39599
20180120	7호선	노원	18922	20669	20180123	39591
20180118	8호선	암사	21063	18528	20180121	39591
20180131	2호선	동대문역사문화공원	18348	21236	20180203	39584
20180115	경인선	동암	19988	19582	20180118	39570
20180212	7호선	고속터미널	20899	18658	20180215	39557
20180124	8호선	천호(풍납토성)	18744	20807	20180127	39551
20180123	3호선	불광	19063	20481	20180126	39544
20180129	5호선	서대문	19540	20001	20180201	39541
20180201	9호선	국회의사당	19669	19867	20180204	39536
20180123	경원선	의정부	19611	19923	20180126	39534
20180118	과천선	평촌	19828	19702	20180121	39530
20180131	6호선	응암	19989	19539	20180203	39528
20180124	7호선	하계	20120	19403	20180127	39523
20180127	4호선	동대문	20090	19428	20180130	39518
20180119	7호선	이수	19705	19810	20180122	39515
20180207	8호선	문정	19330	20184	20180210	39514
20180124	5호선	서대문	19652	19862	20180127	39514
20180123	일산선	화정	19235	20266	20180126	39501
20180114	분당선	서현	19888	19611	20180117	39499
20180122	7호선	고속터미널	21608	17876	20180125	39484
20180207	경부선	가산디지털단지	18096	21375	20180210	39471
20180208	경인선	동암	19823	19639	20180211	39462
20180205	9호선	국회의사당	19649	19799	20180208	39448
20180121	4호선	미아사거리	20110	19333	20180124	39443
20180208	과천선	평촌	19833	19585	20180211	39418
20180131	7호선	남구로	18966	20389	20180203	39355
20180123	안산선	상록수	19774	19579	20180126	39353
20180124	5호선	목동	18868	20482	20180127	39350
20180203	과천선	인덕원	20482	18866	20180206	39348
20180130	8호선	장지	19687	19635	20180202	39322
20180122	7호선	남구로	19147	20169	20180125	39316
20180208	6호선	응암	19716	19594	20180211	39310
20180205	안산선	상록수	19785	19525	20180208	39310
20180119	안산선	중앙	18642	20664	20180122	39306
20180201	경인선	동암	19610	19695	20180204	39305
20180122	9호선	국회의사당	19854	19451	20180125	39305
20180206	8호선	문정	19280	20024	20180209	39304
20180117	6호선	응암	19853	19445	20180120	39298
20180212	9호선	국회의사당	19703	19589	20180215	39292
20180115	8호선	암사	20895	18382	20180118	39277
20180207	8호선	암사	20785	18475	20180210	39260
20180112	9호선	국회의사당	19815	19435	20180115	39250
20180201	경부선	독산	18961	20288	20180204	39249
20180119	경원선	왕십리(성동구청)	18075	21157	20180122	39232
20180121	9호선	노량진	18351	20872	20180124	39223
20180207	안산선	산본	18980	20228	20180210	39208
20180117	7호선	남구로	18982	20197	20180120	39179
20180201	2호선	잠실나루	20078	19090	20180204	39168
20180123	3호선	구파발	20623	18545	20180126	39168
20180112	7호선	하계	20247	18919	20180115	39166
20180125	5호선	서대문	19263	19902	20180128	39165
20180130	과천선	평촌	19629	19535	20180202	39164
20180122	8호선	암사	20663	18500	20180125	39163
20180121	경원선	의정부	19392	19770	20180124	39162
20180207	경부선	독산	18947	20200	20180210	39147
20180212	8호선	암사	20733	18405	20180215	39138
20180122	경인선	동암	19741	19384	20180125	39125
20180203	4호선	총신대입구(이수)	18408	20712	20180206	39120
20180119	2호선	이대	19295	19821	20180122	39116
20180126	3호선	수서	19897	19214	20180129	39111
20180112	공항철도 1호선	인천공항1터미널	20615	18495	20180115	39110
20180205	경부선	가산디지털단지	17711	21391	20180208	39102
20180115	2호선	잠실나루	19963	19138	20180118	39101
20180126	6호선	공덕	19540	19554	20180129	39094
20180112	안산선	산본	18712	20381	20180115	39093
20180205	경부선	독산	18902	20187	20180208	39089
20180212	3호선	수서	19170	19916	20180215	39086
20180129	3호선	구파발	20734	18349	20180201	39083
20180126	5호선	서대문	19300	19783	20180129	39083
20180205	7호선	남구로	19011	20070	20180208	39081
20180129	경원선	의정부	19336	19742	20180201	39078
20180120	4호선	동대문역사문화공원	21101	17973	20180123	39074
20180206	안산선	상록수	19573	19497	20180209	39070
20180212	과천선	평촌	19628	19441	20180215	39069
20180201	9호선	당산	20127	18928	20180204	39055
20180212	경인선	동암	19664	19389	20180215	39053
20180207	2호선	이대	19362	19691	20180210	39053
20180131	2호선	잠실나루	20038	19012	20180203	39050
20180129	안산선	상록수	19673	19357	20180201	39030
20180208	2호선	잠실나루	19917	19110	20180211	39027
20180121	4호선	쌍문	20840	18184	20180124	39024
20180208	2호선	이대	19078	19936	20180211	39014
20180119	7호선	상봉(시외버스터미널)	19821	19189	20180122	39010
20180122	2호선	뚝섬	18863	20138	20180125	39001
20180125	9호선	국회의사당	19576	19406	20180128	38982
20180115	7호선	남구로	19046	19933	20180118	38979
20180201	과천선	평촌	19684	19281	20180204	38965
20180122	과천선	평촌	19574	19388	20180125	38962
20180206	경부선	가산디지털단지	17607	21354	20180209	38961
20180201	8호선	장지	19742	19215	20180204	38957
20180119	7호선	남구로	18781	20170	20180122	38951
20180207	6호선	응암	19596	19352	20180210	38948
20180114	경원선	의정부	19499	19445	20180117	38944
20180130	2호선	잠실나루	19607	19316	20180202	38923
20180118	8호선	장지	19698	19218	20180121	38916
20180201	6호선	응암	19545	19370	20180204	38915
20180127	7호선	고속터미널	21667	17236	20180130	38903
20180124	분당선	정자	18600	20302	20180127	38902
20180203	7호선	노원	18730	20163	20180206	38893
20180212	2호선	이대	18927	19956	20180215	38883
20180205	2호선	뚝섬	18629	20215	20180208	38844
20180212	8호선	장지	19552	19287	20180215	38839
20180112	3호선	구파발	20603	18231	20180115	38834
20180118	6호선	응암	19565	19266	20180121	38831
20180206	경부선	독산	18745	20070	20180209	38815
20180115	2호선	뚝섬	18775	20037	20180118	38812
20180117	9호선	당산	19938	18873	20180120	38811
20180118	9호선	당산	19996	18788	20180121	38784
20180123	8호선	문정	18969	19797	20180126	38766
20180212	4호선	서울역	15007	23756	20180215	38763
20180130	7호선	남구로	18926	19828	20180202	38754
20180126	7호선	하계	20014	18735	20180129	38749
20180129	3호선	홍제	19827	18916	20180201	38743
20180207	7호선	고속터미널	20494	18246	20180210	38740
20180125	분당선	정자	18673	20059	20180128	38732
20180121	4호선	창동	18560	20172	20180124	38732
20180129	5호선	강동	20787	17937	20180201	38724
20180207	9호선	당산	19721	18999	20180210	38720
20180122	2호선	잠실나루	19609	19111	20180125	38720
20180118	2호선	동대문역사문화공원	17948	20715	20180121	38663
20180113	경부선	구로	18866	19793	20180116	38659
20180117	7호선	이수	19396	19235	20180120	38631
20180113	경원선	청량리(서울시립대입구)	18571	20057	20180116	38628
20180203	3호선	경복궁(정부서울청사)	19056	19571	20180206	38627
20180129	8호선	문정	18910	19712	20180201	38622
20180126	9호선	당산	20020	18595	20180129	38615
20180126	일산선	화정	18725	19889	20180129	38614
20180125	일산선	화정	18763	19851	20180128	38614
20180129	경부선	가산디지털단지	17644	20958	20180201	38602
20180122	8호선	장지	19505	19097	20180125	38602
20180211	과천선	경마공원	19137	19463	20180214	38600
20180129	9호선	국회의사당	19300	19289	20180201	38589
20180201	7호선	고속터미널	20448	18130	20180204	38578
20180118	3호선	수서	19381	19183	20180121	38564
20180212	6호선	응암	19391	19164	20180215	38555
20180207	7호선	남구로	18734	19820	20180210	38554
20180206	9호선	당산	19796	18753	20180209	38549
20180121	분당선	서현	19334	19205	20180124	38539
20180206	7호선	남구로	18690	19840	20180209	38530
20180206	8호선	암사	20369	18157	20180209	38526
20180123	경부선	독산	18592	19921	20180126	38513
20180120	경부선	구로	18635	19878	20180123	38513
20180114	4호선	미아사거리	19748	18762	20180117	38510
20180207	과천선	평촌	19424	19079	20180210	38503
20180207	경인선	동암	19151	19347	20180210	38498
20180123	경부선	가산디지털단지	17237	21259	20180126	38496
20180205	8호선	암사	20393	18088	20180208	38481
20180207	3호선	수서	19294	19185	20180210	38479
20180115	9호선	국회의사당	19151	19321	20180118	38472
20180125	7호선	하계	19806	18653	20180128	38459
20180205	6호선	응암	19197	19257	20180208	38454
20180118	7호선	남구로	18567	19877	20180121	38444
20180126	5호선	강동	20762	17676	20180129	38438
20180114	4호선	쌍문	20456	17982	20180117	38438
20180212	9호선	당산	19563	18869	20180215	38432
20180127	4호선	충무로	19070	19358	20180130	38428
20180124	일산선	화정	18727	19701	20180127	38428
20180123	3호선	홍제	19541	18883	20180126	38424
20180212	7호선	남구로	18802	19620	20180215	38422
20180112	5호선	강동	20925	17494	20180115	38419
20180127	경인선	개봉	19324	19094	20180130	38418
20180117	2호선	이대	18905	19511	20180120	38416
20180115	과천선	평촌	19368	19048	20180118	38416
20180129	경부선	독산	18666	19745	20180201	38411
20180117	2호선	왕십리(성동구청)	21119	17277	20180120	38396
20180212	2호선	잠실나루	19507	18867	20180215	38374
20180131	7호선	고속터미널	20193	18173	20180203	38366
20180208	7호선	남구로	18569	19796	20180211	38365
20180203	4호선	동대문역사문화공원	20915	17441	20180206	38356
20180201	8호선	암사	20754	17581	20180204	38335
20180125	안산선	상록수	19233	19100	20180128	38333
20180117	3호선	수서	19287	19042	20180120	38329
20180204	분당선	서현	19417	18907	20180207	38324
20180112	2호선	뚝섬	18392	19927	20180115	38319
20180128	4호선	미아사거리	19516	18800	20180131	38316
20180206	6호선	응암	19143	19166	20180209	38309
20180125	6호선	공덕	19334	18965	20180128	38299
20180130	경인선	동암	19017	19276	20180202	38293
20180126	안산선	상록수	19539	18739	20180129	38278
20180115	6호선	응암	19191	19076	20180118	38267
20180125	5호선	강동	20557	17699	20180128	38256
20180119	분당선	압구정로데오	17704	20549	20180122	38253
20180130	2호선	동대문역사문화공원	17765	20481	20180202	38246
20180208	7호선	상봉(시외버스터미널)	19763	18477	20180211	38240
20180123	7호선	남구로	18406	19820	20180126	38226
20180130	분당선	압구정로데오	19262	18963	20180202	38225
20180112	8호선	문정	18875	19346	20180115	38221
20180122	6호선	응암	19173	19033	20180125	38206
20180126	3호선	불광	18571	19621	20180129	38192
20180125	3호선	불광	18424	19765	20180128	38189
20180129	2호선	뚝섬	18339	19842	20180201	38181
20180112	3호선	홍제	19620	18555	20180115	38175
20180125	3호선	구파발	20164	18001	20180128	38165
20180117	2호선	동대문역사문화공원	17796	20364	20180120	38160
20180126	4호선	서울역	14440	23712	20180129	38152
20180126	8호선	장지	19343	18797	20180129	38140
20180126	2호선	뚝섬	18376	19762	20180129	38138
20180115	8호선	장지	19255	18878	20180118	38133
20180120	안산선	중앙	18455	19671	20180123	38126
20180115	2호선	이대	18752	19364	20180118	38116
20180112	경부선	가산디지털단지	17385	20731	20180115	38116
20180125	8호선	문정	18651	19440	20180128	38091
20180119	경원선	청량리(서울시립대입구)	17900	20191	20180122	38091
20180205	8호선	장지	19091	18990	20180208	38081
20180212	7호선	상봉(시외버스터미널)	19451	18620	20180215	38071
20180121	3호선	양재(서초구청)	18073	19983	20180124	38056
20180124	3호선	구파발	20158	17896	20180127	38054
20180123	8호선	암사	20150	17898	20180126	38048
20180204	1호선	종각	20248	17795	20180207	38043
20180123	9호선	당산	19453	18588	20180126	38041
20180120	2호선	봉천	19756	18280	20180123	38036
20180112	9호선	당산	19594	18440	20180115	38034
20180129	7호선	남구로	18597	19431	20180201	38028
20180211	4호선	미아사거리	19527	18499	20180214	38026
20180207	2호선	잠실나루	19449	18573	20180210	38022
20180127	경인선	주안	20105	17909	20180130	38014
20180201	7호선	남구로	18379	19622	20180204	38001
20180112	4호선	서울역	14574	23408	20180115	37982
20180206	8호선	장지	19212	18751	20180209	37963
20180112	8호선	장지	19191	18766	20180115	37957
20180205	9호선	당산	19371	18572	20180208	37943
20180128	1호선	종로3가	19853	18090	20180131	37943
20180113	1호선	제기동	18587	19342	20180116	37929
20180122	9호선	당산	19472	18442	20180125	37914
20180128	9호선	노량진	17922	19990	20180131	37912
20180119	경인선	동인천	19531	18372	20180122	37903
20180119	4호선	신용산	18753	19140	20180122	37893
20180126	3호선	구파발	20092	17780	20180129	37872
20180204	1호선	청량리(서울시립대입구)	18584	19287	20180207	37871
20180130	3호선	수서	18826	19038	20180202	37864
20180125	2호선	뚝섬	18313	19537	20180128	37850
20180121	과천선	경마공원	18720	19130	20180124	37850
20180122	3호선	수서	18680	19144	20180125	37824
20180206	과천선	평촌	18997	18824	20180209	37821
20180118	7호선	이수	19054	18760	20180121	37814
20180124	2호선	뚝섬	18185	19624	20180127	37809
20180124	6호선	공덕	18995	18791	20180127	37786
20180208	2호선	왕십리(성동구청)	20937	16847	20180211	37784
20180206	안산선	산본	18288	19494	20180209	37782
20180120	2호선	구의(광진구청)	19400	18380	20180123	37780
20180112	경부선	독산	18474	19291	20180115	37765
20180114	분당선	야탑	18797	18956	20180117	37753
20180123	과천선	평촌	18973	18771	20180126	37744
20180211	4호선	창동	18071	19649	20180214	37720
20180112	6호선	이태원	16374	21344	20180115	37718
20180129	7호선	고속터미널	20322	17388	20180201	37710
20180117	7호선	상봉(시외버스터미널)	19273	18436	20180120	37709
20180203	2호선	구의(광진구청)	19244	18463	20180206	37707
20180115	9호선	당산	19158	18549	20180118	37707
20180206	7호선	고속터미널	20036	17667	20180209	37703
20180207	4호선	미아(서울사이버대학)	19340	18347	20180210	37687
20180204	4호선	미아사거리	19154	18532	20180207	37686
20180114	과천선	범계	19196	18487	20180117	37683
20180118	2호선	이대	18726	18955	20180121	37681
20180208	2호선	동대문역사문화공원	17416	20264	20180211	37680
20180211	9호선	노량진	17845	19830	20180214	37675
20180114	4호선	창동	18169	19497	20180117	37666
20180126	8호선	문정	18619	19043	20180129	37662
20180131	7호선	상봉(시외버스터미널)	19290	18369	20180203	37659
20180121	과천선	범계	19241	18415	20180124	37656
20180115	3호선	수서	18768	18880	20180118	37648
20180124	3호선	불광	18028	19598	20180127	37626
20180205	경인선	동암	18974	18650	20180208	37624
20180130	7호선	강남구청	18334	19289	20180202	37623
20180131	7호선	이수	18872	18749	20180203	37621
20180118	2호선	왕십리(성동구청)	20612	16990	20180121	37602
20180207	2호선	왕십리(성동구청)	20631	16962	20180210	37593
20180207	2호선	동대문역사문화공원	17733	19858	20180210	37591
20180124	5호선	강동	20149	17442	20180127	37591
20180125	9호선	당산	19318	18258	20180128	37576
20180119	분당선	죽전	17668	19908	20180122	37576
20180114	2호선	낙성대	18608	18961	20180117	37569
20180115	공항철도 1호선	인천공항1터미널	18277	19262	20180118	37539
20180203	2호선	봉천	19556	17970	20180206	37526
20180114	3호선	양재(서초구청)	18167	19357	20180117	37524
20180129	8호선	암사	19851	17672	20180201	37523
20180128	분당선	서현	18859	18661	20180131	37520
20180126	3호선	홍제	19130	18358	20180129	37488
20180124	8호선	문정	18264	19222	20180127	37486
20180127	7호선	철산	18672	18813	20180130	37485
20180206	경인선	동암	18665	18816	20180209	37481
20180205	과천선	평촌	18843	18626	20180208	37469
20180125	경원선	의정부	18488	18978	20180128	37466
20180123	안산선	산본	18127	19338	20180126	37465
20180119	4호선	미아(서울사이버대학)	19438	18025	20180122	37463
20180130	7호선	상봉(시외버스터미널)	19053	18405	20180202	37458
20180205	안산선	산본	18134	19322	20180208	37456
20180113	공항철도 1호선	인천공항1터미널	19391	18064	20180116	37455
20180129	안산선	산본	18088	19356	20180201	37444
20180130	7호선	이수	18581	18849	20180202	37430
20180206	2호선	잠실나루	19006	18405	20180209	37411
20180201	2호선	이대	18248	19161	20180204	37409
20180118	4호선	서울역	14622	22774	20180121	37396
20180112	경인선	동암	18746	18622	20180115	37368
20180129	9호선	당산	19018	18343	20180201	37361
20180125	경부선	가산디지털단지	16900	20449	20180128	37349
20180129	8호선	장지	18764	18578	20180201	37342
20180129	과천선	평촌	18849	18492	20180201	37341
20180119	9호선	고속터미널	14284	23055	20180122	37339
20180211	1호선	종각	19859	17463	20180214	37322
20180124	안산선	상록수	18687	18635	20180127	37322
20180124	경부선	가산디지털단지	16889	20429	20180127	37318
20180112	2호선	왕십리(성동구청)	20502	16811	20180115	37313
20180208	4호선	서울역	14756	22554	20180211	37310
20180123	7호선	고속터미널	20048	17253	20180126	37301
20180120	9호선	고속터미널	13390	23906	20180123	37296
20180131	7호선	강남구청	17639	19655	20180203	37294
20180130	4호선	미아(서울사이버대학)	18981	18308	20180202	37289
20180129	경인선	동암	18866	18423	20180201	37289
20180126	안산선	산본	17880	19395	20180129	37275
20180123	8호선	장지	18902	18360	20180126	37262
20180128	4호선	쌍문	19767	17489	20180131	37256
20180206	2호선	이대	18399	18854	20180209	37253
20180205	7호선	고속터미널	20116	17137	20180208	37253
20180212	7호선	이수	18744	18469	20180215	37213
20180125	3호선	홍제	19061	18146	20180128	37207
20180127	분당선	모란	18451	18747	20180130	37198
20180118	7호선	상봉(시외버스터미널)	19247	17941	20180121	37188
20180117	4호선	서울역	14972	22201	20180120	37173
20180208	5호선	발산	18969	18203	20180211	37172
20180205	2호선	이대	18065	19107	20180208	37172
20180205	3호선	수서	18288	18883	20180208	37171
20180204	4호선	창동	17904	19266	20180207	37170
20180131	4호선	미아(서울사이버대학)	19260	17893	20180203	37153
20180127	4호선	총신대입구(이수)	17612	19536	20180130	37148
20180124	3호선	홍제	18865	18273	20180127	37138
20180201	7호선	상봉(시외버스터미널)	18959	18178	20180204	37137
20180201	3호선	수서	18578	18558	20180204	37136
20180201	7호선	이수	18817	18318	20180204	37135
20180121	분당선	야탑	18564	18557	20180124	37121
20180201	7호선	강남구청	17686	19433	20180204	37119
20180129	6호선	응암	18602	18506	20180201	37108
20180119	7호선	신대방삼거리	19184	17921	20180122	37105
20180127	과천선	인덕원	19129	17967	20180130	37096
20180124	8호선	장지	18791	18303	20180127	37094
20180206	3호선	수서	18506	18582	20180209	37088
20180117	경인선	동인천	19026	18045	20180120	37071
20180112	7호선	남구로	17985	19053	20180115	37038
20180113	9호선	고속터미널	13384	23646	20180116	37030
20180131	2호선	왕십리(성동구청)	20269	16760	20180203	37029
20180124	9호선	당산	19059	17969	20180127	37028
20180126	8호선	암사	19827	17186	20180129	37013
20180112	8호선	암사	19810	17197	20180115	37007
20180204	9호선	노량진	17561	19441	20180207	37002
20180124	경원선	의정부	18301	18697	20180127	36998
20180126	경부선	가산디지털단지	16868	20113	20180129	36981
20180119	7호선	강남구청	17435	19543	20180122	36978
20180131	3호선	수서	18374	18602	20180203	36976
20180205	2호선	잠실나루	18889	18081	20180208	36970
20180125	8호선	장지	18611	18348	20180128	36959
20180125	7호선	고속터미널	19878	17073	20180128	36951
20180211	2호선	낙성대	18543	18406	20180214	36949
20180208	7호선	이수	18659	18285	20180211	36944
20180123	2호선	잠실나루	18791	18152	20180126	36943
20180122	7호선	이수	18522	18390	20180125	36912
20180211	4호선	쌍문	19565	17345	20180214	36910
20180130	2호선	왕십리(성동구청)	20323	16587	20180202	36910
20180121	2호선	낙성대	18307	18598	20180124	36905
20180117	경원선	왕십리(성동구청)	17175	19730	20180120	36905
20180124	7호선	남구로	17714	19181	20180127	36895
20180121	5호선	까치산	18718	18167	20180124	36885
20180121	4호선	사당	19665	17209	20180124	36874
20180127	5호선	천호(풍납토성)	18371	18496	20180130	36867
20180207	7호선	이수	18432	18425	20180210	36857
20180130	4호선	서울역	14704	22146	20180202	36850
20180113	4호선	길음	18966	17883	20180116	36849
20180112	과천선	평촌	18636	18212	20180115	36848
20180123	6호선	응암	18553	18294	20180126	36847
20180113	2호선	봉천	19220	17615	20180116	36835
20180113	2호선	구의(광진구청)	18800	18024	20180116	36824
20180120	4호선	길음	18984	17839	20180123	36823
20180117	4호선	미아(서울사이버대학)	19106	17712	20180120	36818
20180204	4호선	쌍문	19605	17190	20180207	36795
20180120	2호선	동대문역사문화공원	17644	19146	20180123	36790
20180115	4호선	서울역	14530	22259	20180118	36789
20180207	5호선	발산	18680	18091	20180210	36771
20180208	7호선	강남구청	17431	19337	20180211	36768
20180112	2호선	동대문역사문화공원	16935	19831	20180115	36766
20180124	경부선	독산	17820	18941	20180127	36761
20180115	4호선	미아(서울사이버대학)	19018	17711	20180118	36729
20180204	2호선	낙성대	18318	18398	20180207	36716
20180118	7호선	강남구청	17408	19306	20180121	36714
20180130	2호선	이대	18164	18546	20180202	36710
20180117	7호선	강남구청	17460	19244	20180120	36704
20180126	7호선	남구로	17824	18877	20180129	36701
20180121	중앙선	회기	18289	18412	20180124	36701
20180126	경부선	독산	17939	18747	20180129	36686
20180211	과천선	범계	18523	18154	20180214	36677
20180207	7호선	상봉(시외버스터미널)	18779	17892	20180210	36671
20180125	경부선	독산	17655	18997	20180128	36652
20180203	9호선	고속터미널	13072	23579	20180206	36651
20180123	3호선	수서	18260	18386	20180126	36646
20180114	2호선	신대방	18732	17907	20180117	36639
20180201	4호선	서울역	14767	21869	20180204	36636
20180121	2호선	신대방	18705	17913	20180124	36618
20180123	경인선	동암	18375	18224	20180126	36599
20180114	과천선	경마공원	18105	18471	20180117	36576
20180207	7호선	강남구청	17316	19250	20180210	36566
20180115	7호선	상봉(시외버스터미널)	18750	17815	20180118	36565
20180208	7호선	신대방삼거리	18654	17896	20180211	36550
20180120	8호선	천호(풍납토성)	16911	19630	20180123	36541
20180130	5호선	발산	18508	18032	20180202	36540
20180211	1호선	종로3가	19323	17215	20180214	36538
20180128	과천선	경마공원	18217	18319	20180131	36536
20180201	4호선	미아(서울사이버대학)	19003	17517	20180204	36520
20180124	8호선	암사	19393	17127	20180127	36520
20180125	7호선	남구로	17551	18962	20180128	36513
20180212	7호선	신대방삼거리	18598	17909	20180215	36507
20180115	2호선	동대문역사문화공원	16923	19577	20180118	36500
20180119	1호선	신설동	18449	18047	20180122	36496
20180130	7호선	신대방삼거리	18424	18071	20180202	36495
20180125	과천선	평촌	18336	18139	20180128	36475
20180131	5호선	답십리	19038	17435	20180203	36473
20180114	5호선	까치산	18403	18051	20180117	36454
20180127	3호선	안국	17269	19184	20180130	36453
20180205	2호선	동대문역사문화공원	16991	19460	20180208	36451
20180117	7호선	신대방삼거리	18602	17845	20180120	36447
20180211	3호선	양재(서초구청)	17150	19285	20180214	36435
20180128	2호선	낙성대	18197	18222	20180131	36419
20180130	5호선	답십리	18944	17473	20180202	36417
20180131	7호선	신대방삼거리	18701	17705	20180203	36406
20180112	분당선	압구정로데오	16848	19542	20180115	36390
20180119	5호선	종로3가	18185	18204	20180122	36389
20180112	7호선	이수	18269	18106	20180115	36375
20180114	4호선	사당	19229	17145	20180117	36374
20180112	2호선	이대	18031	18338	20180115	36369
20180125	8호선	암사	19326	17036	20180128	36362
20180117	안산선	중앙	17576	18783	20180120	36359
20180130	5호선	마포	17836	18521	20180202	36357
20180119	9호선	염창	18678	17646	20180122	36324
20180121	경인선	송내	18369	17951	20180124	36320
20180130	9호선	염창	17879	18426	20180202	36305
20180125	안산선	산본	17564	18731	20180128	36295
20180113	2호선	동대문역사문화공원	17483	18810	20180116	36293
20180114	중앙선	회기	18094	18180	20180117	36274
20180121	경부선	안양	18434	17837	20180124	36271
20180114	경인선	송내	18199	18066	20180117	36265
20180206	7호선	강남구청	17283	18980	20180209	36263
20180129	2호선	잠실나루	18452	17798	20180201	36250
20180203	4호선	길음	18579	17658	20180206	36237
20180128	4호선	창동	17555	18676	20180131	36231
20180128	3호선	양재(서초구청)	17311	18914	20180131	36225
20180112	6호선	응암	18445	17779	20180115	36224
20180118	경인선	동인천	18520	17703	20180121	36223
20180131	4호선	서울역	14427	21794	20180203	36221
20180207	4호선	서울역	14502	21715	20180210	36217
20180208	분당선	압구정로데오	17005	19206	20180211	36211
20180117	5호선	답십리	19010	17179	20180120	36189
20180112	2호선	잠실나루	18662	17521	20180115	36183
20180204	분당선	야탑	17965	18203	20180207	36168
20180131	2호선	이대	17818	18349	20180203	36167
20180208	경원선	왕십리(성동구청)	17090	19070	20180211	36160
20180201	2호선	왕십리(성동구청)	19891	16268	20180204	36159
20180122	4호선	서울역	14350	21805	20180125	36155
20180212	5호선	발산	18213	17937	20180215	36150
20180131	9호선	염창	18448	17699	20180203	36147
20180208	4호선	미아(서울사이버대학)	18611	17524	20180211	36135
20180113	8호선	천호(풍납토성)	16632	19503	20180116	36135
20180118	7호선	신대방삼거리	18433	17679	20180121	36112
20180115	7호선	신대방삼거리	18297	17808	20180118	36105
20180118	경원선	왕십리(성동구청)	16948	19150	20180121	36098
20180115	7호선	이수	18091	18004	20180118	36095
20180126	2호선	잠실나루	18821	17271	20180129	36092
20180203	경원선	청량리(서울시립대입구)	17503	18584	20180206	36087
20180212	2호선	왕십리(성동구청)	19889	16187	20180215	36076
20180120	1호선	시청	18220	17849	20180123	36069
20180126	과천선	평촌	18208	17857	20180129	36065
20180206	4호선	서울역	14677	21385	20180209	36062
20180126	2호선	동대문역사문화공원	16610	19445	20180129	36055
20180207	7호선	신대방삼거리	18322	17732	20180210	36054
20180122	안산선	중앙	17698	18356	20180125	36054
20180124	과천선	평촌	18116	17935	20180127	36051
20180122	7호선	상봉(시외버스터미널)	18608	17441	20180125	36049
20180118	4호선	미아(서울사이버대학)	18578	17443	20180121	36021
20180203	8호선	천호(풍납토성)	16534	19459	20180206	35993
20180117	5호선	마포	17706	18274	20180120	35980
20180211	3호선	신사	18041	17937	20180214	35978
20180119	7호선	건대입구	17481	18494	20180122	35975
20180206	2호선	동대문역사문화공원	16706	19265	20180209	35971
20180129	3호선	수서	17907	18063	20180201	35970
20180120	안산선	상록수	18452	17513	20180123	35965
20180206	4호선	미아(서울사이버대학)	18746	17188	20180209	35934
20180131	5호선	발산	17946	17960	20180203	35906
20180119	5호선	발산	17934	17963	20180122	35897
20180124	7호선	고속터미널	19171	16725	20180127	35896
20180125	3호선	수서	18002	17886	20180128	35888
20180127	7호선	노원	17276	18604	20180130	35880
20180123	4호선	서울역	14422	21456	20180126	35878
20180123	7호선	이수	18071	17797	20180126	35868
20180114	경부선	안양	18127	17734	20180117	35861
20180120	3호선	불광	16627	19230	20180123	35857
20180212	4호선	미아(서울사이버대학)	18545	17308	20180215	35853
20180205	4호선	서울역	14405	21443	20180208	35848
20180128	경원선	의정부	17724	18117	20180131	35841
20180203	2호선	동대문역사문화공원	16982	18850	20180206	35832
20180118	안산선	중앙	17436	18386	20180121	35822
20180203	7호선	가산디지털단지	18767	17041	20180206	35808
20180119	5호선	답십리	18783	17023	20180122	35806
20180118	9호선	염창	18082	17722	20180121	35804
20180128	과천선	범계	18212	17591	20180131	35803
20180124	안산선	산본	17268	18529	20180127	35797
20180125	6호선	응암	17971	17810	20180128	35781
20180115	안산선	중앙	17393	18386	20180118	35779
20180115	2호선	왕십리(성동구청)	19725	16049	20180118	35774
20180128	중앙선	회기	17843	17925	20180131	35768
20180205	7호선	상봉(시외버스터미널)	18396	17365	20180208	35761
20180205	4호선	미아(서울사이버대학)	18595	17162	20180208	35757
20180126	7호선	이수	17704	18048	20180129	35752
20180206	7호선	상봉(시외버스터미널)	18323	17427	20180209	35750
20180126	2호선	왕십리(성동구청)	19666	16083	20180129	35749
20180122	4호선	미아(서울사이버대학)	18398	17351	20180125	35749
20180130	7호선	사가정	17653	18088	20180202	35741
20180128	5호선	까치산	18112	17629	20180131	35741
20180112	경원선	왕십리(성동구청)	16303	19438	20180115	35741
20180206	2호선	왕십리(성동구청)	20016	15717	20180209	35733
20180129	2호선	이대	17457	18270	20180201	35727
20180127	4호선	동대문역사문화공원	19262	16463	20180130	35725
20180114	공항철도 1호선	인천공항1터미널	17290	18423	20180117	35713
20180121	7호선	광명사거리	18043	17663	20180124	35706
20180120	7호선	가산디지털단지	18560	17146	20180123	35706
20180124	3호선	수서	17869	17830	20180127	35699
20180212	7호선	강남구청	16947	18747	20180215	35694
20180201	7호선	신대방삼거리	18131	17561	20180204	35692
20180207	5호선	답십리	18617	17072	20180210	35689
20180122	2호선	동대문역사문화공원	16513	19175	20180125	35688
20180208	9호선	염창	18161	17490	20180211	35651
20180129	4호선	서울역	14166	21482	20180201	35648
20180211	분당선	야탑	17580	18061	20180214	35641
20180206	7호선	이수	17913	17726	20180209	35639
20180120	일산선	화정	17491	18141	20180123	35632
20180121	경인선	역곡	17965	17659	20180124	35624
20180203	경부선	구로	17312	18310	20180206	35622
20180117	5호선	발산	17917	17702	20180120	35619
20180113	1호선	시청	17674	17942	20180116	35616
20180211	5호선	까치산	18057	17554	20180214	35611
20180122	2호선	이대	17575	18028	20180125	35603
20180122	7호선	신대방삼거리	18050	17545	20180125	35595
20180208	안산선	중앙	17449	18138	20180211	35587
20180114	6호선	이태원	19186	16401	20180117	35587
20180126	2호선	이대	17846	17739	20180129	35585
20180208	5호선	답십리	18560	17018	20180211	35578
20180130	4호선	신용산	17588	17982	20180202	35570
20180206	7호선	신대방삼거리	18076	17480	20180209	35556
20180201	분당선	압구정로데오	16733	18823	20180204	35556
20180201	경원선	왕십리(성동구청)	16698	18846	20180204	35544
20180126	6호선	응암	17947	17574	20180129	35521
20180114	3호선	압구정	17515	18003	20180117	35518
20180114	경부선	금정	17460	18057	20180117	35517
20180205	7호선	신대방삼거리	18065	17449	20180208	35514
20180201	9호선	염창	18080	17424	20180204	35504
20180128	분당선	야탑	17706	17797	20180131	35503
20180114	경인선	역곡	17993	17510	20180117	35503
20180126	6호선	이태원	15090	20403	20180129	35493
20180204	과천선	경마공원	17566	17926	20180207	35492
20180201	5호선	답십리	18711	16770	20180204	35481
20180123	2호선	이대	17402	18065	20180126	35467
20180117	9호선	염창	17931	17536	20180120	35467
20180123	1호선	제기동	17664	17794	20180126	35458
20180123	7호선	강남구청	16773	18680	20180126	35453
20180129	7호선	이수	17872	17578	20180201	35450
20180131	4호선	신용산	17181	18268	20180203	35449
20180126	경인선	동암	17770	17668	20180129	35438
20180124	6호선	응암	17710	17700	20180127	35410
20180119	5호선	마포	17176	18222	20180122	35398
20180212	9호선	염창	18048	17349	20180215	35397
20180128	2호선	신대방	18051	17346	20180131	35397
20180131	경원선	왕십리(성동구청)	16513	18881	20180203	35394
20180211	경원선	의정부	17668	17707	20180214	35375
20180115	4호선	신용산	17024	18336	20180118	35360
20180207	5호선	우장산	17562	17796	20180210	35358
20180126	분당선	압구정로데오	16422	18930	20180129	35352
20180205	2호선	왕십리(성동구청)	19557	15784	20180208	35341
20180212	4호선	신용산	17113	18225	20180215	35338
20180125	4호선	서울역	13968	21369	20180128	35337
20180118	분당선	압구정로데오	16555	18782	20180121	35337
20180130	경원선	왕십리(성동구청)	16141	19191	20180202	35332
20180122	2호선	왕십리(성동구청)	19369	15953	20180125	35322
20180131	7호선	중계	18394	16916	20180203	35310
20180118	경부선	대방	17669	17638	20180121	35307
20180207	분당선	압구정로데오	16725	18579	20180210	35304
20180121	6호선	이태원	19051	16240	20180124	35291
20180120	경인선	동암	17603	17686	20180123	35289
20180119	7호선	사가정	17780	17509	20180122	35289
20180115	9호선	염창	17858	17428	20180118	35286
20180204	2호선	신대방	17875	17390	20180207	35265
20180204	경원선	의정부	17417	17843	20180207	35260
20180118	5호선	답십리	18507	16750	20180121	35257
20180121	경부선	금정	17210	18041	20180124	35251
20180117	7호선	내방	17362	17886	20180120	35248
20180129	7호선	상봉(시외버스터미널)	18013	17230	20180201	35243
20180122	7호선	강남구청	16750	18486	20180125	35236
20180206	5호선	발산	17861	17365	20180209	35226
20180122	9호선	염창	17725	17496	20180125	35221
20180126	7호선	강남구청	16689	18528	20180129	35217
20180125	2호선	동대문역사문화공원	16369	18848	20180128	35217
20180131	7호선	사가정	17743	17466	20180203	35209
20180128	4호선	사당	18793	16409	20180131	35202
20180112	4호선	신용산	17280	17922	20180115	35202
20180124	4호선	서울역	14161	21038	20180127	35199
20180212	경원선	왕십리(성동구청)	16548	18627	20180215	35175
20180130	1호선	신설동	18082	17081	20180202	35163
20180131	안산선	중앙	16920	18241	20180203	35161
20180212	2호선	동대문역사문화공원	16467	18687	20180215	35154
20180201	5호선	발산	17723	17422	20180204	35145
20180117	4호선	신용산	17064	18075	20180120	35139
20180112	7호선	상봉(시외버스터미널)	17987	17150	20180115	35137
20180212	안산선	중앙	17297	17835	20180215	35132
20180130	7호선	건대입구	17020	18098	20180202	35118
20180131	경인선	동인천	17902	17211	20180203	35113
20180207	9호선	염창	17759	17351	20180210	35110
20180205	7호선	이수	17683	17420	20180208	35103
20180130	5호선	공덕	16925	18154	20180202	35079
20180211	중앙선	회기	17697	17381	20180214	35078
20180117	7호선	건대입구	17224	17849	20180120	35073
20180208	7호선	면목	17658	17407	20180211	35065
20180204	과천선	범계	17816	17236	20180207	35052
20180118	4호선	신용산	17060	17992	20180121	35052
20180127	2호선	봉천	18375	16676	20180130	35051
20180115	7호선	강남구청	16680	18365	20180118	35045
20180113	안산선	상록수	17981	17055	20180116	35036
20180112	7호선	강남구청	16566	18468	20180115	35034
20180126	7호선	상봉(시외버스터미널)	17859	17174	20180129	35033
20180125	2호선	잠실나루	17854	17160	20180128	35014
20180211	2호선	신대방	17878	17130	20180214	35008
20180130	7호선	내방	17186	17815	20180202	35001
20180122	7호선	내방	17197	17796	20180125	34993
20180113	7호선	가산디지털단지	18103	16890	20180116	34993
20180208	경인선	동인천	17803	17189	20180211	34992
20180117	분당선	죽전	16324	18667	20180120	34991
20180204	5호선	까치산	17694	17294	20180207	34988
20180201	경인선	동인천	17957	17028	20180204	34985
20180123	2호선	왕십리(성동구청)	19254	15728	20180126	34982
20180211	3호선	압구정	17108	17871	20180214	34979
20180131	5호선	마포	17238	17741	20180203	34979
20180212	분당선	압구정로데오	16535	18436	20180215	34971
20180207	경원선	왕십리(성동구청)	16525	18443	20180210	34968
20180208	7호선	사가정	17523	17442	20180211	34965
20180208	5호선	마포	17144	17818	20180211	34962
20180118	7호선	건대입구	17196	17766	20180121	34962
20180206	분당선	압구정로데오	16468	18486	20180209	34954
20180118	분당선	죽전	16138	18814	20180121	34952
20180203	2호선	이대	17108	17841	20180206	34949
20180211	6호선	이태원	18746	16200	20180214	34946
20180201	안산선	중앙	17108	17835	20180204	34943
20180119	7호선	내방	17206	17731	20180122	34937
20180117	5호선	우장산	17619	17315	20180120	34934
20180115	경원선	왕십리(성동구청)	16273	18657	20180118	34930
20180212	분당선	죽전	16221	18708	20180215	34929
20180118	1호선	신설동	17589	17332	20180121	34921
20180120	2호선	당산	16577	18342	20180123	34919
20180115	경인선	동인천	17958	16956	20180118	34914
20180125	경인선	동암	17446	17466	20180128	34912
20180208	4호선	신용산	17039	17870	20180211	34909
20180122	5호선	답십리	18081	16828	20180125	34909
20180207	5호선	마포	17099	17809	20180210	34908
20180208	1호선	신설동	17737	17168	20180211	34905
20180212	7호선	내방	17123	17778	20180215	34901
20180124	7호선	강남구청	16616	18283	20180127	34899
20180129	4호선	미아(서울사이버대학)	18148	16749	20180201	34897
20180123	7호선	신대방삼거리	17690	17186	20180126	34876
20180113	3호선	불광	16317	18553	20180116	34870
20180120	경원선	왕십리(성동구청)	16168	18698	20180123	34866
20180115	5호선	답십리	18309	16555	20180118	34864
20180131	6호선	디지털미디어시티	16252	18604	20180203	34856
20180207	경인선	동인천	17709	17144	20180210	34853
20180115	5호선	발산	17414	17436	20180118	34850
20180201	4호선	신용산	17086	17760	20180204	34846
20180112	안산선	중앙	16530	18316	20180115	34846
20180130	분당선	한티	16954	17891	20180202	34845
20180124	경인선	동암	17481	17362	20180127	34843
20180118	5호선	마포	17131	17709	20180121	34840
20180131	분당선	죽전	16098	18736	20180203	34834
20180119	8호선	잠실(송파구청)	16012	18809	20180122	34821
20180201	5호선	우장산	17485	17332	20180204	34817
20180118	7호선	내방	17134	17681	20180121	34815
20180118	5호선	발산	17653	17155	20180121	34808
20180212	5호선	답십리	18142	16657	20180215	34799
20180122	경인선	동인천	17856	16943	20180125	34799
20180131	7호선	내방	17193	17583	20180203	34776
20180117	7호선	사가정	17301	17473	20180120	34774
20180126	7호선	건대입구	16760	18010	20180129	34770
20180129	2호선	동대문역사문화공원	16076	18691	20180201	34767
20180120	2호선	이대	16930	17829	20180123	34759
20180117	경부선	대방	17296	17460	20180120	34756
20180127	9호선	고속터미널	12292	22462	20180130	34754
20180131	1호선	신설동	17613	17128	20180203	34741
20180205	7호선	강남구청	16577	18137	20180208	34714
20180212	7호선	건대입구	16820	17886	20180215	34706
20180123	7호선	상봉(시외버스터미널)	17847	16833	20180126	34680
20180208	7호선	내방	17000	17674	20180211	34674
20180131	분당선	압구정로데오	16222	18448	20180203	34670
20180125	7호선	강남구청	16252	18413	20180128	34665
20180211	4호선	사당	18643	15997	20180214	34640
20180206	9호선	염창	17480	17151	20180209	34631
20180126	4호선	신용산	17025	17605	20180129	34630
20180122	경원선	왕십리(성동구청)	16204	18425	20180125	34629
20180131	5호선	우장산	17390	17233	20180203	34623
20180117	1호선	신설동	17422	17198	20180120	34620
20180119	분당선	수서	17244	17361	20180122	34605
20180123	2호선	동대문역사문화공원	16093	18493	20180126	34586
20180205	5호선	발산	17619	16962	20180208	34581
20180119	5호선	우장산	17585	16986	20180122	34571
20180125	2호선	이대	17032	17522	20180128	34554
20180208	분당선	죽전	15988	18562	20180211	34550
20180117	공항철도 1호선	인천공항1터미널	17378	17171	20180120	34549
20180127	4호선	길음	17778	16758	20180130	34536
20180122	5호선	발산	17290	17244	20180125	34534
20180125	2호선	왕십리(성동구청)	18991	15539	20180128	34530
20180129	7호선	신대방삼거리	17511	17016	20180201	34527
20180112	7호선	건대입구	16683	17837	20180115	34520
20180125	7호선	이수	17412	17099	20180128	34511
20180112	4호선	미아(서울사이버대학)	18057	16449	20180115	34506
20180130	4호선	한성대입구(삼선교)	17209	17296	20180202	34505
20180119	분당선	수내	17227	17277	20180122	34504
20180115	7호선	내방	16970	17534	20180118	34504
20180128	3호선	신사	17315	17183	20180131	34498
20180212	5호선	마포	16986	17501	20180215	34487
20180112	7호선	신대방삼거리	17682	16802	20180115	34484
20180113	안산선	중앙	16535	17946	20180116	34481
20180119	2호선	신당	16974	17492	20180122	34466
20180124	2호선	잠실나루	17622	16816	20180127	34438
20180118	7호선	사가정	17191	17238	20180121	34429
20180117	6호선	디지털미디어시티	16174	18251	20180120	34425
20180119	분당선	한티	16830	17569	20180122	34399
20180118	5호선	우장산	17365	17028	20180121	34393
20180130	6호선	디지털미디어시티	16051	18337	20180202	34388
20180128	경인선	송내	17333	17048	20180131	34381
20180201	7호선	사가정	17224	17151	20180204	34375
20180207	4호선	신용산	16806	17562	20180210	34368
20180122	분당선	죽전	15810	18546	20180125	34356
20180114	3호선	신사	17400	16947	20180117	34347
20180203	7호선	건대입구	16904	17440	20180206	34344
20180204	3호선	신사	17298	17036	20180207	34334
20180127	2호선	구의(광진구청)	17552	16781	20180130	34333
20180201	1호선	신설동	17281	17049	20180204	34330
20180207	안산선	중앙	16723	17602	20180210	34325
20180212	분당선	한티	16702	17615	20180215	34317
20180124	2호선	왕십리(성동구청)	18935	15369	20180127	34304
20180126	경원선	왕십리(성동구청)	15657	18645	20180129	34302
20180128	경부선	안양	17379	16919	20180131	34298
20180131	7호선	건대입구	16616	17679	20180203	34295
20180201	7호선	내방	16820	17470	20180204	34290
20180130	8호선	잠실(송파구청)	16295	17981	20180202	34276
20180113	분당선	미금	16789	17484	20180116	34273
20180208	5호선	우장산	17147	17113	20180211	34260
20180205	5호선	답십리	17889	16371	20180208	34260
20180122	4호선	신용산	16678	17576	20180125	34254
20180203	3호선	불광	15968	18283	20180206	34251
20180121	3호선	압구정	16893	17356	20180124	34249
20180119	5호선	공덕	16473	17770	20180122	34243
20180115	1호선	신설동	17319	16912	20180118	34231
20180205	7호선	사가정	17122	17099	20180208	34221
20180208	분당선	한티	16506	17709	20180211	34215
20180123	9호선	염창	17329	16884	20180126	34213
20180201	6호선	디지털미디어시티	16070	18140	20180204	34210
20180207	7호선	중계	17659	16535	20180210	34194
20180208	2호선	신당	16786	17404	20180211	34190
20180119	일산선	삼송	17556	16634	20180122	34190
20180119	6호선	디지털미디어시티	16349	17834	20180122	34183
20180207	7호선	사가정	17154	17027	20180210	34181
20180130	7호선	면목	16873	17305	20180202	34178
20180118	5호선	종로3가	17751	16427	20180121	34178
20180206	5호선	답십리	17886	16291	20180209	34177
20180113	경인선	동암	17092	17084	20180116	34176
20180125	경인선	구일	15770	18401	20180128	34171
20180208	5호선	공덕	16590	17578	20180211	34168
20180201	분당선	죽전	16053	18111	20180204	34164
20180203	일산선	화정	16666	17491	20180206	34157
20180130	5호선	우장산	16818	17335	20180202	34153
20180117	5호선	종로3가	17563	16588	20180120	34151
20180113	경원선	왕십리(성동구청)	15732	18419	20180116	34151
20180115	6호선	디지털미디어시티	16235	17897	20180118	34132
20180119	경부선	대방	17184	16947	20180122	34131
20180127	1호선	제기동	16941	17179	20180130	34120
20180211	경부선	금정	16642	17469	20180214	34111
20180118	6호선	디지털미디어시티	15977	18123	20180121	34100
20180130	2호선	신당	16596	17502	20180202	34098
20180112	9호선	고속터미널	13023	21073	20180115	34096
20180126	9호선	고속터미널	12745	21348	20180129	34093
20180201	5호선	마포	16801	17290	20180204	34091
20180212	7호선	사가정	17023	17067	20180215	34090
20180201	8호선	잠실(송파구청)	15197	18880	20180204	34077
20180131	분당선	한티	16465	17612	20180203	34077
20180128	3호선	압구정	16782	17284	20180131	34066
20180211	경부선	안양	17240	16823	20180214	34063
20180211	경인선	역곡	17229	16822	20180214	34051
20180115	5호선	우장산	16976	17073	20180118	34049
20180124	7호선	이수	17019	17019	20180127	34038
20180130	안산선	중앙	16707	17330	20180202	34037
20180204	1호선	종로3가	17897	16137	20180207	34034
20180204	4호선	사당	18220	15809	20180207	34029
20180207	7호선	내방	16688	17335	20180210	34023
20180211	7호선	광명사거리	17163	16850	20180214	34013
20180129	7호선	강남구청	16189	17823	20180201	34012
20180123	7호선	내방	16678	17334	20180126	34012
20180206	5호선	마포	16793	17215	20180209	34008
20180121	3호선	신사	17006	17000	20180124	34006
20180129	2호선	왕십리(성동구청)	18657	15348	20180201	34005
20180127	2호선	성수	16414	17590	20180130	34004
20180122	1호선	신설동	17025	16967	20180125	33992
20180122	경부선	대방	16808	17177	20180125	33985
20180112	1호선	제기동	16960	17025	20180115	33985
20180121	4호선	노원	16298	17675	20180124	33973
20180115	7호선	사가정	16918	17051	20180118	33969
20180211	경인선	송내	16949	17018	20180214	33967
20180205	9호선	염창	17163	16786	20180208	33949
20180126	7호선	신대방삼거리	17330	16612	20180129	33942
20180117	2호선	신당	16557	17379	20180120	33936
20180128	경부선	금정	16550	17381	20180131	33931
20180114	5호선	광화문(세종문화회관)	16941	16980	20180117	33921
20180205	7호선	내방	16647	17273	20180208	33920
20180117	분당선	압구정로데오	15994	17926	20180120	33920
20180131	5호선	공덕	16280	17624	20180203	33904
20180115	분당선	죽전	15626	18277	20180118	33903
20180130	7호선	중계	17348	16553	20180202	33901
20180115	5호선	마포	16678	17206	20180118	33884
20180113	일산선	화정	16539	17337	20180116	33876
20180112	분당선	죽전	15962	17911	20180115	33873
20180201	2호선	신당	16614	17253	20180204	33867
20180208	6호선	디지털미디어시티	15894	17970	20180211	33864
20180122	7호선	사가정	16874	16982	20180125	33856
20180122	경원선	청량리(서울시립대입구)	16193	17656	20180125	33849
20180204	3호선	압구정	16729	17119	20180207	33848
20180117	5호선	공덕	16310	17534	20180120	33844
20180125	7호선	상봉(시외버스터미널)	17378	16463	20180128	33841
20180117	7호선	중계	17610	16229	20180120	33839
20180115	경부선	대방	16950	16886	20180118	33836
20180129	9호선	염창	17062	16769	20180201	33831
20180203	1호선	시청	17245	16582	20180206	33827
20180207	5호선	공덕	16376	17445	20180210	33821
20180128	경인선	역곡	17129	16679	20180131	33808
20180204	경인선	역곡	17150	16652	20180207	33802
20180212	경인선	동인천	17360	16418	20180215	33778
20180212	5호선	우장산	16966	16808	20180215	33774
20180208	7호선	건대입구	16439	17327	20180211	33766
20180127	경원선	청량리(서울시립대입구)	16338	17424	20180130	33762
20180112	9호선	염창	17190	16570	20180115	33760
20180123	4호선	미아(서울사이버대학)	17491	16268	20180126	33759
20180123	안산선	중앙	16538	17220	20180126	33758
20180212	1호선	신설동	17083	16672	20180215	33755
20180206	7호선	내방	16589	17162	20180209	33751
20180123	5호선	답십리	17614	16119	20180126	33733
20180207	1호선	신설동	17177	16552	20180210	33729
20180131	2호선	신당	16549	17176	20180203	33725
20180125	1호선	제기동	16829	16890	20180128	33719
20180205	4호선	신용산	16394	17317	20180208	33711
20180130	경부선	대방	16656	17051	20180202	33707
20180121	5호선	화곡	17327	16376	20180124	33703
20180114	4호선	노원	16149	17551	20180117	33700
20180127	3호선	경복궁(정부서울청사)	16439	17255	20180130	33694
20180203	안산선	상록수	17160	16533	20180206	33693
20180206	5호선	우장산	16984	16700	20180209	33684
20180114	7호선	광명사거리	17066	16616	20180117	33682
20180127	8호선	천호(풍납토성)	15574	18077	20180130	33651
20180124	7호선	신대방삼거리	17170	16479	20180127	33649
20180119	6호선	합정	17576	16062	20180122	33638
20180129	5호선	답십리	17540	16097	20180201	33637
20180119	4호선	숙대입구(갈월)	16849	16767	20180122	33616
20180126	4호선	미아(서울사이버대학)	17512	16096	20180129	33608
20180118	2호선	신당	16531	17067	20180121	33598
20180113	2호선	이대	16304	17287	20180116	33591
20180120	경인선	동인천	17059	16531	20180123	33590
20180205	5호선	우장산	16918	16671	20180208	33589
20180207	7호선	건대입구	16328	17256	20180210	33584
20180128	3호선	경복궁(정부서울청사)	15417	18163	20180131	33580
20180206	4호선	신용산	16425	17145	20180209	33570
20180120	2호선	왕십리(성동구청)	17994	15571	20180123	33565
20180203	3호선	구파발	17169	16385	20180206	33554
20180207	2호선	신당	16256	17294	20180210	33550
20180129	4호선	신용산	16290	17259	20180201	33549
20180119	4호선	한성대입구(삼선교)	17253	16290	20180122	33543
20180112	8호선	잠실(송파구청)	15394	18149	20180115	33543
20180117	4호선	숙대입구(갈월)	16855	16686	20180120	33541
20180120	안산선	산본	16158	17368	20180123	33526
20180120	4호선	상계	17624	15900	20180123	33524
20180124	2호선	이대	16652	16866	20180127	33518
20180122	6호선	디지털미디어시티	15792	17722	20180125	33514
20180123	경원선	왕십리(성동구청)	15825	17683	20180126	33508
20180207	분당선	한티	16204	17303	20180210	33507
20180205	5호선	마포	16516	16990	20180208	33506
20180204	경인선	송내	16878	16624	20180207	33502
20180130	일산선	삼송	16853	16640	20180202	33493
20180129	7호선	내방	16504	16985	20180201	33489
20180129	5호선	마포	16443	17045	20180201	33488
20180212	분당선	수내	16741	16745	20180215	33486
20180203	경원선	왕십리(성동구청)	15316	18170	20180206	33486
20180206	5호선	공덕	16165	17318	20180209	33483
20180131	7호선	면목	17145	16334	20180203	33479
20180130	분당선	죽전	15351	18117	20180202	33468
20180126	9호선	염창	16995	16473	20180129	33468
20180201	7호선	건대입구	16386	17073	20180204	33459
20180207	경부선	대방	16670	16785	20180210	33455
20180201	경부선	대방	16643	16807	20180204	33450
20180131	경부선	대방	16613	16828	20180203	33441
20180125	7호선	신대방삼거리	17051	16387	20180128	33438
20180119	안산선	안산	17774	15663	20180122	33437
20180119	7호선	면목	17153	16278	20180122	33431
20180207	6호선	디지털미디어시티	15631	17799	20180210	33430
20180124	7호선	상봉(시외버스터미널)	17257	16173	20180127	33430
20180112	5호선	답십리	17561	15867	20180115	33428
20180206	경원선	왕십리(성동구청)	15610	17816	20180209	33426
20180203	분당선	미금	16337	17081	20180206	33418
20180206	1호선	신설동	16826	16587	20180209	33413
20180130	경인선	동인천	17035	16378	20180202	33413
20180123	분당선	압구정로데오	15854	17557	20180126	33411
20180203	2호선	당산	15755	17651	20180206	33406
20180208	4호선	숙대입구(갈월)	16701	16704	20180211	33405
20180208	경부선	대방	16606	16797	20180211	33403
20180208	분당선	수내	16618	16779	20180211	33397
20180203	9호선	가양	17074	16323	20180206	33397
20180114	2호선	잠실새내	16085	17312	20180117	33397
20180128	4호선	노원	16236	17160	20180131	33396
20180120	분당선	미금	16386	17006	20180123	33392
20180206	7호선	사가정	16707	16681	20180209	33388
20180123	5호선	마포	16471	16914	20180126	33385
20180119	7호선	신중동	16714	16665	20180122	33379
20180204	7호선	광명사거리	16905	16468	20180207	33373
20180127	7호선	가산디지털단지	17516	15849	20180130	33365
20180212	6호선	디지털미디어시티	15847	17498	20180215	33345
20180131	8호선	잠실(송파구청)	15375	17968	20180203	33343
20180207	7호선	면목	16914	16427	20180210	33341
20180122	5호선	마포	16473	16867	20180125	33340
20180127	2호선	동대문역사문화공원	15921	17411	20180130	33332
20180211	5호선	광화문(세종문화회관)	16715	16613	20180214	33328
20180117	일산선	삼송	16914	16399	20180120	33313
20180207	4호선	숙대입구(갈월)	16652	16657	20180210	33309
20180113	2호선	당산	15898	17410	20180116	33308
20180129	7호선	사가정	16545	16762	20180201	33307
20180125	7호선	건대입구	16121	17177	20180128	33298
20180130	분당선	선릉	11276	22000	20180202	33276
20180118	6호선	이태원	15792	17479	20180121	33271
20180117	7호선	면목	16955	16308	20180120	33263
20180205	4호선	숙대입구(갈월)	16677	16578	20180208	33255
20180126	8호선	잠실(송파구청)	15390	17859	20180129	33249
20180113	7호선	건대입구	15974	17273	20180116	33247
20180204	경부선	안양	16841	16401	20180207	33242
20180130	분당선	수내	16491	16746	20180202	33237
20180201	7호선	중계	17393	15841	20180204	33234
20180212	분당선	선릉	10712	22512	20180215	33224
20180113	3호선	구파발	16982	16227	20180116	33209
20180205	경원선	왕십리(성동구청)	15771	17435	20180208	33206
20180207	분당선	죽전	15433	17771	20180210	33204
20180205	분당선	압구정로데오	15731	17473	20180208	33204
20180123	4호선	신용산	16220	16983	20180126	33203
20180212	경원선	청량리(서울시립대입구)	16024	17166	20180215	33190
20180123	5호선	발산	16746	16444	20180126	33190
20180117	분당선	한티	16172	17013	20180120	33185
20180120	3호선	구파발	17035	16139	20180123	33174
20180112	경인선	동인천	17103	16069	20180115	33172
20180208	5호선	종로3가	17135	16035	20180211	33170
20180115	안산선	안산	17355	15805	20180118	33160
20180205	7호선	중계	17147	16003	20180208	33150
20180201	4호선	숙대입구(갈월)	16594	16550	20180204	33144
20180122	7호선	면목	16616	16527	20180125	33143
20180113	경인선	동인천	16776	16364	20180116	33140
20180126	안산선	중앙	15701	17438	20180129	33139
20180118	분당선	한티	16099	17034	20180121	33133
20180119	7호선	상동	16321	16805	20180122	33126
20180129	7호선	중계	17192	15924	20180201	33116
20180208	7호선	중계	17125	15989	20180211	33114
20180131	분당선	수내	16396	16717	20180203	33113
20180120	1호선	동대문	15677	17425	20180123	33102
20180124	2호선	동대문역사문화공원	15450	17647	20180127	33097
20180118	4호선	숙대입구(갈월)	16579	16517	20180121	33096
20180122	5호선	우장산	16454	16639	20180125	33093
20180115	4호선	숙대입구(갈월)	16598	16494	20180118	33092
20180118	일산선	삼송	16913	16170	20180121	33083
20180206	7호선	중계	17028	16053	20180209	33081
20180117	분당선	수내	16424	16657	20180120	33081
20180201	7호선	면목	16836	16240	20180204	33076
20180212	7호선	중계	17110	15963	20180215	33073
20180203	2호선	왕십리(성동구청)	18022	15047	20180206	33069
20180118	분당선	수내	16443	16626	20180121	33069
20180123	7호선	건대입구	16171	16895	20180126	33066
20180128	7호선	광명사거리	16704	16359	20180131	33063
20180117	경원선	청량리(서울시립대입구)	15730	17333	20180120	33063
20180129	안산선	중앙	16108	16952	20180201	33060
20180131	4호선	숙대입구(갈월)	16670	16385	20180203	33055
20180126	5호선	마포	16239	16799	20180129	33038
20180205	1호선	신설동	16767	16267	20180208	33034
20180131	일산선	삼송	16758	16272	20180203	33030
20180112	5호선	마포	16074	16950	20180115	33024
20180122	7호선	건대입구	16136	16876	20180125	33012
20180212	2호선	신당	16128	16870	20180215	32998
20180125	분당선	압구정로데오	15485	17511	20180128	32996
20180212	9호선	고속터미널	12634	20358	20180215	32992
20180206	4호선	숙대입구(갈월)	16475	16509	20180209	32984
20180115	7호선	건대입구	15996	16978	20180118	32974
20180118	8호선	잠실(송파구청)	15320	17649	20180121	32969
20180125	4호선	신용산	16112	16856	20180128	32968
20180113	안산선	산본	15903	17063	20180116	32966
20180125	9호선	염창	16660	16296	20180128	32956
20180125	4호선	미아(서울사이버대학)	17046	15909	20180128	32955
20180212	8호선	잠실(송파구청)	15176	17773	20180215	32949
20180130	4호선	숙대입구(갈월)	16418	16529	20180202	32947
20180124	9호선	염창	16678	16269	20180127	32947
20180212	경부선	대방	16460	16482	20180215	32942
20180212	7호선	면목	16749	16183	20180215	32932
20180203	경인선	동암	16402	16523	20180206	32925
20180205	7호선	건대입구	15936	16976	20180208	32912
20180118	5호선	공덕	15848	17048	20180121	32896
20180122	일산선	삼송	16664	16231	20180125	32895
20180131	분당선	선릉	10478	22410	20180203	32888
20180122	분당선	한티	15991	16895	20180125	32886
20180201	분당선	수내	16354	16522	20180204	32876
20180119	1호선	동대문	15599	17269	20180122	32868
20180208	4호선	한성대입구(삼선교)	16831	16036	20180211	32867
20180118	분당선	선릉	10693	22164	20180121	32857
20180208	일산선	삼송	16846	16008	20180211	32854
20180118	7호선	면목	16688	16164	20180121	32852
20180115	분당선	압구정로데오	15518	17326	20180118	32844
20180112	5호선	발산	16402	16442	20180115	32844
20180115	2호선	신당	16185	16650	20180118	32835
20180119	경부선	성균관대	16899	15935	20180122	32834
20180208	경원선	청량리(서울시립대입구)	15671	17161	20180211	32832
20180201	일산선	삼송	16726	16100	20180204	32826
20180120	7호선	건대입구	15720	17105	20180123	32825
20180206	6호선	디지털미디어시티	15442	17382	20180209	32824
20180204	경부선	금정	16176	16648	20180207	32824
20180122	분당선	압구정로데오	15564	17258	20180125	32822
20180122	분당선	선릉	10686	22131	20180125	32817
20180206	분당선	한티	15794	17022	20180209	32816
20180112	분당선	한티	16047	16769	20180115	32816
20180201	분당선	한티	15844	16971	20180204	32815
20180123	6호선	디지털미디어시티	15359	17456	20180126	32815
20180129	5호선	발산	16549	16265	20180201	32814
20180211	4호선	노원	15996	16806	20180214	32802
20180112	1호선	신설동	16707	16092	20180115	32799
20180115	분당선	한티	15998	16776	20180118	32774
20180206	7호선	건대입구	16019	16752	20180209	32771
20180205	경인선	동인천	16750	16021	20180208	32771
20180115	일산선	삼송	16722	16047	20180118	32769
20180115	7호선	면목	16667	16100	20180118	32767
20180126	1호선	제기동	16498	16263	20180129	32761
20180117	안산선	안산	17310	15447	20180120	32757
20180212	5호선	공덕	15749	17007	20180215	32756
20180207	4호선	한성대입구(삼선교)	16678	16075	20180210	32753
20180118	경원선	청량리(서울시립대입구)	15783	16968	20180121	32751
20180125	7호선	내방	16081	16650	20180128	32731
20180122	분당선	수내	16416	16311	20180125	32727
20180201	5호선	공덕	15810	16915	20180204	32725
20180115	분당선	선릉	10598	22127	20180118	32725
20180112	7호선	내방	16208	16513	20180115	32721
20180206	2호선	신당	15998	16721	20180209	32719
20180121	5호선	광화문(세종문화회관)	16637	16082	20180124	32719
20180207	분당선	수내	16306	16407	20180210	32713
20180205	6호선	디지털미디어시티	15405	17305	20180208	32710
20180123	경부선	대방	16336	16361	20180126	32697
20180119	9호선2단계	봉은사	16604	16090	20180122	32694
20180117	분당선	선릉	10507	22160	20180120	32667
20180123	분당선	죽전	15161	17484	20180126	32645
20180114	5호선	화곡	16658	15983	20180117	32641
20180129	경원선	왕십리(성동구청)	15412	17223	20180201	32635
20180212	일산선	삼송	16648	15978	20180215	32626
20180125	5호선	마포	16089	16528	20180128	32617
20180124	분당선	압구정로데오	15395	17213	20180127	32608
20180120	9호선	가양	16675	15930	20180123	32605
20180122	안산선	안산	16928	15676	20180125	32604
20180212	4호선	숙대입구(갈월)	16339	16250	20180215	32589
20180119	6호선	망원	15590	16997	20180122	32587
20180128	2호선	서초	16648	15936	20180131	32584
20180120	5호선	종로3가	16384	16200	20180123	32584
20180120	3호선	홍제	16673	15900	20180123	32573
20180112	경부선	대방	16314	16258	20180115	32572
20180115	경원선	청량리(서울시립대입구)	15422	17148	20180118	32570
20180117	4호선	한성대입구(삼선교)	16681	15887	20180120	32568
20180208	6호선	망원	15723	16840	20180211	32563
20180129	분당선	죽전	15087	17469	20180201	32556
20180208	8호선	잠실(송파구청)	15007	17548	20180211	32555
20180112	분당선	수서	16269	16284	20180115	32553
20180119	분당선	태평	16679	15854	20180122	32533
20180121	2호선	서초	16465	16067	20180124	32532
20180131	9호선2단계	봉은사	16310	16216	20180203	32526
20180211	1호선	제기동	15826	16698	20180214	32524
20180124	4호선	미아(서울사이버대학)	16849	15675	20180127	32524
20180115	분당선	수내	16274	16241	20180118	32515
20180113	2호선	왕십리(성동구청)	17330	15185	20180116	32515
20180205	분당선	죽전	15085	17421	20180208	32506
20180113	4호선	상계	17089	15412	20180116	32501
20180125	경원선	왕십리(성동구청)	15242	17253	20180128	32495
20180124	5호선	마포	16007	16488	20180127	32495
20180205	7호선	면목	16389	16104	20180208	32493
20180119	분당선	선릉	10318	22168	20180122	32486
20180122	2호선	신당	15937	16543	20180125	32480
20180208	분당선	선릉	10310	22168	20180211	32478
20180208	9호선	고속터미널	12938	19518	20180211	32456
20180112	7호선	사가정	16252	16203	20180115	32455
20180123	5호선	우장산	16199	16253	20180126	32452
20180129	6호선	디지털미디어시티	15275	17173	20180201	32448
20180205	경부선	대방	16101	16346	20180208	32447
20180207	일산선	삼송	16402	16040	20180210	32442
20180131	4호선	한성대입구(삼선교)	16623	15813	20180203	32436
20180123	7호선	사가정	16198	16232	20180126	32430
20180127	경부선	구로	15733	16690	20180130	32423
20180117	8호선	잠실(송파구청)	15078	17342	20180120	32420
20180206	7호선	면목	16431	15980	20180209	32411
20180205	안산선	중앙	15905	16497	20180208	32402
20180131	경원선	청량리(서울시립대입구)	15389	16998	20180203	32387
20180115	7호선	중계	16956	15429	20180118	32385
20180119	5호선	광나루(장신대)	17061	15321	20180122	32382
20180129	7호선	면목	16412	15960	20180201	32372
20180205	5호선	공덕	15593	16777	20180208	32370
20180126	5호선	답십리	16868	15494	20180129	32362
20180129	1호선	신설동	16373	15984	20180201	32357
20180203	4호선	상계	17005	15345	20180206	32350
20180124	7호선	내방	15919	16423	20180127	32342
20180119	7호선	중계	17146	15195	20180122	32341
20180123	분당선	선릉	10467	21870	20180126	32337
20180203	안산선	중앙	15568	16765	20180206	32333
20180129	5호선	우장산	16114	16215	20180201	32329
20180127	경원선	왕십리(성동구청)	14879	17450	20180130	32329
20180126	7호선	사가정	16166	16160	20180129	32326
20180208	7호선	신중동	16249	16058	20180211	32307
20180126	5호선	발산	16181	16123	20180129	32304
20180204	4호선	노원	15647	16655	20180207	32302
20180112	4호선	숙대입구(갈월)	16182	16111	20180115	32293
20180125	5호선	답십리	16885	15407	20180128	32292
20180118	4호선	한성대입구(삼선교)	16573	15717	20180121	32290
20180201	분당선	선릉	10455	21831	20180204	32286
20180124	안산선	중앙	15614	16670	20180127	32284
20180124	5호선	답십리	16693	15573	20180127	32266
20180126	1호선	신설동	16472	15793	20180129	32265
20180206	경부선	대방	16055	16208	20180209	32263
20180207	8호선	잠실(송파구청)	14985	17277	20180210	32262
20180115	5호선	공덕	15535	16725	20180118	32260
20180206	분당선	죽전	14999	17260	20180209	32259
20180112	분당선	수내	16059	16200	20180115	32259
20180124	4호선	신용산	15739	16504	20180127	32243
20180124	경원선	왕십리(성동구청)	15055	17184	20180127	32239
20180122	5호선	종로3가	16576	15660	20180125	32236
20180126	분당선	수서	15777	16449	20180129	32226
20180204	2호선	서초	16480	15742	20180207	32222
20180120	5호선	강동	17490	14730	20180123	32220
20180122	7호선	중계	16630	15588	20180125	32218
20180129	7호선	건대입구	15723	16491	20180201	32214
20180206	8호선	잠실(송파구청)	14922	17284	20180209	32206
20180118	7호선	중계	16821	15382	20180121	32203
20180115	8호선	잠실(송파구청)	14861	17325	20180118	32186
20180207	분당선	선릉	10206	21979	20180210	32185
20180211	5호선	화곡	16531	15651	20180214	32182
20180112	6호선	디지털미디어시티	15338	16841	20180115	32179
20180122	5호선	공덕	15538	16636	20180125	32174
20180120	7호선	하계	16550	15621	20180123	32171
20180206	안산선	중앙	15619	16542	20180209	32161
20180117	7호선	상동	15799	16362	20180120	32161
20180128	5호선	화곡	16435	15720	20180131	32155
20180124	5호선	발산	16156	15993	20180127	32149
20180126	7호선	내방	15837	16308	20180129	32145
20180117	과천선	정부과천청사	16374	15769	20180120	32143
20180126	분당선	한티	15645	16491	20180129	32136
20180205	2호선	신당	15747	16381	20180208	32128
20180131	과천선	정부과천청사	16213	15911	20180203	32124
20180119	경부선	병점	16439	15685	20180122	32124
20180124	7호선	건대입구	15750	16371	20180127	32121
20180123	분당선	한티	15480	16636	20180126	32116
20180115	5호선	종로3가	16312	15788	20180118	32100
20180207	5호선	종로3가	16634	15456	20180210	32090
20180131	안산선	안산	16804	15286	20180203	32090
20180205	분당선	한티	15412	16675	20180208	32087
20180206	경인선	동인천	16458	15625	20180209	32083
20180126	분당선	죽전	15002	17070	20180129	32072
20180125	8호선	잠실(송파구청)	14955	17109	20180128	32064
20180206	4호선	한성대입구(삼선교)	16326	15736	20180209	32062
20180124	1호선	제기동	16115	15936	20180127	32051
20180130	경원선	청량리(서울시립대입구)	15530	16514	20180202	32044
20180119	3호선	약수	16293	15746	20180122	32039
20180123	1호선	신설동	16014	16013	20180126	32027
20180125	분당선	한티	15396	16615	20180128	32011
20180125	5호선	발산	16169	15841	20180128	32010
20180201	5호선	종로3가	16453	15552	20180204	32005
20180129	경부선	대방	15912	16074	20180201	31986
20180212	안산선	안산	16657	15328	20180215	31985
20180120	2호선	성수	15390	16588	20180123	31978
20180112	5호선	우장산	16188	15790	20180115	31978
20180201	4호선	한성대입구(삼선교)	16408	15559	20180204	31967
20180205	분당선	선릉	10296	21663	20180208	31959
20180130	6호선	망원	15249	16708	20180202	31957
20180123	5호선	공덕	15462	16492	20180126	31954
20180113	9호선	가양	16369	15584	20180116	31953
20180207	6호선	망원	15277	16670	20180210	31947
20180131	7호선	신중동	16060	15886	20180203	31946
20180201	경원선	청량리(서울시립대입구)	15248	16688	20180204	31936
20180129	분당선	압구정로데오	15164	16743	20180201	31907
20180130	7호선	상동	15691	16211	20180202	31902
20180208	3호선	약수	16166	15731	20180211	31897
20180208	분당선	수서	15748	16128	20180211	31876
20180122	8호선	잠실(송파구청)	14961	16911	20180125	31872
20180123	7호선	면목	16107	15763	20180126	31870
20180120	7호선	상봉(시외버스터미널)	16268	15602	20180123	31870
20180125	5호선	우장산	15910	15955	20180128	31865
20180123	분당선	수내	15782	16075	20180126	31857
20180123	8호선	잠실(송파구청)	14885	16969	20180126	31854
20180126	6호선	디지털미디어시티	15022	16825	20180129	31847
20180204	5호선	화곡	16369	15475	20180207	31844
20180203	8호선	잠실(송파구청)	14918	16925	20180206	31843
20180118	7호선	상동	15554	16287	20180121	31841
20180203	안산선	산본	15381	16457	20180206	31838
20180119	공항철도 1호선	인천공항1터미널	16802	15032	20180122	31834
20180129	분당선	선릉	10168	21662	20180201	31830
20180212	7호선	신중동	16020	15804	20180215	31824
20180201	6호선	망원	15191	16622	20180204	31813
20180211	9호선	신논현	16283	15522	20180214	31805
20180128	1호선	시청	16033	15770	20180131	31803
20180204	6호선	이태원	17290	14496	20180207	31786
20180131	7호선	상동	15598	16182	20180203	31780
20180128	6호선	이태원	17082	14685	20180131	31767
20180203	7호선	학동	15414	16341	20180206	31755
20180208	7호선	상동	15582	16170	20180211	31752
20180112	경원선	청량리(서울시립대입구)	14892	16860	20180115	31752
20180206	분당선	수내	15696	16040	20180209	31736
20180121	9호선	신논현	16177	15557	20180124	31734
20180201	5호선	아차산(어린이대공원후문)	16326	15397	20180204	31723
20180206	분당선	선릉	10122	21600	20180209	31722
20180122	4호선	숙대입구(갈월)	15950	15771	20180125	31721
20180212	5호선	종로3가	16493	15220	20180215	31713
20180129	2호선	신당	15501	16197	20180201	31698
20180112	5호선	공덕	15118	16572	20180115	31690
20180121	4호선	동대문역사문화공원	16489	15197	20180124	31686
20180117	7호선	신중동	15918	15761	20180120	31679
20180208	5호선	아차산(어린이대공원후문)	16320	15351	20180211	31671
20180125	경부선	대방	15818	15853	20180128	31671
20180114	4호선	동대문역사문화공원	16484	15187	20180117	31671
20180207	경부선	성균관대	16052	15618	20180210	31670
20180125	안산선	중앙	15432	16233	20180128	31665
20180114	경인선	개봉	16186	15476	20180117	31662
20180131	5호선	종로3가	16266	15395	20180203	31661
20180211	2호선	잠실새내	15430	16227	20180214	31657
20180121	안산선	안산	16404	15243	20180124	31647
20180208	6호선	이태원	14834	16810	20180211	31644
20180117	6호선	망원	15132	16508	20180120	31640
20180118	안산선	안산	16460	15173	20180121	31633
20180201	9호선	고속터미널	12440	19172	20180204	31612
20180125	6호선	디지털미디어시티	14621	16983	20180128	31604
20180129	분당선	한티	15380	16222	20180201	31602
20180121	2호선	잠실새내	15565	16033	20180124	31598
20180129	경인선	동인천	16231	15366	20180201	31597
20180124	5호선	우장산	15686	15910	20180127	31596
20180126	5호선	우장산	15827	15751	20180129	31578
20180212	경부선	성균관대	16125	15449	20180215	31574
20180125	7호선	사가정	15818	15744	20180128	31562
20180118	9호선	고속터미널	12551	19003	20180121	31554
20180117	경부선	성균관대	16074	15469	20180120	31543
20180212	4호선	한성대입구(삼선교)	16021	15518	20180215	31539
20180124	6호선	디지털미디어시티	14593	16941	20180127	31534
20180117	6호선	이태원	15418	16097	20180120	31515
20180129	8호선	잠실(송파구청)	14701	16810	20180201	31511
20180126	경인선	동인천	16102	15400	20180129	31502
20180131	6호선	망원	15167	16333	20180203	31500
20180117	1호선	동대문	15313	16176	20180120	31489
20180113	7호선	상봉(시외버스터미널)	15978	15499	20180116	31477
20180128	2호선	잠실새내	15387	16087	20180131	31474
20180129	4호선	숙대입구(갈월)	15673	15796	20180201	31469
20180113	5호선	종로3가	15691	15778	20180116	31469
20180212	7호선	상동	15387	16072	20180215	31459
20180208	경부선	성균관대	16114	15329	20180211	31443
20180207	9호선	고속터미널	12361	19078	20180210	31439
20180127	안산선	상록수	16059	15374	20180130	31433
20180123	2호선	신당	15286	16146	20180126	31432
20180126	5호선	공덕	15057	16359	20180129	31416
20180126	분당선	수내	15726	15689	20180129	31415
20180126	4호선	숙대입구(갈월)	15803	15608	20180129	31411
20180112	안산선	안산	16598	14807	20180115	31405
20180127	1호선	시청	15935	15469	20180130	31404
20180118	6호선	망원	15004	16398	20180121	31402
20180205	4호선	한성대입구(삼선교)	16012	15385	20180208	31397
20180130	7호선	신중동	15705	15689	20180202	31394
20180207	3호선	약수	15867	15524	20180210	31391
20180125	경인선	동인천	16102	15283	20180128	31385
20180122	4호선	한성대입구(삼선교)	16001	15381	20180125	31382
20180118	7호선	신중동	15809	15572	20180121	31381
20180203	7호선	하계	16234	15129	20180206	31363
20180208	2호선	을지로4가	15641	15720	20180211	31361
20180127	7호선	건대입구	15044	16317	20180130	31361
20180113	8호선	잠실(송파구청)	14659	16696	20180116	31355
20180201	안산선	안산	16407	14947	20180204	31354
20180208	6호선	합정	16616	14737	20180211	31353
20180121	경인선	주안	16637	14714	20180124	31351
20180130	9호선	고속터미널	12279	19066	20180202	31345
20180201	7호선	상동	15324	16017	20180204	31341
20180121	2호선	역삼	15415	15918	20180124	31333
20180130	경부선	성균관대	15765	15566	20180202	31331
20180125	4호선	숙대입구(갈월)	15660	15666	20180128	31326
20180114	4호선	성신여대입구(돈암)	15910	15416	20180117	31326
20180113	3호선	홍제	15877	15447	20180116	31324
20180115	경부선	성균관대	15904	15416	20180118	31320
20180118	6호선	합정	16722	14596	20180121	31318
20180118	1호선	동대문	15163	16147	20180121	31310
20180117	6호선	합정	16575	14733	20180120	31308
20180130	2호선	상왕십리	15798	15505	20180202	31303
20180131	6호선	합정	16515	14780	20180203	31295
20180201	9호선2단계	봉은사	15744	15547	20180204	31291
20180204	2호선	역삼	15463	15821	20180207	31284
20180201	7호선	신중동	15735	15544	20180204	31279
20180123	경인선	동인천	16016	15260	20180126	31276
20180204	5호선	광화문(세종문화회관)	15712	15560	20180207	31272
20180120	경부선	노량진	16680	14588	20180123	31268
20180125	1호선	신설동	15794	15472	20180128	31266
20180207	7호선	신중동	15774	15473	20180210	31247
20180130	3호선	약수	15666	15573	20180202	31239
20180201	6호선	이태원	14760	16476	20180204	31236
20180114	9호선	신논현	15960	15273	20180117	31233
20180125	7호선	면목	15853	15379	20180128	31232
20180205	일산선	삼송	15773	15457	20180208	31230
20180124	분당선	한티	15074	16153	20180127	31227
20180125	분당선	선릉	10018	21207	20180128	31225
20180207	5호선	아차산(어린이대공원후문)	15998	15226	20180210	31224
20180120	8호선	잠실(송파구청)	14608	16616	20180123	31224
20180115	4호선	한성대입구(삼선교)	15990	15226	20180118	31216
20180203	3호선	홍제	15736	15471	20180206	31207
20180212	6호선	망원	15073	16121	20180215	31194
20180206	일산선	삼송	15775	15416	20180209	31191
20180114	2호선	선릉	16951	14239	20180117	31190
20180212	분당선	수서	15241	15946	20180215	31187
20180113	5호선	강동	16638	14544	20180116	31182
20180203	공항철도 1호선	인천공항1터미널	16211	14969	20180206	31180
20180127	3호선	불광	14714	16466	20180130	31180
20180115	9호선	고속터미널	12678	18494	20180118	31172
20180112	2호선	신당	15251	15917	20180115	31168
20180124	7호선	중계	16078	15089	20180127	31167
20180114	경인선	주안	16423	14743	20180117	31166
20180120	경부선	평택	16463	14701	20180123	31164
20180113	1호선	동대문	14848	16312	20180116	31160
20180130	6호선	합정	16729	14428	20180202	31157
20180129	5호선	공덕	14970	16187	20180201	31157
20180203	분당선	압구정로데오	14706	16443	20180206	31149
20180125	분당선	수내	15418	15731	20180128	31149
20180126	분당선	선릉	10000	21136	20180129	31136
20180207	과천선	정부과천청사	15873	15257	20180210	31130
20180121	5호선	천호(풍납토성)	15669	15452	20180124	31121
20180112	7호선	상동	15149	15971	20180115	31120
20180113	7호선	하계	15986	15133	20180116	31119
20180119	분당선	오리	17198	13918	20180122	31116
20180114	안산선	안산	16112	14987	20180117	31099
20180117	분당선	태평	15777	15315	20180120	31092
20180128	9호선	신논현	15934	15155	20180131	31089
20180131	9호선	고속터미널	12306	18772	20180203	31078
20180130	5호선	종로3가	16234	14842	20180202	31076
20180118	3호선	약수	15871	15203	20180121	31074
20180129	분당선	수내	15397	15666	20180201	31063
20180117	9호선	고속터미널	12397	18666	20180120	31063
20180117	3호선	약수	15756	15302	20180120	31058
20180131	경부선	성균관대	15918	15134	20180203	31052
20180119	경부선	노량진	16280	14768	20180122	31048
20180119	5호선	아차산(어린이대공원후문)	15907	15138	20180122	31045
20180207	7호선	상동	15244	15790	20180210	31034
20180205	8호선	잠실(송파구청)	14446	16577	20180208	31023
20180125	5호선	공덕	14978	16037	20180128	31015
20180118	경부선	성균관대	15810	15200	20180121	31010
20180119	중앙선	구리	15015	15988	20180122	31003
20180112	분당선	선릉	10004	20995	20180115	30999
20180130	5호선	아차산(어린이대공원후문)	15641	15351	20180202	30992
20180126	7호선	면목	15925	15066	20180129	30991
20180123	4호선	숙대입구(갈월)	15493	15496	20180126	30989
20180205	분당선	수내	15339	15649	20180208	30988
20180124	5호선	공덕	15036	15947	20180127	30983
20180114	2호선	서초	15800	15179	20180117	30979
20180124	1호선	신설동	15708	15263	20180127	30971
20180201	2호선	상왕십리	15839	15129	20180204	30968
20180121	3호선	경복궁(정부서울청사)	14754	16206	20180124	30960
20180208	분당선	태평	15796	15160	20180211	30956
20180124	경인선	동인천	15684	15272	20180127	30956
20180203	5호선	종로3가	15977	14976	20180206	30953
20180206	6호선	망원	14820	16129	20180209	30949
20180118	분당선	수서	15445	15497	20180121	30942
20180128	4호선	성신여대입구(돈암)	15698	15243	20180131	30941
20180112	7호선	면목	15841	15095	20180115	30936
20180204	4호선	성신여대입구(돈암)	15662	15255	20180207	30917
20180113	2호선	성수	14880	16035	20180116	30915
20180208	2호선	상왕십리	15645	15257	20180211	30902
20180126	2호선	신당	15149	15753	20180129	30902
20180123	일산선	삼송	15710	15191	20180126	30901
20180126	경부선	대방	15431	15467	20180129	30898
20180127	2호선	당산	14523	16374	20180130	30897
20180131	1호선	동대문	14952	15942	20180203	30894
20180124	경부선	대방	15387	15501	20180127	30888
20180127	안산선	중앙	14763	16120	20180130	30883
20180115	7호선	신중동	15568	15312	20180118	30880
20180203	2호선	서초	15984	14891	20180206	30875
20180131	5호선	아차산(어린이대공원후문)	15842	15032	20180203	30874
20180130	안산선	안산	16291	14569	20180202	30860
20180201	6호선	합정	16385	14474	20180204	30859
20180121	경인선	개봉	15400	15453	20180124	30853
20180122	9호선	고속터미널	12321	18531	20180125	30852
20180124	분당선	선릉	10010	20838	20180127	30848
20180207	분당선	수서	15363	15483	20180210	30846
20180117	5호선	아차산(어린이대공원후문)	15781	15062	20180120	30843
20180127	경인선	동암	15337	15505	20180130	30842
20180112	5호선	종로3가	15585	15242	20180115	30827
20180124	7호선	사가정	15330	15496	20180127	30826
20180123	안산선	안산	15952	14859	20180126	30811
20180211	4호선	동대문역사문화공원	16066	14741	20180214	30807
20180122	분당선	태평	15603	15204	20180125	30807
20180115	1호선	동대문	14845	15962	20180118	30807
20180126	경원선	청량리(서울시립대입구)	14604	16200	20180129	30804
20180131	2호선	상왕십리	15683	15116	20180203	30799
20180124	분당선	죽전	14251	16547	20180127	30798
20180112	7호선	신중동	15487	15309	20180115	30796
20180201	3호선	약수	15627	15164	20180204	30791
20180123	7호선	상동	15063	15727	20180126	30790
20180117	2호선	상왕십리	15762	15021	20180120	30783
20180212	분당선	태평	15585	15195	20180215	30780
20180122	경부선	성균관대	15635	15141	20180125	30776
20180131	분당선	태평	15723	15052	20180203	30775
20180122	7호선	신중동	15514	15248	20180125	30762
20180124	7호선	면목	15515	15232	20180127	30747
20180129	일산선	삼송	15577	15164	20180201	30741
20180131	공항철도 1호선	인천공항1터미널	15709	15014	20180203	30723
20180121	7호선	고속터미널	17608	13114	20180124	30722
20180131	3호선	약수	15637	15079	20180203	30716
20180211	2호선	서초	15715	14992	20180214	30707
20180119	2호선	상왕십리	15816	14884	20180122	30700
20180129	안산선	안산	15995	14698	20180201	30693
20180201	1호선	동대문	14799	15889	20180204	30688
20180204	9호선	신논현	15829	14857	20180207	30686
20180126	공항철도 1호선	인천공항1터미널	16396	14290	20180129	30686
20180115	7호선	상동	15009	15671	20180118	30680
20180113	분당선	압구정로데오	14411	16269	20180116	30680
20180122	7호선	상동	15114	15561	20180125	30675
20180120	분당선	압구정로데오	14290	16380	20180123	30670
20180119	분당선	망포	16346	14322	20180122	30668
20180112	경부선	성균관대	15745	14922	20180115	30667
20180201	분당선	수서	15279	15385	20180204	30664
20180114	5호선	천호(풍납토성)	15399	15263	20180117	30662
20180120	8호선	장지	15588	15061	20180123	30649
20180122	5호선	광나루(장신대)	16087	14561	20180125	30648
20180123	4호선	한성대입구(삼선교)	15567	15079	20180126	30646
20180121	4호선	성신여대입구(돈암)	15478	15167	20180124	30645
20180122	분당선	수서	15188	15450	20180125	30638
20180123	7호선	중계	16016	14620	20180126	30636
20180203	7호선	상봉(시외버스터미널)	15737	14898	20180206	30635
20180117	분당선	수서	15020	15599	20180120	30619
20180115	분당선	태평	15712	14907	20180118	30619
20180120	7호선	이수	15444	15172	20180123	30616
20180205	공항철도 1호선	인천공항1터미널	14820	15793	20180208	30613
20180208	9호선2단계	봉은사	15332	15258	20180211	30590
20180201	경부선	성균관대	15696	14893	20180204	30589
20180208	안산선	안산	15895	14690	20180211	30585
20180126	4호선	한성대입구(삼선교)	15674	14911	20180129	30585
20180127	2호선	왕십리(성동구청)	16346	14233	20180130	30579
20180120	안산선	안산	15599	14965	20180123	30564
20180204	2호선	잠실새내	15078	15472	20180207	30550
20180206	5호선	아차산(어린이대공원후문)	15668	14880	20180209	30548
20180211	4호선	성신여대입구(돈암)	15555	14986	20180214	30541
20180121	경원선	청량리(서울시립대입구)	15431	15107	20180124	30538
20180125	분당선	죽전	14148	16389	20180128	30537
20180125	4호선	한성대입구(삼선교)	15587	14935	20180128	30522
20180125	7호선	중계	15829	14693	20180128	30522
20180124	분당선	수내	15182	15337	20180127	30519
20180130	6호선	마포구청	15969	14546	20180202	30515
20180130	1호선	동대문	14646	15862	20180202	30508
20180207	6호선	합정	16347	14160	20180210	30507
20180115	3호선	약수	15509	14993	20180118	30502
20180201	공항철도 1호선	인천공항1터미널	16302	14194	20180204	30496
20180206	3호선	약수	15487	15007	20180209	30494
20180203	2호선	성수	14792	15700	20180206	30492
20180127	2호선	이대	14836	15656	20180130	30492
20180205	안산선	안산	15804	14683	20180208	30487
20180126	9호선2단계	봉은사	15564	14921	20180129	30485
20180208	1호선	동대문	14812	15666	20180211	30478
20180206	7호선	상동	14928	15546	20180209	30474
20180118	9호선2단계	봉은사	15402	15069	20180121	30471
20180124	8호선	잠실(송파구청)	14258	16211	20180127	30469
20180212	분당선	오리	16687	13780	20180215	30467
20180130	분당선	수서	14862	15598	20180202	30460
20180112	일산선	삼송	15593	14857	20180115	30450
20180114	7호선	고속터미널	17422	13026	20180117	30448
20180113	8호선	장지	15422	15016	20180116	30438
20180212	공항철도 1호선	인천공항1터미널	15016	15415	20180215	30431
20180112	6호선	합정	15855	14576	20180115	30431
20180120	7호선	논현	14478	15940	20180123	30418
20180118	2호선	상왕십리	15475	14931	20180121	30406
20180127	8호선	잠실(송파구청)	14312	16083	20180130	30395
20180203	5호선	강동	16315	14078	20180206	30393
20180206	7호선	신중동	15281	15108	20180209	30389
20180128	4호선	동대문역사문화공원	15782	14584	20180131	30366
20180212	3호선	약수	15386	14976	20180215	30362
20180130	9호선2단계	봉은사	15808	14553	20180202	30361
20180118	공항철도 1호선	인천공항1터미널	16201	14158	20180121	30359
20180207	분당선	태평	15457	14896	20180210	30353
20180125	2호선	신당	14767	15580	20180128	30347
20180121	5호선	오목교(목동운동장앞)	14759	15588	20180124	30347
20180112	4호선	한성대입구(삼선교)	15592	14753	20180115	30345
20180206	6호선	마포구청	15780	14558	20180209	30338
20180203	8호선	장지	15394	14943	20180206	30337
20180119	3호선	교대(법원.검찰청)	18140	12196	20180122	30336
20180206	9호선	고속터미널	11984	18335	20180209	30319
20180205	5호선	종로3가	15802	14504	20180208	30306
20180203	1호선	동대문	14394	15912	20180206	30306
20180130	분당선	태평	15237	15057	20180202	30294
20180212	6호선	합정	15968	14324	20180215	30292
20180115	6호선	망원	14522	15770	20180118	30292
20180207	2호선	상왕십리	15391	14900	20180210	30291
20180205	3호선	약수	15351	14937	20180208	30288
20180126	7호선	상동	14878	15405	20180129	30283
20180120	7호선	청담	14607	15673	20180123	30280
20180207	안산선	안산	15961	14318	20180210	30279
20180118	분당선	태평	15443	14803	20180121	30246
20180113	7호선	상동	14853	15386	20180116	30239
20180201	분당선	태평	15360	14878	20180204	30238
20180113	경부선	노량진	16000	14233	20180116	30233
20180118	5호선	아차산(어린이대공원후문)	15460	14772	20180121	30232
20180205	7호선	신중동	15187	15044	20180208	30231
20180130	공항철도 1호선	인천공항1터미널	15309	14905	20180202	30214
20180120	4호선	서울역	9379	20823	20180123	30202
20180120	공항철도 1호선	인천공항1터미널	15746	14455	20180123	30201
20180128	경인선	주안	15911	14285	20180131	30196
20180208	5호선	광나루(장신대)	15863	14321	20180211	30184
20180126	6호선	합정	15740	14444	20180129	30184
20180122	6호선	망원	14492	15671	20180125	30163
20180130	2호선	을지로4가	15592	14559	20180202	30151
20180208	분당선	오리	16496	13642	20180211	30138
20180120	3호선	수서	15450	14677	20180123	30127
20180112	분당선	태평	15393	14723	20180115	30116
20180127	일산선	화정	14673	15440	20180130	30113
20180201	2호선	을지로4가	15237	14870	20180204	30107
20180131	분당선	오리	16519	13588	20180203	30107
20180205	경부선	성균관대	15262	14819	20180208	30081
20180118	과천선	정부과천청사	15337	14743	20180121	30080
20180114	2호선	교대(법원.검찰청)	14270	15805	20180117	30075
20180129	9호선	고속터미널	11883	18186	20180201	30069
20180122	5호선	아차산(어린이대공원후문)	15211	14848	20180125	30059
20180117	9호선2단계	봉은사	15183	14876	20180120	30059
20180131	분당선	수서	15021	15035	20180203	30056
20180205	9호선	고속터미널	11955	18097	20180208	30052
20180127	4호선	상계	15812	14229	20180130	30041
20180203	7호선	청담	14440	15591	20180206	30031
20180124	7호선	상동	14772	15254	20180127	30026
20180115	6호선	이태원	14701	15307	20180118	30008
20180114	5호선	오목교(목동운동장앞)	14642	15365	20180117	30007
20180123	7호선	신중동	15171	14824	20180126	29995
20180124	4호선	숙대입구(갈월)	15080	14913	20180127	29993
20180127	분당선	미금	14729	15262	20180130	29991
20180115	분당선	수서	14861	15124	20180118	29985
20180212	2호선	상왕십리	15303	14677	20180215	29980
20180125	7호선	상동	14787	15193	20180128	29980
20180127	안산선	산본	14479	15486	20180130	29965
20180211	2호선	역삼	14659	15304	20180214	29963
20180211	공항철도 1호선	인천공항1터미널	15134	14829	20180214	29963
20180121	2호선	선릉	16305	13651	20180124	29956
20180131	2호선	을지로4가	14972	14983	20180203	29955
20180203	3호선	수서	15286	14667	20180206	29953
20180117	3호선	교대(법원.검찰청)	17837	12111	20180120	29948
20180115	2호선	상왕십리	15164	14774	20180118	29938
20180205	6호선	망원	14363	15573	20180208	29936
20180117	분당선	오리	16522	13412	20180120	29934
20180124	2호선	신당	14569	15351	20180127	29920
20180212	1호선	동대문	14400	15508	20180215	29908
20180113	7호선	이수	15021	14882	20180116	29903
20180131	6호선	이태원	14513	15385	20180203	29898
20180120	6호선	응암	15042	14856	20180123	29898
20180208	8호선	남한산성입구(성남법원.검찰청)	15604	14291	20180211	29895
20180212	2호선	을지로4가	15071	14823	20180215	29894
20180119	8호선	남한산성입구(성남법원.검찰청)	16044	13848	20180122	29892
20180129	분당선	수서	14806	15082	20180201	29888
20180127	9호선	가양	15234	14636	20180130	29870
20180130	6호선	이태원	14550	15316	20180202	29866
20180115	6호선	합정	15775	14089	20180118	29864
20180131	5호선	신정(은행정)	16694	13169	20180203	29863
20180114	2호선	역삼	14728	15133	20180117	29861
20180207	공항철도 1호선	인천공항1터미널	15147	14705	20180210	29852
20180122	1호선	동대문	14233	15612	20180125	29845
20180204	5호선	오목교(목동운동장앞)	14593	15243	20180207	29836
20180205	7호선	상동	14620	15210	20180208	29830
20180207	1호선	동대문	14409	15416	20180210	29825
20180130	6호선	석계	14335	15489	20180202	29824
20180122	3호선	약수	15108	14715	20180125	29823
20180119	7호선	숭실대입구(살피재)	15164	14649	20180122	29813
20180129	7호선	신중동	15043	14761	20180201	29804
20180131	중앙선	구리	14617	15185	20180203	29802
20180127	3호선	구파발	15324	14470	20180130	29794
20180122	공항철도 1호선	인천공항1터미널	14730	15057	20180125	29787
20180119	7호선	수락산	15215	14570	20180122	29785
20180208	공항철도 1호선	인천공항1터미널	15483	14301	20180211	29784
20180119	2호선	을지로4가	15005	14773	20180122	29778
20180212	과천선	정부과천청사	15233	14536	20180215	29769
20180128	7호선	고속터미널	16939	12825	20180131	29764
20180121	과천선	인덕원	14984	14776	20180124	29760
20180125	9호선2단계	봉은사	15130	14628	20180128	29758
20180208	6호선	마포구청	15656	14091	20180211	29747
20180126	7호선	신중동	14897	14849	20180129	29746
20180118	3호선	교대(법원.검찰청)	17821	11923	20180121	29744
20180203	경인선	동인천	15516	14225	20180206	29741
20180206	안산선	안산	15525	14213	20180209	29738
20180211	5호선	오목교(목동운동장앞)	14504	15231	20180214	29735
20180205	5호선	아차산(어린이대공원후문)	15281	14453	20180208	29734
20180212	6호선	마포구청	15602	14126	20180215	29728
20180207	2호선	을지로4가	15072	14649	20180210	29721
20180127	3호선	홍제	15284	14432	20180130	29716
20180117	5호선	광나루(장신대)	15806	13909	20180120	29715
20180123	9호선	고속터미널	11677	18034	20180126	29711
20180206	5호선	종로3가	15285	14415	20180209	29700
20180205	분당선	수서	14671	15009	20180208	29680
20180118	분당선	오리	16298	13381	20180121	29679
20180208	경부선	병점	14831	14834	20180211	29665
20180129	4호선	한성대입구(삼선교)	15007	14658	20180201	29665
20180113	안산선	안산	15130	14530	20180116	29660
20180126	안산선	안산	15713	13944	20180129	29657
20180122	2호선	상왕십리	15033	14614	20180125	29647
20180126	7호선	중계	15678	13965	20180129	29643
20180129	7호선	상동	14536	15099	20180201	29635
20180124	과천선	정부과천청사	15112	14517	20180127	29629
20180212	5호선	아차산(어린이대공원후문)	15110	14518	20180215	29628
20180113	4호선	서울역	9351	20276	20180116	29627
20180206	공항철도 1호선	인천공항1터미널	14988	14638	20180209	29626
20180130	5호선	신정(은행정)	16158	13456	20180202	29614
20180208	5호선	신정(은행정)	16519	13086	20180211	29605
20180125	일산선	삼송	15010	14593	20180128	29603
20180206	6호선	합정	15636	13963	20180209	29599
20180123	5호선	종로3가	15334	14262	20180126	29596
20180129	공항철도 1호선	인천공항1터미널	14537	15054	20180201	29591
20180123	분당선	태평	15124	14467	20180126	29591
20180201	5호선	신정(은행정)	16491	13099	20180204	29590
20180112	3호선	약수	15168	14420	20180115	29588
20180117	5호선	신정(은행정)	16616	12960	20180120	29576
20180206	2호선	상왕십리	15028	14547	20180209	29575
20180114	9호선	고속터미널	10445	19130	20180117	29575
20180113	경부선	평택	15382	14190	20180116	29572
20180131	6호선	마포구청	15515	14056	20180203	29571
20180212	6호선	이태원	14508	15051	20180215	29559
20180204	공항철도 1호선	인천공항1터미널	14227	15332	20180207	29559
20180119	6호선	마포구청	15615	13944	20180122	29559
20180118	5호선	광나루(장신대)	15587	13969	20180121	29556
20180206	분당선	태평	15056	14496	20180209	29552
20180129	분당선	태평	15050	14491	20180201	29541
20180117	6호선	마포구청	15569	13969	20180120	29538
20180130	7호선	수락산	14705	14832	20180202	29537
20180124	4호선	한성대입구(삼선교)	14876	14660	20180127	29536
20180117	중앙선	구리	14396	15137	20180120	29533
20180112	경부선	병점	15039	14493	20180115	29532
20180203	4호선	서울역	9525	20001	20180206	29526
20180130	중앙선	구리	14088	15435	20180202	29523
20180128	2호선	역삼	14472	15045	20180131	29517
20180205	2호선	상왕십리	14980	14530	20180208	29510
20180112	7호선	숭실대입구(살피재)	14957	14549	20180115	29506
20180114	경원선	청량리(서울시립대입구)	14710	14793	20180117	29503
20180117	2호선	을지로4가	15006	14493	20180120	29499
20180112	7호선	중계	15646	13852	20180115	29498
20180130	7호선	숭실대입구(살피재)	14727	14769	20180202	29496
20180207	6호선	이태원	14257	15235	20180210	29492
20180121	2호선	교대(법원.검찰청)	14131	15360	20180124	29491
20180125	분당선	수서	14647	14840	20180128	29487
20180201	6호선	마포구청	15447	14034	20180204	29481
20180203	6호선	응암	14820	14657	20180206	29477
20180126	일산선	삼송	15009	14466	20180129	29475
20180211	5호선	천호(풍납토성)	14831	14643	20180214	29474
20180123	6호선	망원	14114	15341	20180126	29455
20180119	5호선	신정(은행정)	16665	12782	20180122	29447
20180113	3호선	수서	15122	14322	20180116	29444
20180131	5호선	광나루(장신대)	15636	13803	20180203	29439
20180207	경원선	청량리(서울시립대입구)	14113	15324	20180210	29437
20180206	경부선	성균관대	14947	14488	20180209	29435
20180123	분당선	수서	14654	14780	20180126	29434
20180125	9호선	고속터미널	11451	17968	20180128	29419
20180112	9호선2단계	봉은사	14972	14425	20180115	29397
20180120	7호선	학동	14210	15183	20180123	29393
20180118	6호선	마포구청	15351	14011	20180121	29362
20180206	분당선	수서	14491	14870	20180209	29361
20180204	경인선	개봉	14455	14906	20180207	29361
20180204	경인선	주안	15484	13874	20180207	29358
20180128	5호선	오목교(목동운동장앞)	14408	14939	20180131	29347
20180212	경부선	병점	14601	14740	20180215	29341
20180129	경부선	성균관대	14894	14445	20180201	29339
20180115	5호선	아차산(어린이대공원후문)	14831	14498	20180118	29329
20180204	7호선	고속터미널	16440	12886	20180207	29326
20180130	5호선	광나루(장신대)	15400	13924	20180202	29324
20180203	2호선	영등포구청	14336	14972	20180206	29308
20180123	6호선	합정	15439	13860	20180126	29299
20180203	7호선	이수	14822	14467	20180206	29289
20180123	경부선	성균관대	14910	14374	20180126	29284
20180129	6호선	망원	14090	15185	20180201	29275
20180211	경인선	개봉	14548	14723	20180214	29271
20180131	7호선	수락산	14849	14420	20180203	29269
20180120	2호선	영등포구청	14473	14788	20180123	29261
20180207	6호선	마포구청	15350	13908	20180210	29258
20180114	3호선	경복궁(정부서울청사)	13784	15471	20180117	29255
20180203	7호선	논현	13714	15540	20180206	29254
20180128	5호선	천호(풍납토성)	14759	14494	20180131	29253
20180119	6호선	석계	14626	14627	20180122	29253
20180123	경원선	청량리(서울시립대입구)	13992	15260	20180126	29252
20180115	2호선	을지로4가	14880	14366	20180118	29246
20180130	분당선	오리	15925	13320	20180202	29245
20180131	6호선	석계	14578	14665	20180203	29243
20180117	경부선	병점	14727	14510	20180120	29237
20180201	분당선	오리	15990	13245	20180204	29235
20180121	1호선	제기동	14388	14847	20180124	29235
20180130	공항철도 1호선	디지털미디어시티	16294	12939	20180202	29233
20180122	분당선	오리	16081	13152	20180125	29233
20180125	7호선	신중동	14814	14417	20180128	29231
20180115	일산선	대화	16637	12589	20180118	29226
20180208	중앙선	구리	14318	14900	20180211	29218
20180118	8호선	남한산성입구(성남법원.검찰청)	15340	13874	20180121	29214
20180114	과천선	인덕원	14804	14403	20180117	29207
20180120	7호선	상동	14481	14725	20180123	29206
20180203	7호선	상동	14365	14839	20180206	29204
20180201	공항철도 1호선	디지털미디어시티	15569	13629	20180204	29198
20180205	분당선	태평	14834	14362	20180208	29196
20180205	1호선	동대문	14152	15043	20180208	29195
20180118	중앙선	구리	14278	14911	20180121	29189
20180207	5호선	신정(은행정)	16203	12983	20180210	29186
20180114	1호선	동대문	13199	15986	20180117	29185
20180119	6호선	새절(신사)	15093	14091	20180122	29184
20180129	5호선	종로3가	14921	14250	20180201	29171
20180127	공항철도 1호선	인천공항1터미널	15241	13927	20180130	29168
20180117	8호선	남한산성입구(성남법원.검찰청)	15333	13827	20180120	29160
20180117	경부선	노량진	15200	13956	20180120	29156
20180122	6호선	마포구청	15340	13808	20180125	29148
20180204	2호선	선릉	15840	13304	20180207	29144
20180207	분당선	오리	16047	13091	20180210	29138
20180118	경부선	노량진	15149	13987	20180121	29136
20180129	경원선	청량리(서울시립대입구)	13966	15166	20180201	29132
20180126	분당선	태평	14910	14210	20180129	29120
20180122	중앙선	구리	14210	14910	20180125	29120
20180115	분당선	오리	15960	13154	20180118	29114
20180112	2호선	상왕십리	14956	14146	20180115	29102
20180115	7호선	숭실대입구(살피재)	14600	14497	20180118	29097
20180120	5호선	발산	14244	14852	20180123	29096
20180204	5호선	천호(풍납토성)	14663	14431	20180207	29094
20180207	5호선	광나루(장신대)	15405	13686	20180210	29091
20180123	2호선	상왕십리	14731	14359	20180126	29090
20180120	분당선	죽전	13373	15705	20180123	29078
20180121	7호선	철산	14581	14496	20180124	29077
20180124	공항철도 1호선	인천공항1터미널	14970	14104	20180127	29074
20180208	7호선	수락산	14825	14247	20180211	29072
20180126	5호선	종로3가	14744	14328	20180129	29072
20180129	2호선	상왕십리	14786	14284	20180201	29070
20180112	6호선	망원	13973	15096	20180115	29069
20180211	경인선	주안	15416	13652	20180214	29068
20180123	공항철도 1호선	인천공항1터미널	14554	14513	20180126	29067
20180115	경부선	병점	14534	14533	20180118	29067
20180117	6호선	석계	14350	14708	20180120	29058
20180120	5호선	목동	14393	14663	20180123	29056
20180205	6호선	합정	15443	13608	20180208	29051
20180204	4호선	동대문역사문화공원	15137	13911	20180207	29048
20180208	3호선	교대(법원.검찰청)	17462	11583	20180211	29045
20180127	8호선	장지	14723	14316	20180130	29039
20180207	9호선2단계	봉은사	14625	14409	20180210	29034
20180117	7호선	수락산	14619	14411	20180120	29030
20180113	6호선	응암	14817	14211	20180116	29028
20180118	공항철도 1호선	디지털미디어시티	15489	13526	20180121	29015
20180118	2호선	을지로4가	14766	14244	20180121	29010
20180113	2호선	영등포구청	14326	14678	20180116	29004
20180201	5호선	광나루(장신대)	15236	13767	20180204	29003
20180128	경인선	개봉	14416	14586	20180131	29002
20180212	5호선	신정(은행정)	16115	12886	20180215	29001
20180127	7호선	하계	15066	13931	20180130	28997
20180122	일산선	대화	16237	12754	20180125	28991
20180119	일산선	대화	16328	12661	20180122	28989
20180126	3호선	약수	14724	14261	20180129	28985
20180120	2호선	신당	14098	14887	20180123	28985
20180128	2호선	교대(법원.검찰청)	13728	15255	20180131	28983
20180208	6호선	석계	14416	14555	20180211	28971
20180212	분당선	망포	15071	13889	20180215	28960
20180121	1호선	동대문	13169	15787	20180124	28956
20180113	5호선	목동	14259	14694	20180116	28953
20180203	6호선	합정	15654	13298	20180206	28952
20180124	안산선	안산	15156	13794	20180127	28950
20180131	경부선	병점	14460	14487	20180203	28947
20180206	1호선	동대문	14169	14777	20180209	28946
20180115	5호선	신정(은행정)	16156	12789	20180118	28945
20180118	5호선	신정(은행정)	16207	12730	20180121	28937
20180123	3호선	약수	14782	14147	20180126	28929
20180119	7호선	부천시청	14321	14601	20180122	28922
20180123	5호선	아차산(어린이대공원후문)	14688	14227	20180126	28915
20180127	분당선	압구정로데오	13831	15082	20180130	28913
20180125	5호선	종로3가	15010	13903	20180128	28913
20180120	6호선	합정	15468	13445	20180123	28913
20180119	분당선	수원시청	12764	16147	20180122	28911
20180115	8호선	남한산성입구(성남법원.검찰청)	15176	13735	20180118	28911
20180124	분당선	수서	14272	14635	20180127	28907
20180203	5호선	발산	14206	14696	20180206	28902
20180115	6호선	마포구청	15215	13685	20180118	28900
20180118	7호선	수락산	14584	14311	20180121	28895
20180208	공항철도 1호선	디지털미디어시티	15430	13461	20180211	28891
20180122	5호선	신정(은행정)	16051	12840	20180125	28891
20180118	경부선	병점	14501	14386	20180121	28887
20180129	3호선	약수	14764	14121	20180201	28885
20180201	7호선	수락산	14511	14360	20180204	28871
20180124	7호선	신중동	14530	14340	20180127	28870
20180125	6호선	합정	15453	13413	20180128	28866
20180212	7호선	숭실대입구(살피재)	14593	14266	20180215	28859
20180118	7호선	숭실대입구(살피재)	14524	14327	20180121	28851
20180122	경부선	병점	14423	14423	20180125	28846
20180113	2호선	서초	14665	14174	20180116	28839
20180212	3호선	교대(법원.검찰청)	17132	11705	20180215	28837
20180120	2호선	서초	14856	13981	20180123	28837
20180125	2호선	상왕십리	14580	14253	20180128	28833
20180120	일산선	삼송	14866	13963	20180123	28829
20180124	5호선	종로3가	14894	13919	20180127	28813
20180122	6호선	합정	15347	13453	20180125	28800
20180126	6호선	망원	13852	14945	20180129	28797
20180125	안산선	안산	14978	13806	20180128	28784
20180206	2호선	을지로4가	14574	14209	20180209	28783
20180113	7호선	학동	13937	14840	20180116	28777
20180122	7호선	수락산	14463	14310	20180125	28773
20180122	7호선	숭실대입구(살피재)	14406	14365	20180125	28771
20180131	8호선	남한산성입구(성남법원.검찰청)	15215	13551	20180203	28766
20180119	7호선	공릉(서울과학기술대)	14510	14255	20180122	28765
20180208	7호선	숭실대입구(살피재)	14532	14225	20180211	28757
20180115	7호선	수락산	14511	14245	20180118	28756
20180124	일산선	삼송	14575	14179	20180127	28754
20180205	5호선	신정(은행정)	15985	12767	20180208	28752
20180206	5호선	신정(은행정)	15942	12788	20180209	28730
20180113	7호선	논현	13508	15215	20180116	28723
20180122	2호선	을지로4가	14635	14086	20180125	28721
20180125	3호선	약수	14642	14068	20180128	28710
20180117	7호선	숭실대입구(살피재)	14468	14240	20180120	28708
20180205	2호선	을지로4가	14425	14280	20180208	28705
20180128	과천선	인덕원	14572	14131	20180131	28703
20180127	7호선	학동	14019	14682	20180130	28701
20180128	안산선	안산	14864	13823	20180131	28687
20180115	중앙선	구리	14059	14628	20180118	28687
20180205	6호선	마포구청	15001	13682	20180208	28683
20180124	2호선	상왕십리	14515	14162	20180127	28677
20180126	2호선	상왕십리	14696	13978	20180129	28674
20180119	5호선	군자(능동)	12702	15972	20180122	28674
20180121	공항철도 1호선	인천공항1터미널	14295	14376	20180124	28671
20180114	1호선	제기동	14156	14510	20180117	28666
20180201	중앙선	구리	14030	14631	20180204	28661
20180122	8호선	남한산성입구(성남법원.검찰청)	15046	13614	20180125	28660
20180113	7호선	청담	13812	14839	20180116	28651
20180129	5호선	아차산(어린이대공원후문)	14637	14007	20180201	28644
20180207	경부선	병점	14192	14448	20180210	28640
20180201	8호선	남한산성입구(성남법원.검찰청)	15158	13480	20180204	28638
20180125	6호선	망원	13674	14961	20180128	28635
20180131	일산선	대화	16052	12582	20180203	28634
20180129	과천선	정부과천청사	14544	14082	20180201	28626
20180203	5호선	목동	14091	14518	20180206	28609
20180211	2호선	교대(법원.검찰청)	13688	14919	20180214	28607
20180129	6호선	합정	15110	13495	20180201	28605
20180203	4호선	미아(서울사이버대학)	14832	13768	20180206	28600
20180127	2호선	서초	14644	13947	20180130	28591
20180127	7호선	상봉(시외버스터미널)	14628	13955	20180130	28583
20180211	경원선	청량리(서울시립대입구)	14497	14078	20180214	28575
20180207	7호선	숭실대입구(살피재)	14399	14171	20180210	28570
20180128	2호선	선릉	15528	13033	20180131	28561
20180119	3호선	대치	14522	14031	20180122	28553
20180130	3호선	교대(법원.검찰청)	17158	11393	20180202	28551
20180121	분당선	모란	14202	14348	20180124	28550
20180208	6호선	새절(신사)	14472	14076	20180211	28548
20180130	6호선	새절(신사)	14275	14272	20180202	28547
20180124	9호선	고속터미널	11143	17398	20180127	28541
20180207	중앙선	구리	13947	14581	20180210	28528
20180206	경원선	청량리(서울시립대입구)	13601	14918	20180209	28519
20180212	3호선	대치	14428	14085	20180215	28513
20180131	7호선	숭실대입구(살피재)	14474	14039	20180203	28513
20180125	공항철도 1호선	인천공항1터미널	15286	13217	20180128	28503
20180131	6호선	새절(신사)	14604	13888	20180203	28492
20180113	분당선	죽전	13246	15228	20180116	28474
20180206	분당선	오리	15565	12907	20180209	28472
20180207	6호선	석계	14144	14318	20180210	28462
20180205	경원선	청량리(서울시립대입구)	13632	14830	20180208	28462
20180125	경원선	청량리(서울시립대입구)	13790	14671	20180128	28461
20180115	3호선	교대(법원.검찰청)	16780	11677	20180118	28457
20180117	6호선	새절(신사)	14516	13925	20180120	28441
20180125	분당선	태평	14521	13917	20180128	28438
20180119	공항철도 1호선	디지털미디어시티	15361	13069	20180122	28430
20180119	과천선	정부과천청사	14681	13747	20180122	28428
20180201	6호선	석계	14105	14308	20180204	28413
20180120	과천선	경마공원	14110	14302	20180123	28412
20180123	6호선	마포구청	14812	13596	20180126	28408
20180207	7호선	수락산	14369	14020	20180210	28389
20180212	중앙선	구리	13900	14484	20180215	28384
20180124	9호선2단계	봉은사	14352	14030	20180127	28382
20180120	9호선	당산	15268	13108	20180123	28376
20180117	2호선	충정로(경기대입구)	13722	14647	20180120	28369
20180207	3호선	교대(법원.검찰청)	17042	11325	20180210	28367
20180131	3호선	교대(법원.검찰청)	16843	11516	20180203	28359
20180118	6호선	석계	14059	14299	20180121	28358
20180212	7호선	수락산	14420	13936	20180215	28356
20180201	경부선	병점	14220	14127	20180204	28347
20180131	분당선	망포	14776	13571	20180203	28347
20180112	1호선	동대문	13655	14692	20180115	28347
20180115	6호선	석계	13966	14380	20180118	28346
20180129	5호선	광나루(장신대)	14940	13401	20180201	28341
20180117	분당선	망포	14815	13515	20180120	28330
20180207	6호선	새절(신사)	14470	13851	20180210	28321
20180115	경부선	노량진	14691	13630	20180118	28321
20180120	2호선	방배	14162	14158	20180123	28320
20180208	분당선	망포	14821	13497	20180211	28318
20180129	6호선	마포구청	14942	13376	20180201	28318
20180112	3호선	교대(법원.검찰청)	16745	11570	20180115	28315
20180113	6호선	합정	15160	13151	20180116	28311
20180208	7호선	부천시청	14219	14086	20180211	28305
20180129	5호선	신정(은행정)	15817	12487	20180201	28304
20180112	5호선	아차산(어린이대공원후문)	14496	13808	20180115	28304
20180115	5호선	광나루(장신대)	14981	13322	20180118	28303
20180121	3호선	안국	13804	14498	20180124	28302
20180114	경부선	구로	14153	14149	20180117	28302
20180207	8호선	남한산성입구(성남법원.검찰청)	14886	13413	20180210	28299
20180130	8호선	남한산성입구(성남법원.검찰청)	14612	13673	20180202	28285
20180123	9호선2단계	봉은사	14320	13955	20180126	28275
20180114	2호선	동대문역사문화공원	12705	15567	20180117	28272
20180123	5호선	신정(은행정)	15785	12484	20180126	28269
20180205	분당선	오리	15506	12761	20180208	28267
20180121	9호선	고속터미널	10063	18200	20180124	28263
20180120	5호선	장한평	14236	14026	20180123	28262
20180212	5호선	광나루(장신대)	15031	13224	20180215	28255
20180205	6호선	새절(신사)	14354	13901	20180208	28255
20180201	일산선	대화	15786	12460	20180204	28246
20180117	3호선	대치	14350	13894	20180120	28244
20180120	경부선	병점	14229	14013	20180123	28242
20180128	공항철도 1호선	인천공항1터미널	13876	14365	20180131	28241
20180119	경부선	평택	14729	13512	20180122	28241
20180129	1호선	동대문	13701	14539	20180201	28240
20180130	6호선	월곡(동덕여대)	14112	14120	20180202	28232
20180211	7호선	고속터미널	15449	12780	20180214	28229
20180122	6호선	이태원	13828	14398	20180125	28226
20180122	6호선	석계	13808	14415	20180125	28223
20180212	6호선	석계	14012	14209	20180215	28221
20180122	6호선	새절(신사)	14278	13941	20180125	28219
20180126	경부선	성균관대	14436	13781	20180129	28217
20180122	3호선	교대(법원.검찰청)	16720	11496	20180125	28216
20180113	5호선	발산	13814	14401	20180116	28215
20180122	3호선	대치	14296	13917	20180125	28213
20180203	경부선	노량진	14949	13260	20180206	28209
20180124	분당선	태평	14442	13765	20180127	28207
20180130	5호선	군자(능동)	12356	15850	20180202	28206
20180123	공항철도 1호선	디지털미디어시티	15023	13168	20180126	28191
20180212	9호선2단계	봉은사	14264	13924	20180215	28188
20180121	4호선	총신대입구(이수)	13434	14749	20180124	28183
20180203	분당선	한티	14285	13892	20180206	28177
20180113	4호선	미아(서울사이버대학)	14740	13431	20180116	28171
20180212	8호선	남한산성입구(성남법원.검찰청)	14816	13344	20180215	28160
20180206	7호선	수락산	14207	13953	20180209	28160
20180208	경부선	노량진	14473	13683	20180211	28156
20180112	5호선	신정(은행정)	15827	12329	20180115	28156
20180112	분당선	망포	15133	13021	20180115	28154
20180127	경인선	동인천	14403	13744	20180130	28147
20180201	6호선	새절(신사)	14316	13830	20180204	28146
20180201	3호선	교대(법원.검찰청)	16701	11431	20180204	28132
20180124	6호선	망원	13491	14638	20180127	28129
20180118	분당선	망포	14751	13375	20180121	28126
20180118	6호선	새절(신사)	14365	13749	20180121	28114
20180129	2호선	을지로4가	14157	13947	20180201	28104
20180203	9호선	당산	14798	13302	20180206	28100
20180208	일산선	대화	15643	12450	20180211	28093
20180131	공항철도 1호선	디지털미디어시티	14722	13371	20180203	28093
20180114	7호선	철산	13982	14109	20180117	28091
20180203	경부선	평택	14709	13374	20180206	28083
20180113	과천선	경마공원	13914	14168	20180116	28082
20180205	5호선	광나루(장신대)	14811	13270	20180208	28081
20180130	일산선	대화	15281	12789	20180202	28070
20180119	3호선	녹번	15084	12967	20180122	28051
20180130	2호선	충정로(경기대입구)	13869	14177	20180202	28046
20180206	6호선	이태원	13689	14356	20180209	28045
20180207	일산선	대화	15750	12291	20180210	28041
20180112	경부선	노량진	14528	13497	20180115	28025
20180114	4호선	총신대입구(이수)	13250	14769	20180117	28019
20180201	7호선	숭실대입구(살피재)	14123	13894	20180204	28017
20180211	분당선	모란	13805	14210	20180214	28015
20180115	3호선	대치	14263	13747	20180118	28010
20180127	5호선	강동	14986	13017	20180130	28003
20180123	8호선	남한산성입구(성남법원.검찰청)	14659	13336	20180126	27995
20180205	7호선	숭실대입구(살피재)	13962	14032	20180208	27994
20180129	9호선2단계	봉은사	14087	13905	20180201	27992
20180205	6호선	이태원	13659	14300	20180208	27959
20180131	5호선	군자(능동)	12509	15449	20180203	27958
20180125	경부선	성균관대	14370	13585	20180128	27955
20180124	6호선	합정	14904	13036	20180127	27940
20180117	5호선	군자(능동)	12306	15632	20180120	27938
20180129	분당선	오리	15393	12521	20180201	27914
20180127	1호선	동대문	13501	14413	20180130	27914
20180122	9호선2단계	봉은사	14231	13683	20180125	27914
20180112	분당선	오리	15357	12538	20180115	27895
20180117	공항철도 1호선	디지털미디어시티	14928	12951	20180120	27879
20180207	3호선	대치	13999	13876	20180210	27875
20180123	7호선	숭실대입구(살피재)	14030	13844	20180126	27874
20180130	3호선	대치	14040	13826	20180202	27866
20180205	7호선	수락산	14105	13757	20180208	27862
20180131	경부선	노량진	14362	13484	20180203	27846
20180118	3호선	대치	14129	13717	20180121	27846
20180131	3호선	대치	14157	13678	20180203	27835
20180119	4호선	당고개	14408	13424	20180122	27832
20180120	8호선	암사	14691	13140	20180123	27831
20180205	6호선	석계	13601	14227	20180208	27828
20180201	경부선	노량진	14365	13459	20180204	27824
20180115	6호선	새절(신사)	14169	13654	20180118	27823
20180212	일산선	대화	15700	12104	20180215	27804
20180204	2호선	교대(법원.검찰청)	13347	14455	20180207	27802
20180212	7호선	공릉(서울과학기술대)	13985	13815	20180215	27800
20180206	6호선	석계	13759	14037	20180209	27796
20180203	2호선	신당	13617	14179	20180206	27796
20180115	분당선	망포	14346	13448	20180118	27794
20180120	4호선	미아(서울사이버대학)	14545	13241	20180123	27786
20180119	2호선	충정로(경기대입구)	13439	14340	20180122	27779
20180206	8호선	남한산성입구(성남법원.검찰청)	14643	13135	20180209	27778
20180201	분당선	망포	14381	13392	20180204	27773
20180211	7호선	철산	13801	13967	20180214	27768
20180117	일산선	대화	15615	12151	20180120	27766
20180124	경부선	성균관대	14142	13621	20180127	27763
20180126	3호선	교대(법원.검찰청)	16338	11414	20180129	27752
20180121	2호선	동대문역사문화공원	12469	15265	20180124	27734
20180208	2호선	충정로(경기대입구)	13469	14263	20180211	27732
20180205	3호선	교대(법원.검찰청)	16404	11323	20180208	27727
20180208	3호선	녹번	14870	12854	20180211	27724
20180206	5호선	광나루(장신대)	14690	13034	20180209	27724
20180131	7호선	부천시청	13842	13882	20180203	27724
20180127	7호선	이수	13886	13836	20180130	27722
20180131	2호선	충정로(경기대입구)	13506	14208	20180203	27714
20180207	2호선	충정로(경기대입구)	13523	14185	20180210	27708
20180115	9호선2단계	봉은사	13896	13812	20180118	27708
20180113	5호선	장한평	13813	13889	20180116	27702
20180121	1호선	동묘앞	13548	14153	20180124	27701
20180121	4호선	길음	14101	13590	20180124	27691
20180130	경부선	병점	13803	13887	20180202	27690
20180204	과천선	인덕원	13926	13756	20180207	27682
20180115	2호선	충정로(경기대입구)	13485	14192	20180118	27677
20180131	7호선	공릉(서울과학기술대)	13805	13865	20180203	27670
20180203	일산선	삼송	14277	13386	20180206	27663
20180118	일산선	대화	15503	12159	20180121	27662
20180126	5호선	신정(은행정)	15618	12042	20180129	27660
20180124	3호선	약수	14128	13529	20180127	27657
20180127	5호선	종로3가	14040	13604	20180130	27644
20180118	2호선	충정로(경기대입구)	13415	14228	20180121	27643
20180120	분당선	정자	13811	13831	20180123	27642
20180212	7호선	부천시청	13792	13846	20180215	27638
20180122	분당선	망포	14269	13362	20180125	27631
20180118	5호선	군자(능동)	12242	15384	20180121	27626
20180113	경부선	병점	13943	13674	20180116	27617
20180212	경부선	노량진	14240	13368	20180215	27608
20180123	분당선	오리	15240	12367	20180126	27607
20180121	경부선	평택	13059	14540	20180124	27599
20180130	3호선	녹번	14557	13040	20180202	27597
20180211	2호선	선릉	14886	12706	20180214	27592
20180126	6호선	마포구청	14494	13098	20180129	27592
20180212	6호선	새절(신사)	14021	13553	20180215	27574
20180124	5호선	광나루(장신대)	14698	12873	20180127	27571
20180123	5호선	광나루(장신대)	14680	12890	20180126	27570
20180203	과천선	경마공원	13716	13839	20180206	27555
20180114	7호선	노원	13512	14043	20180117	27555
20180119	경원선	회룡	13965	13573	20180122	27538
20180120	7호선	사가정	14125	13405	20180123	27530
20180206	7호선	숭실대입구(살피재)	13839	13688	20180209	27527
20180119	경인선	소사	14148	13376	20180122	27524
20180125	5호선	신정(은행정)	15331	12182	20180128	27513
20180206	공항철도 1호선	디지털미디어시티	14712	12798	20180209	27510
20180211	과천선	인덕원	13775	13732	20180214	27507
20180123	중앙선	구리	13440	14066	20180126	27506
20180203	안산선	안산	13930	13574	20180206	27504
20180203	분당선	죽전	12679	14819	20180206	27498
20180124	5호선	신정(은행정)	15267	12231	20180127	27498
20180211	3호선	경복궁(정부서울청사)	13391	14105	20180214	27496
20180125	6호선	마포구청	14411	13078	20180128	27489
20180205	중앙선	구리	13352	14129	20180208	27481
20180203	2호선	방배	13849	13630	20180206	27479
20180130	분당선	망포	14144	13334	20180202	27478
20180124	경원선	청량리(서울시립대입구)	13341	14137	20180127	27478
20180119	7호선	어린이대공원(세종대)	13989	13485	20180122	27474
20180113	일산선	삼송	14180	13294	20180116	27474
20180114	경부선	평택	13178	14295	20180117	27473
20180121	7호선	노원	13506	13966	20180124	27472
20180126	1호선	동대문	13363	14108	20180129	27471
20180112	중앙선	구리	13369	14101	20180115	27470
20180126	분당선	오리	15118	12350	20180129	27468
20180112	8호선	남한산성입구(성남법원.검찰청)	14751	12709	20180115	27460
20180207	공항철도 1호선	디지털미디어시티	14732	12726	20180210	27458
20180129	7호선	숭실대입구(살피재)	13821	13634	20180201	27455
20180129	6호선	석계	13405	14048	20180201	27453
20180128	경원선	청량리(서울시립대입구)	13854	13594	20180131	27448
20180127	3호선	수서	14069	13378	20180130	27447
20180123	1호선	동대문	13306	14136	20180126	27442
20180206	9호선2단계	봉은사	13841	13599	20180209	27440
20180125	5호선	아차산(어린이대공원후문)	14009	13430	20180128	27439
20180114	일산선	화정	13498	13933	20180117	27431
20180121	2호선	봉천	13938	13492	20180124	27430
20180208	3호선	대치	13836	13589	20180211	27425
20180121	안산선	중앙	13732	13693	20180124	27425
20180205	8호선	남한산성입구(성남법원.검찰청)	14418	13004	20180208	27422
20180129	7호선	수락산	13745	13673	20180201	27418
20180118	3호선	녹번	14672	12738	20180121	27410
20180130	7호선	공릉(서울과학기술대)	13497	13906	20180202	27403
20180112	6호선	마포구청	14448	12944	20180115	27392
20180211	4호선	총신대입구(이수)	12996	14393	20180214	27389
20180205	9호선2단계	봉은사	13896	13491	20180208	27387
20180201	7호선	부천시청	13688	13697	20180204	27385
20180124	5호선	아차산(어린이대공원후문)	13858	13527	20180127	27385
20180205	경부선	병점	13611	13748	20180208	27359
20180130	7호선	군자(능동)	16526	10829	20180202	27355
20180127	7호선	논현	12789	14560	20180130	27349
20180128	9호선	고속터미널	9844	17503	20180131	27347
20180114	8호선	천호(풍납토성)	12812	14527	20180117	27339
20180117	7호선	부천시청	13585	13751	20180120	27336
20180127	7호선	상동	13439	13895	20180130	27334
20180131	7호선	어린이대공원(세종대)	13706	13625	20180203	27331
20180128	분당선	모란	13427	13903	20180131	27330
20180117	4호선	당고개	14041	13288	20180120	27329
20180123	3호선	교대(법원.검찰청)	16302	11026	20180126	27328
20180119	6호선	월곡(동덕여대)	14041	13286	20180122	27327
20180121	안산선	상록수	13863	13459	20180124	27322
20180129	8호선	남한산성입구(성남법원.검찰청)	14377	12941	20180201	27318
20180121	경부선	구로	13551	13760	20180124	27311
20180212	2호선	충정로(경기대입구)	13233	14072	20180215	27305
20180211	7호선	노원	13407	13893	20180214	27300
20180201	5호선	군자(능동)	12234	15061	20180204	27295
20180123	6호선	석계	13434	13838	20180126	27272
20180207	7호선	부천시청	13634	13636	20180210	27270
20180127	과천선	경마공원	13599	13669	20180130	27268
20180207	분당선	망포	14224	13043	20180210	27267
20180129	일산선	대화	15513	11745	20180201	27258
20180201	7호선	공릉(서울과학기술대)	13710	13539	20180204	27249
20180126	5호선	아차산(어린이대공원후문)	13916	13330	20180129	27246
20180129	3호선	교대(법원.검찰청)	16123	11120	20180201	27243
20180206	6호선	새절(신사)	13767	13473	20180209	27240
20180115	7호선	공릉(서울과학기술대)	13528	13704	20180118	27232
20180121	8호선	천호(풍납토성)	12900	14327	20180124	27227
20180113	분당선	수원시청	12406	14817	20180116	27223
20180115	경인선	소사	13881	13338	20180118	27219
20180201	3호선	녹번	14621	12596	20180204	27217
20180125	6호선	이태원	12873	14337	20180128	27210
20180121	일산선	화정	13372	13837	20180124	27209
20180112	3호선	대치	13701	13506	20180115	27207
20180203	5호선	장한평	13472	13731	20180206	27203
20180130	7호선	부천시청	13585	13607	20180202	27192
20180123	7호선	수락산	13677	13513	20180126	27190
20180117	3호선	녹번	14631	12558	20180120	27189
20180123	6호선	이태원	13299	13889	20180126	27188
20180118	경인선	소사	13847	13339	20180121	27186
20180125	분당선	오리	14908	12272	20180128	27180
20180117	7호선	공릉(서울과학기술대)	13633	13545	20180120	27178
20180115	6호선	월곡(동덕여대)	13707	13461	20180118	27168
20180206	2호선	충정로(경기대입구)	13115	14047	20180209	27162
20180129	6호선	이태원	13339	13821	20180201	27160
20180128	7호선	철산	13514	13645	20180131	27159
20180211	안산선	안산	13938	13219	20180214	27157
20180113	분당선	한티	13746	13409	20180116	27155
20180124	6호선	마포구청	14193	12957	20180127	27150
20180123	경부선	병점	13696	13454	20180126	27150
20180201	3호선	대치	13646	13495	20180204	27141
20180208	7호선	공릉(서울과학기술대)	13572	13562	20180211	27134
20180113	분당선	정자	13332	13798	20180116	27130
20180121	4호선	회현(남대문시장)	13369	13755	20180124	27124
20180120	분당선	한티	13952	13168	20180123	27120
20180117	경인선	소사	13818	13301	20180120	27119
20180206	3호선	교대(법원.검찰청)	16154	10963	20180209	27117
20180126	경부선	병점	13900	13210	20180129	27110
20180203	6호선	망원	12949	14158	20180206	27107
20180130	7호선	어린이대공원(세종대)	13876	13224	20180202	27100
20180204	7호선	철산	13437	13654	20180207	27091
20180208	5호선	군자(능동)	12089	15000	20180211	27089
20180204	안산선	안산	13851	13236	20180207	27087
20180131	3호선	녹번	14600	12483	20180203	27083
20180131	7호선	군자(능동)	16435	10642	20180203	27077
20180122	2호선	충정로(경기대입구)	13109	13968	20180125	27077
20180206	경부선	병점	13605	13471	20180209	27076
20180130	3호선	매봉	13871	13201	20180202	27072
20180203	8호선	암사	14209	12849	20180206	27058
20180204	9호선	고속터미널	9492	17565	20180207	27057
20180131	경인선	소사	13888	13161	20180203	27049
20180125	3호선	교대(법원.검찰청)	16044	11001	20180128	27045
20180203	분당선	정자	13319	13716	20180206	27035
20180129	경부선	병점	13512	13523	20180201	27035
20180125	공항철도 1호선	디지털미디어시티	14459	12571	20180128	27030
20180122	경인선	소사	13798	13225	20180125	27023
20180112	6호선	석계	13554	13442	20180115	26996
20180212	5호선	군자(능동)	12024	14959	20180215	26983
20180118	7호선	부천시청	13444	13537	20180121	26981
20180122	7호선	부천시청	13409	13561	20180125	26970
20180113	2호선	방배	13628	13341	20180116	26969
20180128	1호선	제기동	13237	13727	20180131	26964
20180113	7호선	사가정	13612	13350	20180116	26962
20180211	9호선	고속터미널	9280	17681	20180214	26961
20180127	6호선	응암	13652	13307	20180130	26959
20180201	2호선	충정로(경기대입구)	13118	13837	20180204	26955
20180113	2호선	신당	13118	13837	20180116	26955
20180207	3호선	녹번	14517	12436	20180210	26953
20180112	5호선	광나루(장신대)	14324	12626	20180115	26950
20180114	3호선	불광	12443	14489	20180117	26932
20180114	4호선	길음	13903	13019	20180117	26922
20180126	공항철도 1호선	디지털미디어시티	14594	12322	20180129	26916
20180206	중앙선	구리	13111	13803	20180209	26914
20180123	2호선	을지로4가	13664	13249	20180126	26913
20180205	7호선	공릉(서울과학기술대)	13432	13480	20180208	26912
20180119	3호선	종로3가	11442	15470	20180122	26912
20180120	2호선	문래	13342	13567	20180123	26909
20180122	5호선	군자(능동)	12000	14905	20180125	26905
20180205	3호선	녹번	14462	12432	20180208	26894
20180124	3호선	교대(법원.검찰청)	15989	10902	20180127	26891
20180207	5호선	군자(능동)	12040	14850	20180210	26890
20180124	6호선	이태원	13179	13709	20180127	26888
20180117	6호선	월곡(동덕여대)	13561	13327	20180120	26888
20180119	7호선	군자(능동)	16560	10324	20180122	26884
20180115	5호선	군자(능동)	11992	14892	20180118	26884
20180117	7호선	어린이대공원(세종대)	13550	13333	20180120	26883
20180126	분당선	망포	14410	12468	20180129	26878
20180123	6호선	새절(신사)	13596	13282	20180126	26878
20180205	2호선	충정로(경기대입구)	13026	13837	20180208	26863
20180204	1호선	제기동	13280	13583	20180207	26863
20180129	분당선	망포	13893	12965	20180201	26858
20180119	6호선	안암(고대병원앞)	13375	13483	20180122	26858
20180112	7호선	부천시청	13209	13649	20180115	26858
20180205	일산선	대화	15204	11653	20180208	26857
20180118	7호선	공릉(서울과학기술대)	13433	13421	20180121	26854
20180114	2호선	종합운동장	12549	14305	20180117	26854
20180112	7호선	수락산	13774	13073	20180115	26847
20180205	3호선	대치	13459	13386	20180208	26845
20180118	7호선	어린이대공원(세종대)	13385	13459	20180121	26844
20180120	1호선	동묘앞	13018	13807	20180123	26825
20180120	분당선	수원시청	12056	14768	20180123	26824
20180117	7호선	군자(능동)	16397	10422	20180120	26819
20180203	7호선	사가정	13573	13235	20180206	26808
20180118	4호선	당고개	13712	13096	20180121	26808
20180131	6호선	월곡(동덕여대)	13638	13166	20180203	26804
20180126	6호선	석계	13303	13492	20180129	26795
20180122	경부선	노량진	13776	13019	20180125	26795
20180115	7호선	부천시청	13423	13372	20180118	26795
20180212	3호선	녹번	14455	12338	20180215	26793
20180122	3호선	녹번	14256	12530	20180125	26786
20180211	2호선	동대문역사문화공원	12177	14608	20180214	26785
20180204	2호선	봉천	13721	13063	20180207	26784
20180119	일산선	백석	13470	13306	20180122	26776
20180208	4호선	당고개	13836	12938	20180211	26774
20180212	6호선	월곡(동덕여대)	13532	13238	20180215	26770
20180125	1호선	동대문	13198	13570	20180128	26768
20180203	2호선	문래	13296	13455	20180206	26751
20180129	중앙선	구리	13114	13632	20180201	26746
20180205	분당선	망포	13835	12905	20180208	26740
20180115	3호선	녹번	14368	12371	20180118	26739
20180126	8호선	남한산성입구(성남법원.검찰청)	14249	12472	20180129	26721
20180114	2호선	봉천	13619	13101	20180117	26720
20180201	경인선	소사	13711	13008	20180204	26719
20180114	3호선	안국	13003	13715	20180117	26718
20180122	7호선	공릉(서울과학기술대)	13257	13460	20180125	26717
20180206	3호선	대치	13315	13397	20180209	26712
20180126	중앙선	구리	12820	13888	20180129	26708
20180115	공항철도 1호선	디지털미디어시티	14293	12414	20180118	26707
20180206	일산선	대화	14965	11732	20180209	26697
20180131	3호선	종로3가	11836	14859	20180203	26695
20180117	3호선	매봉	13700	12995	20180120	26695
20180123	7호선	어린이대공원(세종대)	13484	13210	20180126	26694
20180130	경부선	노량진	13515	13175	20180202	26690
20180128	7호선	노원	13202	13484	20180131	26686
20180207	7호선	공릉(서울과학기술대)	13394	13291	20180210	26685
20180112	공항철도 1호선	디지털미디어시티	14525	12155	20180115	26680
20180208	6호선	월곡(동덕여대)	13518	13160	20180211	26678
20180127	7호선	청담	12810	13866	20180130	26676
20180118	6호선	월곡(동덕여대)	13535	13135	20180121	26670
20180122	공항철도 1호선	디지털미디어시티	14216	12452	20180125	26668
20180131	4호선	당고개	13818	12847	20180203	26665
20180208	경인선	소사	13647	13015	20180211	26662
20180118	7호선	군자(능동)	16287	10372	20180121	26659
20180211	2호선	봉천	13633	13024	20180214	26657
20180112	분당선	수원시청	11867	14788	20180115	26655
20180115	6호선	안암(고대병원앞)	13131	13519	20180118	26650
20180119	6호선	상수	11889	14738	20180122	26627
20180208	3호선	매봉	13581	13039	20180211	26620
20180121	3호선	불광	12494	14124	20180124	26618
20180128	2호선	동대문역사문화공원	11953	14664	20180131	26617
20180124	7호선	숭실대입구(살피재)	13411	13196	20180127	26607
20180129	6호선	새절(신사)	13532	13072	20180201	26604
20180211	7호선	가산디지털단지	13984	12618	20180214	26602
20180207	경부선	노량진	13545	13052	20180210	26597
20180123	분당선	망포	13853	12743	20180126	26596
20180128	4호선	총신대입구(이수)	12585	14005	20180131	26590
20180117	6호선	안암(고대병원앞)	13186	13402	20180120	26588
20180201	6호선	월곡(동덕여대)	13492	13095	20180204	26587
20180114	안산선	상록수	13377	13205	20180117	26582
20180129	2호선	충정로(경기대입구)	12856	13725	20180201	26581
20180113	경부선	성균관대	13812	12768	20180116	26580
20180127	분당선	한티	13622	12956	20180130	26578
20180123	일산선	대화	14923	11655	20180126	26578
20180205	7호선	부천시청	13397	13179	20180208	26576
20180123	2호선	충정로(경기대입구)	12931	13645	20180126	26576
20180208	경원선	회룡	13640	12935	20180211	26575
20180131	3호선	매봉	13508	13057	20180203	26565
20180126	7호선	부천시청	13114	13451	20180129	26565
20180125	7호선	수락산	13294	13257	20180128	26551
20180127	안산선	안산	13446	13098	20180130	26544
20180115	4호선	당고개	13762	12776	20180118	26538
20180114	4호선	회현(남대문시장)	12957	13581	20180117	26538
20180112	5호선	군자(능동)	11740	14792	20180115	26532
20180206	3호선	녹번	14150	12380	20180209	26530
20180212	공항철도 1호선	디지털미디어시티	14059	12459	20180215	26518
20180127	4호선	미아(서울사이버대학)	13861	12654	20180130	26515
20180112	2호선	충정로(경기대입구)	12915	13593	20180115	26508
20180129	3호선	대치	13457	13045	20180201	26502
20180123	7호선	부천시청	13285	13217	20180126	26502
20180120	6호선	망원	12613	13880	20180123	26493
20180206	분당선	망포	13701	12791	20180209	26492
20180127	2호선	영등포구청	13205	13287	20180130	26492
20180120	6호선	상수	11645	14833	20180123	26478
20180125	6호선	석계	13022	13450	20180128	26472
20180208	3호선	종로3가	11670	14784	20180211	26454
20180125	8호선	남한산성입구(성남법원.검찰청)	13872	12581	20180128	26453
20180117	경원선	회룡	13522	12911	20180120	26433
20180122	경원선	회룡	13392	13040	20180125	26432
20180206	7호선	공릉(서울과학기술대)	13189	13234	20180209	26423
20180121	경인선	동인천	13437	12984	20180124	26421
20180126	7호선	숭실대입구(살피재)	13507	12913	20180129	26420
20180113	8호선	암사	13941	12474	20180116	26415
20180123	3호선	대치	13394	13014	20180126	26408
20180201	7호선	군자(능동)	15989	10418	20180204	26407
20180113	9호선	당산	14051	12345	20180116	26396
20180130	6호선	안암(고대병원앞)	13509	12886	20180202	26395
20180212	3호선	매봉	13408	12977	20180215	26385
20180125	5호선	광나루(장신대)	14132	12249	20180128	26381
20180124	분당선	오리	14540	11837	20180127	26377
20180206	7호선	부천시청	13212	13161	20180209	26373
20180124	8호선	남한산성입구(성남법원.검찰청)	13882	12489	20180127	26371
20180207	7호선	군자(능동)	16112	10257	20180210	26369
20180207	3호선	매봉	13415	12954	20180210	26369
20180126	7호선	수락산	13385	12974	20180129	26359
20180131	7호선	마들	13737	12621	20180203	26358
20180118	6호선	안암(고대병원앞)	13177	13176	20180121	26353
20180130	경인선	소사	13415	12937	20180202	26352
20180119	8호선	강동구청	13125	13215	20180122	26340
20180119	3호선	매봉	13503	12832	20180122	26335
20180115	경원선	회룡	13335	12998	20180118	26333
20180131	경원선	회룡	13427	12904	20180203	26331
20180130	8호선	강동구청	12858	13466	20180202	26324
20180130	3호선	종로3가	11873	14449	20180202	26322
20180201	과천선	정부과천청사	13573	12747	20180204	26320
20180121	경인선	동암	13171	13141	20180124	26312
20180124	3호선	대치	13276	13025	20180127	26301
20180128	1호선	동대문	11991	14301	20180131	26292
20180130	4호선	당고개	13371	12906	20180202	26277
20180127	4호선	서울역	7837	18434	20180130	26271
20180203	4호선	한성대입구(삼선교)	13251	13019	20180206	26270
20180205	6호선	안암(고대병원앞)	13079	13189	20180208	26268
20180117	3호선	종로3가	11557	14698	20180120	26255
20180204	4호선	총신대입구(이수)	12469	13785	20180207	26254
20180119	7호선	마들	13675	12578	20180122	26253
20180204	일산선	화정	12826	13424	20180207	26250
20180203	6호선	상수	11857	14386	20180206	26243
20180126	일산선	대화	14524	11716	20180129	26240
20180126	3호선	대치	13247	12992	20180129	26239
20180112	일산선	대화	14884	11355	20180115	26239
20180201	7호선	마들	13559	12679	20180204	26238
20180211	일산선	화정	12824	13412	20180214	26236
20180112	6호선	새절(신사)	13483	12752	20180115	26235
20180130	3호선	을지로3가	13177	13051	20180202	26228
20180206	5호선	군자(능동)	11729	14493	20180209	26222
20180125	3호선	대치	13245	12976	20180128	26221
20180122	3호선	매봉	13463	12756	20180125	26219
20180112	2호선	을지로4가	13280	12932	20180115	26212
20180212	경인선	소사	13364	12841	20180215	26205
20180124	6호선	석계	12837	13364	20180127	26201
20180130	7호선	마들	13204	12996	20180202	26200
20180131	3호선	을지로3가	12556	13638	20180203	26194
20180212	3호선	종로3가	11615	14578	20180215	26193
20180122	과천선	정부과천청사	13501	12691	20180125	26192
20180115	3호선	매봉	13374	12810	20180118	26184
20180125	2호선	충정로(경기대입구)	12634	13534	20180128	26168
20180201	4호선	당고개	13469	12693	20180204	26162
20180123	3호선	녹번	13998	12163	20180126	26161
20180126	2호선	충정로(경기대입구)	12617	13541	20180129	26158
20180114	2호선	구의(광진구청)	13257	12901	20180117	26158
20180122	4호선	당고개	13511	12646	20180125	26157
20180122	6호선	월곡(동덕여대)	13259	12897	20180125	26156
20180204	7호선	노원	12802	13348	20180207	26150
20180113	2호선	문래	13161	12972	20180116	26133
20180208	7호선	마들	13466	12654	20180211	26120
20180131	8호선	강동구청	12875	13241	20180203	26116
20180204	4호선	길음	13152	12946	20180207	26098
20180127	경부선	노량진	13986	12105	20180130	26091
20180129	6호선	월곡(동덕여대)	13347	12742	20180201	26089
20180117	8호선	강동구청	12902	13187	20180120	26089
20180128	2호선	봉천	13277	12809	20180131	26086
20180124	7호선	수락산	13113	12968	20180127	26081
20180124	공항철도 1호선	디지털미디어시티	13847	12231	20180127	26078
20180203	분당선	수원시청	11945	14132	20180206	26077
20180121	2호선	이대	12707	13361	20180124	26068
20180118	3호선	매봉	13306	12762	20180121	26068
20180118	3호선	종로3가	11468	14600	20180121	26068
20180115	7호선	군자(능동)	15828	10231	20180118	26059
20180123	5호선	군자(능동)	11615	14441	20180126	26056
20180118	경원선	회룡	13182	12870	20180121	26052
20180211	3호선	불광	12176	13872	20180214	26048
20180208	7호선	군자(능동)	15939	10099	20180211	26038
20180207	6호선	월곡(동덕여대)	13180	12858	20180210	26038
20180121	2호선	구의(광진구청)	13254	12783	20180124	26037
20180129	5호선	군자(능동)	11716	14320	20180201	26036
20180212	4호선	당고개	13461	12564	20180215	26025
20180212	7호선	군자(능동)	15856	10169	20180215	26025
20180204	8호선	천호(풍납토성)	12275	13749	20180207	26024
20180122	7호선	군자(능동)	15864	10156	20180125	26020
20180117	7호선	마들	13425	12595	20180120	26020
20180120	경부선	성균관대	13300	12717	20180123	26017
20180205	6호선	월곡(동덕여대)	13054	12951	20180208	26005
20180127	2호선	신당	12604	13391	20180130	25995
20180127	경부선	평택	13511	12477	20180130	25988
20180120	1호선	신설동	13273	12713	20180123	25986
20180128	4호선	길음	13192	12792	20180131	25984
20180129	7호선	부천시청	12951	13032	20180201	25983
20180201	경원선	회룡	13191	12784	20180204	25975
20180125	7호선	숭실대입구(살피재)	13097	12875	20180128	25972
20180119	일산선	원당	13411	12549	20180122	25960
20180125	중앙선	구리	12630	13324	20180128	25954
20180114	경인선	동암	13046	12904	20180117	25950
20180118	7호선	마들	13416	12527	20180121	25943
20180201	3호선	매봉	13275	12667	20180204	25942
20180204	경원선	청량리(서울시립대입구)	13042	12898	20180207	25940
20180127	5호선	목동	12836	13100	20180130	25936
20180122	일산선	백석	12995	12931	20180125	25926
20180129	3호선	녹번	13961	11958	20180201	25919
20180124	일산선	대화	14533	11386	20180127	25919
20180126	분당선	수원시청	11540	14375	20180129	25915
20180128	8호선	천호(풍납토성)	12234	13679	20180131	25913
20180211	8호선	천호(풍납토성)	12203	13699	20180214	25902
20180212	8호선	강동구청	12756	13144	20180215	25900
20180115	과천선	정부과천청사	13332	12561	20180118	25893
20180205	공항철도 1호선	디지털미디어시티	13756	12115	20180208	25871
20180207	경인선	소사	13216	12653	20180210	25869
20180125	분당선	망포	13393	12475	20180128	25868
20180114	1호선	동묘앞	12686	13179	20180117	25865
20180114	경인선	동인천	13246	12618	20180117	25864
20180118	일산선	백석	13001	12847	20180121	25848
20180208	8호선	강동구청	12623	13210	20180211	25833
20180112	7호선	공릉(서울과학기술대)	13076	12757	20180115	25833
20180125	7호선	부천시청	12803	13021	20180128	25824
20180126	5호선	광나루(장신대)	13862	11959	20180129	25821
20180129	공항철도 1호선	디지털미디어시티	13690	12129	20180201	25819
20180125	일산선	대화	14456	11357	20180128	25813
20180127	9호선	당산	13760	12045	20180130	25805
20180208	일산선	백석	13078	12724	20180211	25802
20180124	2호선	충정로(경기대입구)	12566	13229	20180127	25795
20180127	5호선	장한평	12920	12872	20180130	25792
20180120	중앙선	구리	12484	13301	20180123	25785
20180211	4호선	회현(남대문시장)	12750	13034	20180214	25784
20180127	6호선	합정	13806	11977	20180130	25783
20180130	경원선	회룡	12887	12893	20180202	25780
20180211	2호선	구의(광진구청)	12937	12836	20180214	25773
20180124	7호선	어린이대공원(세종대)	13111	12657	20180127	25768
20180120	4호선	한성대입구(삼선교)	13137	12624	20180123	25761
20180130	과천선	정부과천청사	13386	12361	20180202	25747
20180206	3호선	매봉	13145	12596	20180209	25741
20180207	7호선	마들	13208	12530	20180210	25738
20180126	2호선	을지로4가	13123	12607	20180129	25730
20180117	7호선	남성	13254	12476	20180120	25730
20180127	분당선	죽전	12000	13723	20180130	25723
20180124	7호선	부천시청	12815	12901	20180127	25716
20180125	7호선	어린이대공원(세종대)	13043	12669	20180128	25712
20180203	경부선	병점	12986	12722	20180206	25708
20180125	2호선	을지로4가	13050	12658	20180128	25708
20180207	3호선	을지로3가	12527	13176	20180210	25703
20180124	1호선	동대문	12653	13042	20180127	25695
20180212	7호선	마들	13220	12474	20180215	25694
20180114	4호선	충무로	12904	12789	20180117	25693
20180128	경부선	구로	12722	12970	20180131	25692
20180122	8호선	강동구청	12661	13031	20180125	25692
20180128	경부선	평택	12176	13506	20180131	25682
20180201	3호선	종로3가	11271	14404	20180204	25675
20180126	7호선	어린이대공원(세종대)	13141	12527	20180129	25668
20180205	5호선	군자(능동)	11421	14245	20180208	25666
20180115	7호선	어린이대공원(세종대)	13029	12633	20180118	25662
20180117	일산선	원당	13212	12447	20180120	25659
20180120	분당선	태평	13183	12475	20180123	25658
20180211	안산선	상록수	13000	12656	20180214	25656
20180126	6호선	새절(신사)	13141	12510	20180129	25651
20180121	7호선	가산디지털단지	13442	12181	20180124	25623
20180119	3호선	을지로3가	12236	13386	20180122	25622
20180205	과천선	정부과천청사	13230	12387	20180208	25617
20180127	7호선	사가정	12975	12641	20180130	25616
20180124	분당선	망포	13342	12266	20180127	25608
20180117	3호선	을지로3가	12327	13280	20180120	25607
20180112	6호선	안암(고대병원앞)	12952	12649	20180115	25601
20180125	경부선	병점	12813	12783	20180128	25596
20180125	6호선	새절(신사)	12940	12648	20180128	25588
20180208	3호선	을지로3가	12458	13128	20180211	25586
20180126	5호선	군자(능동)	11318	14264	20180129	25582
20180114	7호선	가산디지털단지	13441	12136	20180117	25577
20180204	4호선	회현(남대문시장)	12649	12923	20180207	25572
20180118	8호선	강동구청	12556	13014	20180121	25570
20180207	경원선	회룡	13124	12441	20180210	25565
20180130	일산선	백석	12836	12726	20180202	25562
20180207	4호선	당고개	13036	12525	20180210	25561
20180203	7호선	어린이대공원(세종대)	12951	12610	20180206	25561
20180122	7호선	마들	13098	12457	20180125	25555
20180113	분당선	태평	13056	12492	20180116	25548
20180205	7호선	마들	13094	12453	20180208	25547
20180206	7호선	군자(능동)	15549	9994	20180209	25543
20180205	경부선	노량진	13101	12438	20180208	25539
20180205	3호선	매봉	13005	12534	20180208	25539
20180112	6호선	상수	11430	14108	20180115	25538
20180124	중앙선	구리	12407	13128	20180127	25535
20180208	7호선	남성	13253	12264	20180211	25517
20180212	경원선	회룡	13142	12363	20180215	25505
20180206	7호선	마들	13098	12407	20180209	25505
20180212	분당선	수원시청	12241	13262	20180215	25503
20180122	7호선	어린이대공원(세종대)	12938	12565	20180125	25503
20180211	1호선	동대문	11531	13971	20180214	25502
20180206	6호선	월곡(동덕여대)	12863	12639	20180209	25502
20180123	7호선	공릉(서울과학기술대)	12748	12753	20180126	25501
20180117	일산선	백석	12812	12680	20180120	25492
20180112	3호선	종로3가	11153	14339	20180115	25492
20180124	2호선	을지로4가	13018	12464	20180127	25482
20180205	경인선	소사	13037	12431	20180208	25468
20180127	2호선	방배	12799	12660	20180130	25459
20180201	3호선	을지로3가	12242	13202	20180204	25444
20180203	7호선	신대방삼거리	13120	12321	20180206	25441
20180207	7호선	남성	12999	12439	20180210	25438
20180120	5호선	아차산(어린이대공원후문)	13095	12335	20180123	25430
20180204	2호선	동대문역사문화공원	11405	14022	20180207	25427
20180208	7호선	어린이대공원(세종대)	12715	12710	20180211	25425
20180124	6호선	새절(신사)	12975	12449	20180127	25424
20180112	3호선	녹번	13783	11639	20180115	25422
20180115	7호선	마들	13191	12230	20180118	25421
20180129	7호선	공릉(서울과학기술대)	12749	12671	20180201	25420
20180207	8호선	강동구청	12571	12848	20180210	25419
20180128	3호선	불광	11831	13586	20180131	25417
20180207	7호선	어린이대공원(세종대)	12893	12521	20180210	25414
20180115	경부선	평택	12513	12886	20180118	25399
20180207	3호선	종로3가	11255	14141	20180210	25396
20180115	8호선	강동구청	12452	12933	20180118	25385
20180118	7호선	남성	13143	12239	20180121	25382
20180205	4호선	당고개	13115	12258	20180208	25373
20180131	5호선	상일동	13945	11409	20180203	25354
20180201	7호선	어린이대공원(세종대)	12795	12554	20180204	25349
20180123	3호선	매봉	12996	12351	20180126	25347
20180122	3호선	종로3가	11446	13901	20180125	25347
20180128	4호선	회현(남대문시장)	12759	12587	20180131	25346
20180126	6호선	상수	11381	13963	20180129	25344
20180124	경부선	병점	12662	12680	20180127	25342
20180128	안산선	상록수	12813	12518	20180131	25331
20180125	5호선	군자(능동)	11367	13963	20180128	25330
20180120	7호선	면목	13062	12255	20180123	25317
20180208	과천선	정부과천청사	13144	12171	20180211	25315
20180204	3호선	경복궁(정부서울청사)	12501	12814	20180207	25315
20180117	5호선	상일동	13766	11543	20180120	25309
20180130	일산선	원당	12573	12733	20180202	25306
20180122	일산선	원당	12904	12398	20180125	25302
20180121	경원선	왕십리(성동구청)	11881	13407	20180124	25288
20180131	일산선	백석	12777	12509	20180203	25286
20180131	분당선	수원시청	11991	13291	20180203	25282
20180122	7호선	남성	12885	12394	20180125	25279
20180115	3호선	종로3가	11133	14146	20180118	25279
20180119	6호선	화랑대(서울여대입구)	14365	10913	20180122	25278
20180206	경인선	소사	12928	12347	20180209	25275
20180130	9호선	등촌	12331	12942	20180202	25273
20180205	7호선	군자(능동)	15340	9926	20180208	25266
20180208	7호선	장승배기	12723	12539	20180211	25262
20180129	경인선	소사	12948	12309	20180201	25257
20180117	분당선	수원시청	11955	13297	20180120	25252
20180112	경부선	평택	13088	12156	20180115	25244
20180112	6호선	월곡(동덕여대)	12938	12305	20180115	25243
20180206	7호선	어린이대공원(세종대)	12763	12473	20180209	25236
20180212	7호선	어린이대공원(세종대)	12850	12384	20180215	25234
20180129	7호선	군자(능동)	15278	9954	20180201	25232
20180112	과천선	정부과천청사	13162	12069	20180115	25231
20180201	일산선	백석	12599	12628	20180204	25227
20180130	7호선	중화	12525	12698	20180202	25223
20180203	2호선	시청	13955	11250	20180206	25205
20180206	4호선	당고개	12946	12252	20180209	25198
20180113	6호선	망원	12080	13116	20180116	25196
20180201	5호선	상일동	13751	11440	20180204	25191
20180128	2호선	구의(광진구청)	12626	12564	20180131	25190
20180119	경부선	금천구청	12881	12309	20180122	25190
20180118	3호선	을지로3가	12172	13014	20180121	25186
20180123	6호선	월곡(동덕여대)	12678	12507	20180126	25185
20180118	분당선	수원시청	11980	13200	20180121	25180
20180112	7호선	어린이대공원(세종대)	12794	12386	20180115	25180
20180123	7호선	군자(능동)	15346	9831	20180126	25177
20180126	7호선	공릉(서울과학기술대)	12679	12496	20180129	25175
20180122	3호선	을지로3가	12347	12817	20180125	25164
20180113	4호선	한성대입구(삼선교)	12724	12439	20180116	25163
20180115	일산선	백석	12634	12527	20180118	25161
20180119	5호선	상일동	13888	11268	20180122	25156
20180212	3호선	을지로3가	12204	12945	20180215	25149
20180115	7호선	남성	12966	12183	20180118	25149
20180212	일산선	백석	12585	12559	20180215	25144
20180204	2호선	구의(광진구청)	12716	12428	20180207	25144
20180118	5호선	상일동	13644	11499	20180121	25143
20180121	9호선	가양	12892	12249	20180124	25141
20180118	일산선	원당	12907	12228	20180121	25135
20180131	6호선	안암(고대병원앞)	12429	12700	20180203	25129
20180201	8호선	강동구청	12472	12648	20180204	25120
20180129	경부선	노량진	12875	12243	20180201	25118
20180117	7호선	신풍	12861	12256	20180120	25117
20180120	5호선	답십리	13071	12033	20180123	25104
20180127	5호선	발산	12248	12854	20180130	25102
20180206	경부선	노량진	12763	12330	20180209	25093
20180205	8호선	강동구청	12277	12812	20180208	25089
20180127	일산선	삼송	12935	12147	20180130	25082
20180131	일산선	원당	12887	12189	20180203	25076
20180208	일산선	원당	12807	12262	20180211	25069
20180123	경인선	소사	12778	12289	20180126	25067
20180123	경부선	노량진	12862	12201	20180126	25063
20180212	6호선	안암(고대병원앞)	12477	12578	20180215	25055
20180131	7호선	신풍	12875	12177	20180203	25052
20180114	안산선	중앙	12606	12446	20180117	25052
20180131	7호선	중화	12769	12279	20180203	25048
20180124	5호선	군자(능동)	11161	13883	20180127	25044
20180119	7호선	장승배기	12758	12269	20180122	25027
20180123	과천선	정부과천청사	12727	12299	20180126	25026
20180115	일산선	원당	12923	12103	20180118	25026
20180130	5호선	상일동	13237	11771	20180202	25008
20180127	8호선	암사	13135	11869	20180130	25004
20180120	7호선	신대방삼거리	12920	12073	20180123	24993
20180204	경부선	구로	12434	12552	20180207	24986
20180206	8호선	강동구청	12264	12714	20180209	24978
20180129	3호선	종로3가	11210	13767	20180201	24977
20180201	일산선	원당	12744	12230	20180204	24974
20180120	6호선	공덕	12723	12249	20180123	24972
20180112	7호선	군자(능동)	15346	9621	20180115	24967
20180126	경부선	노량진	12989	11970	20180129	24959
20180123	8호선	강동구청	12207	12752	20180126	24959
20180204	3호선	불광	11591	13367	20180207	24958
20180119	7호선	신풍	12783	12170	20180122	24953
20180131	7호선	남성	12960	11992	20180203	24952
20180129	4호선	당고개	13009	11941	20180201	24950
20180120	2호선	시청	13603	11333	20180123	24936
20180123	3호선	종로3가	11300	13620	20180126	24920
20180129	3호선	매봉	12773	12143	20180201	24916
20180208	5호선	상일동	13489	11425	20180211	24914
20180119	8호선	단대오거리	12864	12045	20180122	24909
20180123	4호선	당고개	12837	12069	20180126	24906
20180121	4호선	상계	12913	11993	20180124	24906
20180119	7호선	남성	13075	11828	20180122	24903
20180201	7호선	남성	12948	11931	20180204	24879
20180120	과천선	평촌	12517	12362	20180123	24879
20180112	3호선	매봉	12710	12167	20180115	24877
20180117	7호선	장승배기	12578	12298	20180120	24876
20180129	3호선	을지로3가	12021	12851	20180201	24872
20180211	4호선	길음	12611	12259	20180214	24870
20180212	7호선	남성	12777	12089	20180215	24866
20180113	6호선	상수	11011	13850	20180116	24861
20180204	7호선	가산디지털단지	13168	11692	20180207	24860
20180201	6호선	안암(고대병원앞)	12305	12546	20180204	24851
20180205	5호선	상일동	13456	11392	20180208	24848
20180126	3호선	종로3가	11040	13807	20180129	24847
20180114	4호선	상계	12968	11874	20180117	24842
20180113	5호선	우장산	12610	12232	20180116	24842
20180207	7호선	신풍	12810	12029	20180210	24839
20180123	3호선	을지로3가	12020	12808	20180126	24828
20180203	경부선	성균관대	12661	12166	20180206	24827
20180211	경부선	구로	12372	12453	20180214	24825
20180206	3호선	을지로3가	11980	12844	20180209	24824
20180203	1호선	신설동	12544	12280	20180206	24824
20180122	5호선	상일동	13403	11421	20180125	24824
20180204	안산선	상록수	12540	12280	20180207	24820
20180203	분당선	태평	12594	12226	20180206	24820
20180114	9호선	가양	12676	12140	20180117	24816
20180128	경인선	동암	12487	12320	20180131	24807
20180120	경인선	소사	12566	12233	20180123	24799
20180115	3호선	을지로3가	11816	12983	20180118	24799
20180203	7호선	면목	12606	12188	20180206	24794
20180123	7호선	마들	12783	12010	20180126	24793
20180206	3호선	종로3가	11157	13631	20180209	24788
20180125	7호선	공릉(서울과학기술대)	12382	12406	20180128	24788
20180128	7호선	가산디지털단지	13094	11690	20180131	24784
20180113	중앙선	구리	12002	12780	20180116	24782
20180208	7호선	중화	12671	12109	20180211	24780
20180211	3호선	안국	12035	12744	20180214	24779
20180121	3호선	구파발	12557	12217	20180124	24774
20180206	6호선	안암(고대병원앞)	12389	12384	20180209	24773
20180205	3호선	종로3가	11029	13739	20180208	24768
20180201	7호선	중화	12593	12173	20180204	24766
20180127	분당선	수원시청	11249	13512	20180130	24761
20180205	7호선	남성	12794	11966	20180208	24760
20180128	안산선	중앙	12280	12480	20180131	24760
20180117	6호선	화랑대(서울여대입구)	14097	10659	20180120	24756
20180130	7호선	남성	12568	12186	20180202	24754
20180124	3호선	녹번	13261	11487	20180127	24748
20180125	3호선	녹번	13254	11492	20180128	24746
20180129	8호선	강동구청	12080	12656	20180201	24736
20180113	경인선	소사	12559	12172	20180116	24731
20180115	분당선	수원시청	11800	12927	20180118	24727
20180129	7호선	마들	12763	11961	20180201	24724
20180203	6호선	안암(고대병원앞)	12746	11965	20180206	24711
20180128	일산선	화정	12092	12615	20180131	24707
20180126	3호선	녹번	13372	11314	20180129	24686
20180208	7호선	신풍	12604	12079	20180211	24683
20180126	6호선	월곡(동덕여대)	12599	12079	20180129	24678
20180126	3호선	을지로3가	12042	12629	20180129	24671
20180205	경원선	회룡	12648	12001	20180208	24649
20180113	7호선	신대방삼거리	12656	11979	20180116	24635
20180119	7호선	중화	12605	12027	20180122	24632
20180205	3호선	을지로3가	12005	12625	20180208	24630
20180212	9호선	등촌	12322	12306	20180215	24628
20180206	7호선	남성	12700	11917	20180209	24617
20180119	경부선	남영	11973	12639	20180122	24612
20180208	분당선	수원시청	11791	12811	20180211	24602
20180112	3호선	을지로3가	11889	12710	20180115	24599
20180125	3호선	매봉	12496	12101	20180128	24597
20180112	4호선	당고개	12795	11802	20180115	24597
20180126	7호선	군자(능동)	15057	9537	20180129	24594
20180120	9호선	염창	12961	11629	20180123	24590
20180113	과천선	평촌	12576	12009	20180116	24585
20180115	7호선	장승배기	12422	12155	20180118	24577
20180115	6호선	화랑대(서울여대입구)	14022	10554	20180118	24576
20180113	2호선	종합운동장	12109	12467	20180116	24576
20180201	7호선	신풍	12568	12007	20180204	24575
20180118	7호선	장승배기	12374	12199	20180121	24573
20180122	7호선	장승배기	12365	12205	20180125	24570
20180120	5호선	우장산	12417	12147	20180123	24564
20180119	3호선	가락시장	12415	12142	20180122	24557
20180112	7호선	마들	12792	11758	20180115	24550
20180206	경원선	회룡	12518	12030	20180209	24548
20180120	7호선	강남구청	11884	12652	20180123	24536
20180122	6호선	안암(고대병원앞)	12162	12367	20180125	24529
20180130	6호선	화랑대(서울여대입구)	13740	10787	20180202	24527
20180212	일산선	원당	12572	11953	20180215	24525
20180125	7호선	군자(능동)	14970	9550	20180128	24520
20180207	5호선	상일동	13320	11196	20180210	24516
20180212	5호선	상일동	13366	11141	20180215	24507
20180207	7호선	중화	12502	12000	20180210	24502
20180203	중앙선	구리	11931	12568	20180206	24499
20180118	6호선	상수	11455	13034	20180121	24489
20180208	9호선	등촌	12188	12299	20180211	24487
20180124	3호선	매봉	12481	12005	20180127	24486
20180113	5호선	답십리	12717	11768	20180116	24485
20180201	6호선	화랑대(서울여대입구)	13926	10557	20180204	24483
20180125	6호선	월곡(동덕여대)	12447	12025	20180128	24472
20180115	5호선	상일동	13406	11059	20180118	24465
20180124	3호선	을지로3가	12029	12434	20180127	24463
20180115	7호선	신풍	12568	11887	20180118	24455
20180113	1호선	신설동	12559	11888	20180116	24447
20180127	2호선	종합운동장	11706	12732	20180130	24438
20180114	경원선	왕십리(성동구청)	11499	12934	20180117	24433
20180121	7호선	하계	12517	11915	20180124	24432
20180118	6호선	화랑대(서울여대입구)	13869	10563	20180121	24432
20180212	7호선	신풍	12504	11917	20180215	24421
20180212	7호선	장승배기	12318	12101	20180215	24419
20180124	7호선	공릉(서울과학기술대)	12232	12179	20180127	24411
20180203	2호선	을지로3가	12760	11641	20180206	24401
20180117	7호선	중화	12443	11957	20180120	24400
20180122	경부선	평택	12260	12132	20180125	24392
20180204	3호선	구파발	12318	12067	20180207	24385
20180201	7호선	장승배기	12312	12071	20180204	24383
20180204	경부선	평택	11664	12718	20180207	24382
20180130	7호선	장승배기	12230	12146	20180202	24376
20180118	7호선	신풍	12544	11827	20180121	24371
20180207	7호선	장승배기	12283	12079	20180210	24362
20180125	7호선	마들	12655	11707	20180128	24362
20180203	7호선	강남구청	11870	12488	20180206	24358
20180117	경부선	평택	12408	11946	20180120	24354
20180130	분당선	수원시청	11740	12611	20180202	24351
20180130	7호선	신풍	12356	11991	20180202	24347
20180207	일산선	원당	12422	11923	20180210	24345
20180117	7호선	부평구청	13504	10836	20180120	24340
20180124	7호선	군자(능동)	14822	9517	20180127	24339
20180115	경부선	금천구청	12515	11824	20180118	24339
20180212	3호선	가락시장	12381	11949	20180215	24330
20180114	3호선	구파발	12336	11984	20180117	24320
20180127	7호선	신대방삼거리	12493	11816	20180130	24309
20180131	6호선	화랑대(서울여대입구)	13936	10371	20180203	24307
20180114	8호선	장지	12229	12073	20180117	24302
20180126	7호선	마들	12641	11657	20180129	24298
20180129	경원선	회룡	12284	12005	20180201	24289
20180117	경부선	금천구청	12431	11858	20180120	24289
20180126	3호선	매봉	12481	11807	20180129	24288
20180122	7호선	중화	12396	11891	20180125	24287
20180122	분당선	수원시청	11747	12540	20180125	24287
20180208	경부선	금천구청	12369	11912	20180211	24281
20180118	7호선	중화	12384	11890	20180121	24274
20180211	안산선	중앙	12265	11999	20180214	24264
20180204	3호선	안국	11749	12513	20180207	24262
20180208	6호선	화랑대(서울여대입구)	13798	10461	20180211	24259
20180119	7호선	부평구청	13491	10749	20180122	24240
20180203	5호선	답십리	12654	11584	20180206	24238
20180124	8호선	강동구청	11841	12392	20180127	24233
20180131	7호선	장승배기	12240	11992	20180203	24232
20180125	3호선	을지로3가	11743	12480	20180128	24223
20180117	경인선	오류동	12450	11771	20180120	24221
20180113	7호선	면목	12455	11759	20180116	24214
20180207	일산선	백석	12177	12030	20180210	24207
20180127	분당선	정자	11998	12206	20180130	24204
20180212	7호선	중화	12300	11902	20180215	24202
20180131	경부선	금천구청	12452	11741	20180203	24193
20180129	6호선	안암(고대병원앞)	11963	12225	20180201	24188
20180121	8호선	장지	12174	12010	20180124	24184
20180123	7호선	장승배기	12138	12041	20180126	24179
20180113	7호선	신중동	12125	12054	20180116	24179
20180205	7호선	장승배기	12123	12055	20180208	24178
20180207	분당선	수원시청	11478	12699	20180210	24177
20180131	7호선	부평구청	13442	10734	20180203	24176
20180127	6호선	상수	10513	13659	20180130	24172
20180128	3호선	안국	12025	12143	20180131	24168
20180204	8호선	장지	12218	11949	20180207	24167
20180204	9호선	가양	12314	11849	20180207	24163
20180114	분당선	미금	11748	12414	20180117	24162
20180113	2호선	시청	13173	10989	20180116	24162
20180206	7호선	중화	12269	11891	20180209	24160
20180122	6호선	화랑대(서울여대입구)	13691	10467	20180125	24158
20180204	경인선	동암	12173	11984	20180207	24157
20180211	8호선	장지	12205	11950	20180214	24155
20180123	6호선	안암(고대병원앞)	11980	12171	20180126	24151
20180211	경인선	동암	12147	11988	20180214	24135
20180117	8호선	단대오거리	12157	11975	20180120	24132
20180205	7호선	어린이대공원(세종대)	12230	11895	20180208	24125
20180205	7호선	신풍	12399	11718	20180208	24117
20180211	경부선	평택	11582	12531	20180214	24113
20180113	5호선	아차산(어린이대공원후문)	12414	11690	20180116	24104
20180125	3호선	종로3가	10880	13222	20180128	24102
20180120	분당선	수서	12092	12010	20180123	24102
20180206	5호선	상일동	12976	11121	20180209	24097
20180118	경부선	금천구청	12426	11668	20180121	24094
20180120	7호선	신중동	11988	12105	20180123	24093
20180203	5호선	우장산	12218	11874	20180206	24092
20180129	일산선	백석	12107	11982	20180201	24089
20180208	3호선	가락시장	12156	11931	20180211	24087
20180201	분당선	수원시청	11539	12545	20180204	24084
20180129	7호선	어린이대공원(세종대)	12095	11986	20180201	24081
20180112	8호선	강동구청	11889	12179	20180115	24068
20180127	6호선	망원	11625	12442	20180130	24067
20180204	1호선	동대문	10975	13090	20180207	24065
20180201	경부선	남영	11634	12431	20180204	24065
20180131	8호선	단대오거리	12129	11936	20180203	24065
20180119	7호선	먹골	12325	11735	20180122	24060
20180127	4호선	한성대입구(삼선교)	12192	11860	20180130	24052
20180130	6호선	상수	11432	12617	20180202	24049
20180120	경부선	대방	12164	11881	20180123	24045
20180201	경부선	금천구청	12283	11758	20180204	24041
20180208	6호선	상수	11124	12898	20180211	24022
20180118	7호선	부평구청	13376	10646	20180121	24022
20180203	과천선	평촌	12175	11838	20180206	24013
20180206	7호선	신풍	12263	11744	20180209	24007
20180121	분당선	미금	11584	12422	20180124	24006
20180201	9호선	등촌	11998	12003	20180204	24001
20180206	7호선	장승배기	12116	11884	20180209	24000
20180115	7호선	중화	12218	11775	20180118	23993
20180119	2호선	종합운동장	11448	12537	20180122	23985
20180124	6호선	월곡(동덕여대)	12132	11851	20180127	23983
20180121	8호선	잠실(송파구청)	11490	12492	20180124	23982
20180117	경부선	남영	11596	12380	20180120	23976
20180123	경원선	회룡	12320	11644	20180126	23964
20180205	7호선	중화	12129	11829	20180208	23958
20180212	6호선	화랑대(서울여대입구)	13742	10213	20180215	23955
20180127	7호선	강남구청	11561	12392	20180130	23953
20180124	3호선	종로3가	10879	13074	20180127	23953
20180124	경부선	노량진	12245	11703	20180127	23948
20180119	경인선	오류동	12312	11636	20180122	23948
20180119	9호선	등촌	12063	11874	20180122	23937
20180126	8호선	강동구청	11809	12127	20180129	23936
20180131	9호선	등촌	12036	11896	20180203	23932
20180208	경부선	남영	11594	12337	20180211	23931
20180113	6호선	공덕	12206	11723	20180116	23929
20180207	6호선	화랑대(서울여대입구)	13676	10252	20180210	23928
20180126	과천선	정부과천청사	12365	11556	20180129	23921
20180203	5호선	아차산(어린이대공원후문)	12267	11644	20180206	23911
20180211	1호선	종로5가	12393	11511	20180214	23904
20180131	경부선	평택	12211	11693	20180203	23904
20180126	4호선	당고개	12309	11588	20180129	23897
20180118	경부선	남영	11477	12414	20180121	23891
20180121	4호선	충무로	11919	11969	20180124	23888
20180125	8호선	강동구청	11734	12149	20180128	23883
20180212	경부선	금천구청	12232	11645	20180215	23877
20180122	경부선	금천구청	12364	11513	20180125	23877
20180115	경부선	남영	11575	12295	20180118	23870
20180129	7호선	남성	12295	11574	20180201	23869
20180122	7호선	신풍	12174	11691	20180125	23865
20180201	6호선	상수	11112	12747	20180204	23859
20180208	7호선	부평구청	13292	10562	20180211	23854
20180114	8호선	잠실(송파구청)	11385	12469	20180117	23854
20180206	과천선	정부과천청사	12267	11586	20180209	23853
20180130	7호선	부평구청	13207	10640	20180202	23847
20180118	경부선	평택	12180	11666	20180121	23846
20180117	9호선	등촌	11962	11882	20180120	23844
20180123	7호선	남성	12240	11602	20180126	23842
20180128	8호선	장지	11943	11896	20180131	23839
20180130	7호선	먹골	11916	11919	20180202	23835
20180204	4호선	충무로	12081	11747	20180207	23828
20180121	안산선	산본	11555	12270	20180124	23825
20180125	경인선	소사	12215	11598	20180128	23813
20180128	9호선	가양	12103	11707	20180131	23810
20180120	2호선	종합운동장	11477	12322	20180123	23799
20180201	7호선	부평구청	13175	10621	20180204	23796
20180205	9호선	등촌	11849	11945	20180208	23794
20180125	4호선	당고개	12303	11489	20180128	23792
20180115	경인선	오류동	12403	11383	20180118	23786
20180203	9호선	염창	12403	11381	20180206	23784
20180130	2호선	종합운동장	11102	12679	20180202	23781
20180125	경부선	노량진	12262	11518	20180128	23780
20180123	5호선	상일동	12847	10932	20180126	23779
20180112	경인선	소사	12257	11514	20180115	23771
20180127	2호선	문래	11779	11984	20180130	23763
20180115	9호선	등촌	11880	11881	20180118	23761
20180122	8호선	단대오거리	11990	11770	20180125	23760
20180207	9호선	등촌	11831	11921	20180210	23752
20180211	3호선	구파발	12010	11738	20180214	23748
20180112	일산선	백석	11834	11913	20180115	23747
20180113	9호선	염창	12500	11239	20180116	23739
20180203	분당선	수서	11870	11866	20180206	23736
20180131	7호선	먹골	12191	11543	20180203	23734
20180120	7호선	수락산	12227	11500	20180123	23727
20180203	6호선	공덕	12062	11663	20180206	23725
20180204	분당선	미금	11417	12306	20180207	23723
20180208	8호선	단대오거리	11967	11754	20180211	23721
20180205	일산선	원당	12072	11648	20180208	23720
20180211	4호선	상계	12295	11424	20180214	23719
20180205	경부선	남영	11392	12327	20180208	23719
20180115	7호선	부평구청	13165	10545	20180118	23710
20180206	2호선	종합운동장	11227	12478	20180209	23705
20180118	경인선	오류동	12299	11398	20180121	23697
20180207	경부선	남영	11530	12162	20180210	23692
20180201	7호선	먹골	11995	11695	20180204	23690
20180113	7호선	강남구청	11507	12180	20180116	23687
20180114	2호선	왕십리(성동구청)	12818	10863	20180117	23681
20180206	일산선	원당	11992	11680	20180209	23672
20180207	6호선	안암(고대병원앞)	11803	11868	20180210	23671
20180203	1호선	동묘앞	11541	12120	20180206	23661
20180208	경부선	평택	12054	11605	20180211	23659
20180122	9호선	등촌	11674	11983	20180125	23657
20180122	7호선	부평구청	13226	10431	20180125	23657
20180211	경인선	동인천	12021	11631	20180214	23652
20180205	6호선	화랑대(서울여대입구)	13511	10132	20180208	23643
20180212	경부선	평택	11984	11657	20180215	23641
20180212	7호선	부평구청	13150	10489	20180215	23639
20180208	2호선	종합운동장	11086	12551	20180211	23637
20180130	8호선	단대오거리	11906	11725	20180202	23631
20180206	일산선	백석	11880	11749	20180209	23629
20180130	분당선	강남구청	11269	12355	20180202	23624
20180206	경부선	남영	11313	12310	20180209	23623
20180122	경부선	남영	11317	12305	20180125	23622
20180206	9호선	등촌	11655	11963	20180209	23618
20180120	2호선	을지로3가	12293	11325	20180123	23618
20180119	경원선	석계	11147	12470	20180122	23617
20180120	4호선	신용산	11445	12171	20180123	23616
20180117	3호선	동대입구	11425	12182	20180120	23607
20180204	경원선	왕십리(성동구청)	11043	12563	20180207	23606
20180117	2호선	종합운동장	11329	12277	20180120	23606
20180205	일산선	백석	11955	11645	20180208	23600
20180114	7호선	하계	12060	11539	20180117	23599
20180118	8호선	단대오거리	11952	11645	20180121	23597
20180208	6호선	안암(고대병원앞)	11760	11835	20180211	23595
20180126	6호선	안암(고대병원앞)	11880	11708	20180129	23588
20180124	7호선	마들	12192	11394	20180127	23586
20180119	경부선	석수	12749	10830	20180122	23579
20180120	5호선	여의도	11040	12537	20180123	23577
20180117	6호선	상수	10957	12612	20180120	23569
20180123	7호선	중화	11971	11591	20180126	23562
20180201	2호선	종합운동장	11131	12420	20180204	23551
20180204	7호선	건대입구	11798	11751	20180207	23549
20180206	6호선	화랑대(서울여대입구)	13309	10239	20180209	23548
20180121	1호선	종로5가	11922	11623	20180124	23545
20180207	8호선	단대오거리	11782	11762	20180210	23544
20180119	공항철도 1호선	계양	12186	11355	20180122	23541
20180204	8호선	잠실(송파구청)	11371	12165	20180207	23536
20180123	일산선	백석	11812	11724	20180126	23536
20180129	7호선	장승배기	11840	11682	20180201	23522
20180208	경인선	오류동	12151	11368	20180211	23519
20180115	8호선	단대오거리	11952	11547	20180118	23499
20180207	7호선	부평구청	13056	10439	20180210	23495
20180129	5호선	상일동	12771	10724	20180201	23495
20180127	분당선	태평	12021	11468	20180130	23489
20180207	경부선	금천구청	12047	11439	20180210	23486
20180117	7호선	먹골	11886	11599	20180120	23485
20180124	4호선	당고개	12042	11430	20180127	23472
20180120	9호선2단계	봉은사	11997	11474	20180123	23471
20180208	7호선	먹골	11907	11563	20180211	23470
20180130	3호선	동대입구	11577	11893	20180202	23470
20180123	분당선	수원시청	11134	12333	20180126	23467
20180123	6호선	화랑대(서울여대입구)	13386	10075	20180126	23461
20180124	6호선	안암(고대병원앞)	11776	11680	20180127	23456
20180201	8호선	단대오거리	11752	11701	20180204	23453
20180114	안산선	산본	11295	12154	20180117	23449
20180112	7호선	남성	12346	11094	20180115	23440
20180124	경인선	소사	11994	11442	20180127	23436
20180129	7호선	신풍	12040	11390	20180201	23430
20180122	경인선	오류동	12068	11360	20180125	23428
20180127	경부선	병점	11801	11626	20180130	23427
20180203	4호선	숙대입구(갈월)	11921	11495	20180206	23416
20180113	4호선	숙대입구(갈월)	11951	11457	20180116	23408
20180131	경인선	오류동	12085	11319	20180203	23404
20180130	7호선	중곡	11841	11546	20180202	23387
20180123	7호선	신풍	12015	11363	20180126	23378
20180204	경인선	동인천	11835	11538	20180207	23373
20180129	일산선	원당	11902	11471	20180201	23373
20180212	7호선	먹골	11829	11534	20180215	23363
20180211	분당선	미금	11314	12038	20180214	23352
20180131	경부선	남영	11270	12082	20180203	23352
20180119	공항철도 1호선	서울역	12396	10956	20180122	23352
20180114	2호선	이대	11344	12005	20180117	23349
20180203	경인선	소사	11802	11543	20180206	23345
20180128	경인선	동인천	11780	11565	20180131	23345
20180131	6호선	상수	10920	12407	20180203	23327
20180126	경부선	평택	12174	11153	20180129	23327
20180123	일산선	원당	11896	11431	20180126	23327
20180203	7호선	수락산	12009	11316	20180206	23325
20180119	8호선	복정	12822	10487	20180122	23309
20180119	9호선	김포공항	10390	12918	20180122	23308
20180118	9호선	등촌	11694	11613	20180121	23307
20180201	경인선	오류동	12094	11210	20180204	23304
20180121	7호선	건대입구	11429	11875	20180124	23304
20180119	7호선	상도	12166	11134	20180122	23300
20180112	경원선	회룡	11900	11396	20180115	23296
20180211	4호선	충무로	11718	11576	20180214	23294
20180115	7호선	먹골	11753	11524	20180118	23277
20180118	2호선	종합운동장	11086	12187	20180121	23273
20180113	경부선	대방	11732	11537	20180116	23269
20180207	7호선	먹골	11801	11466	20180210	23267
20180129	7호선	중화	11971	11294	20180201	23265
20180128	4호선	상계	12063	11202	20180131	23265
20180126	경인선	소사	11963	11301	20180129	23264
20180212	8호선	단대오거리	11765	11498	20180215	23263
20180203	7호선	신중동	11660	11600	20180206	23260
20180206	7호선	부평구청	12944	10315	20180209	23259
20180206	분당선	수원시청	11084	12169	20180209	23253
20180126	9호선	김포공항	10535	12705	20180129	23240
20180201	경부선	평택	11793	11439	20180204	23232
20180119	3호선	옥수	11408	11824	20180122	23232
20180207	2호선	종합운동장	11148	12081	20180210	23229
20180201	3호선	가락시장	11815	11412	20180204	23227
20180129	분당선	수원시청	11194	12033	20180201	23227
20180123	7호선	부평구청	12801	10412	20180126	23213
20180127	7호선	면목	11967	11245	20180130	23212
20180205	분당선	수원시청	11088	12119	20180208	23207
20180113	2호선	을지로3가	12297	10909	20180116	23206
20180212	경부선	남영	11272	11927	20180215	23199
20180130	3호선	가락시장	11594	11595	20180202	23189
20180129	6호선	화랑대(서울여대입구)	13161	10013	20180201	23174
20180205	경부선	평택	11513	11659	20180208	23172
20180128	7호선	하계	11796	11371	20180131	23167
20180113	4호선	신용산	11134	12032	20180116	23166
20180117	7호선	상도	11936	11225	20180120	23161
20180204	4호선	상계	12033	11122	20180207	23155
20180205	7호선	부평구청	12931	10222	20180208	23153
20180131	3호선	가락시장	11855	11298	20180203	23153
20180122	7호선	먹골	11628	11513	20180125	23141
20180211	2호선	이대	11245	11889	20180214	23134
20180130	경부선	금천구청	11772	11356	20180202	23128
20180127	경부선	성균관대	11692	11428	20180130	23120
20180112	6호선	화랑대(서울여대입구)	13306	9808	20180115	23114
20180208	7호선	온수(성공회대입구)	11841	11248	20180211	23089
20180112	7호선	장승배기	11662	11427	20180115	23089
20180128	1호선	동묘앞	11581	11498	20180131	23079
20180203	경부선	대방	11539	11538	20180206	23077
20180211	안산선	산본	11190	11886	20180214	23076
20180128	8호선	잠실(송파구청)	11172	11904	20180131	23076
20180120	4호선	숙대입구(갈월)	11789	11286	20180123	23075
20180125	과천선	정부과천청사	11713	11357	20180128	23070
20180125	7호선	남성	11865	11194	20180128	23059
20180113	분당선	수내	11905	11153	20180116	23058
20180113	분당선	수서	11550	11506	20180116	23056
20180118	3호선	가락시장	11621	11433	20180121	23054
20180121	2호선	당산	10844	12208	20180124	23052
20180117	5호선	둔촌동	11382	11654	20180120	23036
20180204	2호선	이대	11222	11810	20180207	23032
20180118	7호선	먹골	11650	11378	20180121	23028
20180114	1호선	시청	11871	11155	20180117	23026
20180129	7호선	부평구청	12842	10180	20180201	23022
20180115	3호선	가락시장	11632	11390	20180118	23022
20180207	6호선	상수	10809	12204	20180210	23013
20180125	분당선	수원시청	10969	12040	20180128	23009
20180121	2호선	왕십리(성동구청)	12429	10576	20180124	23005
20180203	5호선	여의도	10776	12221	20180206	22997
20180211	7호선	하계	11738	11255	20180214	22993
20180112	7호선	중화	11839	11152	20180115	22991
20180121	7호선	상봉(시외버스터미널)	11738	11248	20180124	22986
20180125	6호선	상수	10885	12097	20180128	22982
20180208	경부선	석수	12342	10632	20180211	22974
20180112	7호선	신풍	11859	11115	20180115	22974
20180206	8호선	단대오거리	11578	11379	20180209	22957
20180203	4호선	신용산	11220	11734	20180206	22954
20180125	6호선	안암(고대병원앞)	11456	11495	20180128	22951
20180117	경원선	석계	10813	12137	20180120	22950
20180123	9호선	등촌	11450	11498	20180126	22948
20180208	7호선	상도	11842	11105	20180211	22947
20180131	경부선	석수	12343	10603	20180203	22946
20180124	5호선	상일동	12449	10496	20180127	22945
20180211	1호선	동묘앞	11558	11383	20180214	22941
20180112	경부선	남영	11168	11771	20180115	22939
20180212	경인선	오류동	11854	11084	20180215	22938
20180115	2호선	종합운동장	10831	12106	20180118	22937
20180115	경원선	석계	10746	12179	20180118	22925
20180130	공항철도 1호선	계양	11573	11350	20180202	22923
20180119	분당선	강남구청	10655	12268	20180122	22923
20180130	경부선	남영	11080	11822	20180202	22902
20180119	5호선	둔촌동	11252	11647	20180122	22899
20180118	공항철도 1호선	계양	11877	11019	20180121	22896
20180113	경원선	외대앞	11970	10924	20180116	22894
20180127	2호선	시청	12456	10437	20180130	22893
20180131	2호선	종합운동장	10813	12075	20180203	22888
20180114	1호선	종로5가	11453	11434	20180117	22887
20180126	7호선	중화	11699	11184	20180129	22883
20180124	7호선	남성	11806	11076	20180127	22882
20180112	8호선	단대오거리	11730	11150	20180115	22880
20180205	2호선	종합운동장	10547	12323	20180208	22870
20180126	6호선	화랑대(서울여대입구)	13079	9791	20180129	22870
20180122	공항철도 1호선	계양	11828	11041	20180125	22869
20180117	3호선	가락시장	11625	11228	20180120	22853
20180121	3호선	홍제	11561	11285	20180124	22846
20180207	7호선	온수(성공회대입구)	11826	11019	20180210	22845
20180112	일산선	원당	11698	11142	20180115	22840
20180131	공항철도 1호선	계양	11942	10893	20180203	22835
20180205	7호선	먹골	11539	11293	20180208	22832
20180120	4호선	당고개	11709	11121	20180123	22830
20180204	7호선	하계	11591	11234	20180207	22825
20180113	7호선	수락산	11770	11055	20180116	22825
20180131	6호선	증산(명지대앞)	11697	11123	20180203	22820
20180130	경인선	오류동	11725	11093	20180202	22818
20180112	7호선	부평구청	12760	10050	20180115	22810
20180130	7호선	상도	11645	11161	20180202	22806
20180126	7호선	신풍	11710	11096	20180129	22806
20180129	9호선	등촌	11391	11414	20180201	22805
20180125	일산선	백석	11473	11331	20180128	22804
20180124	2호선	종합운동장	10900	11902	20180127	22802
20180126	7호선	남성	11929	10871	20180129	22800
20180129	경부선	평택	11385	11413	20180201	22798
20180120	7호선	어린이대공원(세종대)	11585	11201	20180123	22786
20180115	7호선	상도	11674	11106	20180118	22780
20180131	7호선	상도	11769	11010	20180203	22779
20180207	경부선	평택	11585	11193	20180210	22778
20180205	7호선	온수(성공회대입구)	11779	10997	20180208	22776
20180117	경부선	석수	12142	10631	20180120	22773
20180125	7호선	장승배기	11443	11329	20180128	22772
20180120	2호선	뚝섬	11259	11512	20180123	22771
20180113	7호선	부천시청	11376	11392	20180116	22768
20180207	3호선	가락시장	11519	11236	20180210	22755
20180119	경부선	명학	11467	11286	20180122	22753
20180121	3호선	수서	11320	11429	20180124	22749
20180128	3호선	구파발	11472	11276	20180131	22748
20180205	경부선	금천구청	11685	11059	20180208	22744
20180120	공항철도 1호선	서울역	11942	10791	20180123	22733
20180126	일산선	백석	11397	11327	20180129	22724
20180112	공항철도 1호선	서울역	12268	10454	20180115	22722
20180122	2호선	종합운동장	10371	12347	20180125	22718
20180207	7호선	중곡	11710	11005	20180210	22715
20180130	6호선	증산(명지대앞)	11415	11300	20180202	22715
20180212	6호선	상수	10701	12008	20180215	22709
20180207	6호선	증산(명지대앞)	11588	11121	20180210	22709
20180203	7호선	부천시청	11351	11348	20180206	22699
20180127	9호선2단계	봉은사	11577	11121	20180130	22698
20180212	7호선	상도	11689	11006	20180215	22695
20180123	8호선	단대오거리	11514	11176	20180126	22690
20180208	6호선	증산(명지대앞)	11650	11033	20180211	22683
20180212	경부선	석수	12128	10551	20180215	22679
20180131	7호선	중곡	11847	10817	20180203	22664
20180124	7호선	신풍	11642	11020	20180127	22662
20180125	5호선	상일동	12313	10341	20180128	22654
20180203	분당선	수내	11629	11023	20180206	22652
20180119	경원선	외대앞	11695	10957	20180122	22652
20180208	7호선	중곡	11609	11038	20180211	22647
20180131	2호선	아현	11470	11174	20180203	22644
20180118	6호선	증산(명지대앞)	11542	11102	20180121	22644
20180125	7호선	중화	11461	11179	20180128	22640
20180211	2호선	왕십리(성동구청)	12504	10134	20180214	22638
20180205	8호선	단대오거리	11463	11175	20180208	22638
20180128	1호선	종로5가	11575	11063	20180131	22638
20180129	8호선	단대오거리	11493	11143	20180201	22636
20180130	경원선	석계	10509	12125	20180202	22634
20180119	2호선	아현	11631	11002	20180122	22633
20180131	5호선	둔촌동	11201	11431	20180203	22632
20180124	6호선	화랑대(서울여대입구)	12888	9741	20180127	22629
20180117	공항철도 1호선	계양	11769	10860	20180120	22629
20180115	공항철도 1호선	계양	11795	10832	20180118	22627
20180128	경원선	왕십리(성동구청)	10641	11985	20180131	22626
20180127	5호선	답십리	11779	10843	20180130	22622
20180208	공항철도 1호선	계양	11754	10853	20180211	22607
20180126	7호선	부평구청	12580	10021	20180129	22601
20180122	경부선	석수	12032	10565	20180125	22597
20180118	7호선	상도	11659	10936	20180121	22595
20180208	3호선	옥수	11093	11501	20180211	22594
20180203	일산선	대화	12074	10517	20180206	22591
20180127	5호선	우장산	11415	11174	20180130	22589
20180126	3호선	동대입구	11036	11550	20180129	22586
20180119	6호선	증산(명지대앞)	11675	10911	20180122	22586
20180122	3호선	가락시장	11428	11155	20180125	22583
20180206	7호선	먹골	11487	11091	20180209	22578
20180127	9호선	염창	11802	10769	20180130	22571
20180114	2호선	당산	10615	11956	20180117	22571
20180201	경부선	석수	12103	10465	20180204	22568
20180128	4호선	충무로	11417	11149	20180131	22566
20180128	분당선	미금	10987	11577	20180131	22564
20180201	9호선	김포공항	10122	12439	20180204	22561
20180125	7호선	부평구청	12483	10063	20180128	22546
20180206	7호선	온수(성공회대입구)	11767	10777	20180209	22544
20180201	7호선	중곡	11700	10842	20180204	22542
20180207	경인선	오류동	11575	10959	20180210	22534
20180117	경부선	명학	11262	11271	20180120	22533
20180211	8호선	잠실(송파구청)	10847	11685	20180214	22532
20180118	경원선	석계	10584	11938	20180121	22522
20180114	경부선	노량진	11971	10551	20180117	22522
20180113	1호선	동묘앞	10950	11569	20180116	22519
20180126	경원선	회룡	11467	11049	20180129	22516
20180206	6호선	상수	10663	11850	20180209	22513
20180124	7호선	중화	11486	11027	20180127	22513
20180131	7호선	온수(성공회대입구)	11674	10838	20180203	22512
20180201	7호선	상도	11666	10845	20180204	22511
20180123	7호선	먹골	11392	11117	20180126	22509
20180112	5호선	상일동	12462	10043	20180115	22505
20180211	7호선	건대입구	11176	11325	20180214	22501
20180130	3호선	옥수	10729	11772	20180202	22501
20180131	3호선	옥수	11003	11491	20180203	22494
20180126	7호선	장승배기	11468	11020	20180129	22488
20180118	경부선	석수	12076	10411	20180121	22487
20180125	7호선	신풍	11537	10944	20180128	22481
20180117	분당선	강남구청	10403	12077	20180120	22480
20180204	안산선	중앙	11182	11297	20180207	22479
20180115	경부선	석수	12058	10416	20180118	22474
20180129	7호선	먹골	11385	11085	20180201	22470
20180114	7호선	건대입구	11098	11365	20180117	22463
20180129	경부선	금천구청	11576	10885	20180201	22461
20180131	경원선	석계	10574	11882	20180203	22456
20180212	공항철도 1호선	계양	11679	10772	20180215	22451
20180122	7호선	상도	11549	10902	20180125	22451
20180113	7호선	어린이대공원(세종대)	11407	11044	20180116	22451
20180211	9호선	가양	11375	11074	20180214	22449
20180128	2호선	이대	10939	11506	20180131	22445
20180131	분당선	강남구청	10304	12139	20180203	22443
20180117	3호선	옥수	10979	11464	20180120	22443
20180208	분당선	강남구청	10426	12013	20180211	22439
20180205	경인선	오류동	11644	10793	20180208	22437
20180121	4호선	동대문	11062	11373	20180124	22435
20180128	2호선	종합운동장	10656	11777	20180131	22433
20180120	2호선	잠실나루	11553	10872	20180123	22425
20180119	5호선	영등포시장	10823	11602	20180122	22425
20180125	일산선	원당	11505	10916	20180128	22421
20180207	7호선	상도	11559	10858	20180210	22417
20180201	7호선	온수(성공회대입구)	11705	10710	20180204	22415
20180124	7호선	부평구청	12382	10023	20180127	22405
20180117	6호선	증산(명지대앞)	11483	10922	20180120	22405
20180201	6호선	증산(명지대앞)	11428	10976	20180204	22404
20180121	6호선	응암	11107	11295	20180124	22402
20180118	3호선	옥수	10966	11436	20180121	22402
20180208	6호선	광흥창(서강)	11224	11174	20180211	22398
20180120	5호선	광나루(장신대)	11740	10652	20180123	22392
20180120	7호선	부천시청	11252	11133	20180123	22385
20180125	6호선	화랑대(서울여대입구)	12775	9607	20180128	22382
20180118	3호선	일원	10972	11404	20180121	22376
20180120	7호선	남구로	11015	11354	20180123	22369
20180131	9호선	김포공항	10107	12255	20180203	22362
20180123	경부선	남영	10763	11593	20180126	22356
20180115	6호선	증산(명지대앞)	11315	11031	20180118	22346
20180113	5호선	여의도	10425	11920	20180116	22345
20180115	경원선	외대앞	11425	10919	20180118	22344
20180120	분당선	수내	11487	10855	20180123	22342
20180121	분당선	죽전	10122	12215	20180124	22337
20180122	경원선	석계	10540	11789	20180125	22329
20180207	6호선	광흥창(서강)	11339	10989	20180210	22328
20180212	7호선	온수(성공회대입구)	11575	10751	20180215	22326
20180212	9호선	김포공항	9523	12795	20180215	22318
20180124	7호선	장승배기	11202	11093	20180127	22295
20180131	4호선	이촌(국립중앙박물관)	10585	11709	20180203	22294
20180127	2호선	을지로3가	11424	10861	20180130	22285
20180124	분당선	수원시청	10612	11673	20180127	22285
20180127	중앙선	구리	10792	11492	20180130	22284
20180207	분당선	강남구청	10339	11941	20180210	22280
20180117	8호선	복정	12298	9982	20180120	22280
20180121	7호선	대림(구로구청)	11229	11049	20180124	22278
20180126	공항철도 1호선	서울역	12031	10245	20180129	22276
20180126	5호선	상일동	12127	10147	20180129	22274
20180114	3호선	홍제	11338	10936	20180117	22274
20180120	7호선	중계	11695	10578	20180123	22273
20180119	2호선	신정네거리	10986	11281	20180122	22267
20180125	경원선	회룡	11307	10957	20180128	22264
20180127	6호선	공덕	11401	10857	20180130	22258
20180206	3호선	가락시장	11366	10885	20180209	22251
20180124	8호선	단대오거리	11111	11138	20180127	22249
20180203	7호선	중계	11642	10604	20180206	22246
20180112	9호선	등촌	11207	11032	20180115	22239
20180201	분당선	강남구청	10316	11919	20180204	22235
20180123	경부선	금천구청	11433	10802	20180126	22235
20180127	분당선	수서	11123	11111	20180130	22234
20180208	3호선	일원	11062	11171	20180211	22233
20180123	경원선	외대앞	11291	10942	20180126	22233
20180113	공항철도 1호선	서울역	11729	10499	20180116	22228
20180130	7호선	온수(성공회대입구)	11409	10816	20180202	22225
20180127	1호선	신설동	11348	10875	20180130	22223
20180207	5호선	둔촌동	10917	11303	20180210	22220
20180112	2호선	종합운동장	10629	11587	20180115	22216
20180212	2호선	종합운동장	10566	11649	20180215	22215
20180119	6호선	광흥창(서강)	11163	11052	20180122	22215
20180208	경원선	석계	10592	11621	20180211	22213
20180120	경원선	회룡	11173	11040	20180123	22213
20180130	2호선	아현	11013	11198	20180202	22211
20180126	7호선	먹골	11345	10866	20180129	22211
20180212	6호선	증산(명지대앞)	11360	10849	20180215	22209
20180203	5호선	광나루(장신대)	11572	10637	20180206	22209
20180206	경부선	금천구청	11252	10954	20180209	22206
20180129	경부선	남영	10679	11527	20180201	22206
20180115	5호선	둔촌동	10852	11351	20180118	22203
20180117	7호선	온수(성공회대입구)	11513	10682	20180120	22195
20180201	공항철도 1호선	계양	11577	10613	20180204	22190
20180118	분당선	강남구청	10269	11907	20180121	22176
20180211	경원선	왕십리(성동구청)	10401	11772	20180214	22173
20180128	2호선	왕십리(성동구청)	11994	10175	20180131	22169
20180124	경원선	회룡	11307	10862	20180127	22169
20180125	9호선	등촌	10987	11181	20180128	22168
20180207	3호선	대청	11699	10459	20180210	22158
20180120	3호선	약수	11387	10770	20180123	22157
20180115	7호선	대림(구로구청)	11024	11126	20180118	22150
20180203	분당선	오리	12206	9942	20180206	22148
20180130	5호선	둔촌동	10864	11283	20180202	22147
20180120	3호선	대치	11719	10422	20180123	22141
20180117	6호선	광흥창(서강)	11206	10931	20180120	22137
20180130	경부선	석수	11784	10350	20180202	22134
20180208	3호선	대청	11565	10563	20180211	22128
20180114	분당선	죽전	10144	11982	20180117	22126
20180205	6호선	증산(명지대앞)	11326	10788	20180208	22114
20180203	공항철도 1호선	서울역	11436	10669	20180206	22105
20180123	6호선	상수	10418	11685	20180126	22103
20180121	5호선	강동	11466	10637	20180124	22103
20180201	3호선	옥수	10767	11329	20180204	22096
20180124	9호선	김포공항	9791	12305	20180127	22096
20180124	일산선	백석	11109	10984	20180127	22093
20180212	공항철도 1호선	서울역	12298	9794	20180215	22092
20180208	2호선	아현	11232	10859	20180211	22091
20180125	8호선	단대오거리	11180	10908	20180128	22088
20180206	7호선	중곡	11437	10649	20180209	22086
20180119	5호선	고덕	11298	10786	20180122	22084
20180128	안산선	산본	10656	11421	20180131	22077
20180205	3호선	가락시장	11241	10835	20180208	22076
20180128	7호선	건대입구	10989	11085	20180131	22074
20180122	6호선	증산(명지대앞)	11223	10844	20180125	22067
20180122	일산선	주엽	10828	11230	20180125	22058
20180201	경원선	석계	10377	11679	20180204	22056
20180131	경부선	명학	10914	11142	20180203	22056
20180204	3호선	홍제	11257	10795	20180207	22052
20180212	분당선	강남구청	10193	11856	20180215	22049
20180201	8호선	복정	12163	9880	20180204	22043
20180130	3호선	일원	10672	11371	20180202	22043
20180205	7호선	상도	11259	10781	20180208	22040
20180207	경부선	석수	11766	10273	20180210	22039
20180208	8호선	복정	12221	9803	20180211	22024
20180112	7호선	먹골	11255	10765	20180115	22020
20180204	안산선	산본	10600	11419	20180207	22019
20180123	공항철도 1호선	계양	11379	10640	20180126	22019
20180117	경원선	외대앞	11298	10721	20180120	22019
20180206	분당선	강남구청	10236	11779	20180209	22015
20180119	7호선	온수(성공회대입구)	11483	10532	20180122	22015
20180117	9호선	김포공항	9688	12326	20180120	22014
20180118	경원선	외대앞	11249	10762	20180121	22011
20180208	경의선	일산	11100	10909	20180211	22009
20180211	3호선	홍제	11111	10897	20180214	22008
20180120	5호선	군자(능동)	9460	12547	20180123	22007
20180112	7호선	상도	11322	10685	20180115	22007
20180126	경부선	남영	10528	11477	20180129	22005
20180112	9호선	김포공항	10003	11999	20180115	22002
20180206	7호선	상도	11419	10582	20180209	22001
20180126	8호선	단대오거리	11249	10752	20180129	22001
20180207	9호선	김포공항	9798	12200	20180210	21998
20180130	경부선	평택	11177	10821	20180202	21998
20180207	공항철도 1호선	계양	11305	10692	20180210	21997
20180127	5호선	아차산(어린이대공원후문)	11220	10777	20180130	21997
20180208	경원선	외대앞	11370	10626	20180211	21996
20180127	과천선	평촌	11183	10813	20180130	21996
20180119	경인선	제물포	11462	10528	20180122	21990
20180114	3호선	수서	10929	11059	20180117	21988
20180204	2호선	왕십리(성동구청)	11895	10079	20180207	21974
20180112	경부선	금천구청	11276	10694	20180115	21970
20180203	7호선	남구로	10723	11240	20180206	21963
20180203	9호선	김포공항	9754	12206	20180206	21960
20180212	3호선	옥수	10679	11280	20180215	21959
20180119	일산선	주엽	10816	11134	20180122	21950
20180117	7호선	중곡	11370	10579	20180120	21949
20180112	3호선	가락시장	11161	10787	20180115	21948
20180212	경원선	외대앞	11193	10753	20180215	21946
20180118	6호선	광흥창(서강)	11025	10920	20180121	21945
20180114	경부선	병점	10388	11550	20180117	21938
20180126	일산선	원당	11200	10737	20180129	21937
20180120	9호선	김포공항	9658	12278	20180123	21936
20180118	8호선	복정	12307	9629	20180121	21936
20180115	7호선	온수(성공회대입구)	11445	10490	20180118	21935
20180115	경부선	명학	10885	11050	20180118	21935
20180212	경원선	석계	10409	11518	20180215	21927
20180208	5호선	고덕	11120	10806	20180211	21926
20180114	5호선	강동	11373	10548	20180117	21921
20180206	6호선	증산(명지대앞)	11197	10723	20180209	21920
20180117	2호선	신정네거리	10744	11176	20180120	21920
20180129	공항철도 1호선	계양	11398	10518	20180201	21916
20180118	9호선	김포공항	9828	12087	20180121	21915
20180201	경부선	명학	10871	11037	20180204	21908
20180117	7호선	대림(구로구청)	10844	11060	20180120	21904
20180123	2호선	종합운동장	10345	11555	20180126	21900
20180118	경부선	명학	10867	11022	20180121	21889
20180206	5호선	굽은다리(강동구민회관앞)	11209	10676	20180209	21885
20180120	경부선	독산	10967	10916	20180123	21883
20180131	8호선	복정	12151	9728	20180203	21879
20180201	6호선	광흥창(서강)	11038	10836	20180204	21874
20180207	8호선	복정	12056	9816	20180210	21872
20180125	9호선	김포공항	9882	11989	20180128	21871
20180130	9호선	김포공항	10110	11755	20180202	21865
20180115	6호선	상수	10364	11501	20180118	21865
20180204	7호선	상봉(시외버스터미널)	11276	10588	20180207	21864
20180115	9호선	김포공항	9753	12105	20180118	21858
20180203	3호선	대치	11569	10288	20180206	21857
20180130	경부선	명학	10965	10889	20180202	21854
20180205	7호선	중곡	11313	10539	20180208	21852
20180121	경부선	병점	10308	11537	20180124	21845
20180207	3호선	옥수	10694	11145	20180210	21839
20180129	경인선	오류동	11285	10553	20180201	21838
20180125	경부선	남영	10533	11305	20180128	21838
20180124	일산선	원당	11189	10648	20180127	21837
20180113	7호선	중계	11493	10343	20180116	21836
20180206	경부선	평택	11079	10750	20180209	21829
20180128	3호선	홍제	11051	10776	20180131	21827
20180113	4호선	당고개	11328	10490	20180116	21818
20180119	경인선	중동	11304	10513	20180122	21817
20180203	경부선	독산	10908	10908	20180206	21816
20180201	5호선	고덕	11208	10606	20180204	21814
20180203	2호선	뚝섬	10880	10932	20180206	21812
20180212	7호선	중곡	11219	10581	20180215	21800
20180122	8호선	복정	11997	9798	20180125	21795
20180212	3호선	일원	10692	11101	20180215	21793
20180121	6호선	합정	11938	9854	20180124	21792
20180120	일산선	대화	11873	9917	20180123	21790
20180206	경인선	오류동	11228	10559	20180209	21787
20180120	분당선	오리	12150	9635	20180123	21785
20180115	3호선	옥수	10658	11126	20180118	21784
20180122	5호선	둔촌동	10709	11073	20180125	21782
20180122	3호선	옥수	10670	11112	20180125	21782
20180208	9호선	김포공항	9781	11998	20180211	21779
20180212	5호선	둔촌동	10808	10948	20180215	21756
20180122	6호선	상수	10246	11507	20180125	21753
20180122	분당선	강남구청	10060	11693	20180125	21753
20180205	경부선	석수	11698	10053	20180208	21751
20180201	5호선	둔촌동	10836	10915	20180204	21751
20180118	5호선	둔촌동	10753	10995	20180121	21748
20180130	8호선	석촌	10671	11076	20180202	21747
20180122	경원선	외대앞	11054	10692	20180125	21746
20180113	7호선	남구로	10688	11032	20180116	21720
20180211	1호선	시청	11231	10487	20180214	21718
20180119	경원선	방학	11055	10661	20180122	21716
20180201	2호선	아현	11047	10666	20180204	21713
20180117	일산선	주엽	10646	11067	20180120	21713
20180113	3호선	약수	11177	10535	20180116	21712
20180126	분당선	강남구청	10029	11682	20180129	21711
20180206	3호선	동대입구	10505	11205	20180209	21710
20180114	4호선	동대문	10819	10886	20180117	21705
20180118	일산선	주엽	10716	10988	20180121	21704
20180131	경원선	외대앞	11114	10588	20180203	21702
20180113	9호선	김포공항	9515	12187	20180116	21702
20180131	경원선	방학	10990	10710	20180203	21700
20180129	7호선	상도	11130	10568	20180201	21698
20180115	분당선	강남구청	10049	11646	20180118	21695
20180124	6호선	상수	10310	11382	20180127	21692
20180205	9호선	김포공항	9479	12208	20180208	21687
20180212	경부선	명학	10764	10921	20180215	21685
20180122	경부선	명학	10782	10898	20180125	21680
20180119	7호선	굴포천	10532	11148	20180122	21680
20180130	2호선	신정네거리	10438	11240	20180202	21678
20180121	4호선	서울역	6597	15081	20180124	21678
20180124	9호선	등촌	10730	10945	20180127	21675
20180125	7호선	먹골	11023	10650	20180128	21673
20180208	2호선	신정네거리	10683	10987	20180211	21670
20180119	7호선	중곡	11202	10468	20180122	21670
20180115	일산선	주엽	10636	11033	20180118	21669
20180130	경원선	외대앞	10879	10789	20180202	21668
20180127	경부선	대방	10863	10799	20180130	21662
20180123	7호선	상도	11217	10443	20180126	21660
20180117	2호선	아현	11135	10520	20180120	21655
20180204	3호선	수서	10785	10868	20180207	21653
20180119	5호선	굽은다리(강동구민회관앞)	11047	10605	20180122	21652
20180122	9호선	김포공항	9498	12150	20180125	21648
20180208	경부선	명학	10685	10962	20180211	21647
20180113	5호선	군자(능동)	9347	12295	20180116	21642
20180207	5호선	고덕	11051	10589	20180210	21640
20180120	6호선	새절(신사)	11101	10536	20180123	21637
20180131	2호선	신정네거리	10665	10971	20180203	21636
20180113	일산선	백석	10853	10780	20180116	21633
20180118	7호선	온수(성공회대입구)	11294	10338	20180121	21632
20180208	7호선	보라매	10620	11006	20180211	21626
20180130	8호선	복정	11815	9811	20180202	21626
20180212	2호선	신정네거리	10686	10939	20180215	21625
20180118	7호선	중곡	11081	10544	20180121	21625
20180121	일산선	삼송	10835	10789	20180124	21624
20180113	경부선	독산	10757	10867	20180116	21624
20180124	7호선	먹골	10970	10651	20180127	21621
20180208	5호선	영등포시장	10429	11190	20180211	21619
20180207	2호선	아현	10878	10741	20180210	21619
20180121	경부선	노량진	11537	10077	20180124	21614
20180128	5호선	강동	11325	10286	20180131	21611
20180129	3호선	가락시장	10945	10663	20180201	21608
20180131	5호선	영등포시장	10390	11217	20180203	21607
20180129	9호선	김포공항	9696	11907	20180201	21603
20180208	5호선	둔촌동	10798	10802	20180211	21600
20180211	4호선	동대문	10778	10820	20180214	21598
20180122	7호선	중곡	11016	10582	20180125	21598
20180118	2호선	아현	10979	10617	20180121	21596
20180119	3호선	동대입구	10270	11318	20180122	21588
20180207	5호선	영등포시장	10343	11243	20180210	21586
20180203	4호선	당고개	11025	10556	20180206	21581
20180120	일산선	백석	10812	10768	20180123	21580
20180201	5호선	영등포시장	10361	11218	20180204	21579
20180112	분당선	강남구청	10014	11562	20180115	21576
20180201	3호선	일원	10631	10934	20180204	21565
20180205	공항철도 1호선	계양	11188	10374	20180208	21562
20180113	2호선	잠실나루	11111	10451	20180116	21562
20180112	경인선	오류동	11029	10533	20180115	21562
20180119	3호선	일원	10850	10709	20180122	21559
20180131	5호선	굽은다리(강동구민회관앞)	10952	10606	20180203	21558
20180115	7호선	중곡	11084	10469	20180118	21553
20180112	공항철도 1호선	계양	11217	10333	20180115	21550
20180126	9호선	등촌	10766	10783	20180129	21549
20180212	5호선	고덕	11035	10506	20180215	21541
20180129	7호선	온수(성공회대입구)	11271	10262	20180201	21533
20180127	7호선	신중동	10773	10751	20180130	21524
20180205	3호선	일원	10599	10922	20180208	21521
20180122	7호선	온수(성공회대입구)	11134	10383	20180125	21517
20180119	8호선	석촌	10570	10947	20180122	21517
20180112	3호선	동대입구	10393	11123	20180115	21516
20180207	6호선	신당	10638	10877	20180210	21515
20180130	7호선	굴포천	10323	11181	20180202	21504
20180130	일산선	주엽	10377	11126	20180202	21503
20180123	경부선	평택	11040	10462	20180126	21502
20180123	분당선	강남구청	9946	11556	20180126	21502
20180131	7호선	굴포천	10493	11003	20180203	21496
20180212	7호선	대림(구로구청)	10715	10780	20180215	21495
20180123	경부선	석수	11490	10002	20180126	21492
20180207	2호선	신정네거리	10615	10874	20180210	21489
20180203	9호선2단계	봉은사	11002	10486	20180206	21488
20180115	8호선	복정	11879	9603	20180118	21482
20180130	5호선	영등포시장	10354	11123	20180202	21477
20180129	2호선	종합운동장	9896	11581	20180201	21477
20180117	3호선	대청	11299	10171	20180120	21470
20180117	경인선	제물포	11095	10372	20180120	21467
20180207	3호선	일원	10575	10891	20180210	21466
20180117	7호선	굴포천	10395	11069	20180120	21464
20180126	7호선	상도	11186	10275	20180129	21461
20180126	2호선	아현	10951	10509	20180129	21460
20180118	7호선	대림(구로구청)	10664	10796	20180121	21460
20180201	경원선	외대앞	11010	10445	20180204	21455
20180130	6호선	봉화산(서울의료원)	10924	10531	20180202	21455
20180123	6호선	증산(명지대앞)	10915	10540	20180126	21455
20180119	7호선	대림(구로구청)	10603	10846	20180122	21449
20180212	8호선	복정	11839	9609	20180215	21448
20180130	5호선	고덕	10736	10712	20180202	21448
20180211	2호선	당산	10058	11386	20180214	21444
20180208	경원선	방학	10865	10576	20180211	21441
20180131	3호선	일원	10555	10885	20180203	21440
20180208	일산선	주엽	10530	10908	20180211	21438
20180207	경원선	석계	10075	11363	20180210	21438
20180127	9호선	김포공항	9371	12066	20180130	21437
20180114	7호선	상봉(시외버스터미널)	11130	10305	20180117	21435
20180124	경부선	남영	10355	11079	20180127	21434
20180205	6호선	상수	10124	11303	20180208	21427
20180126	3호선	가락시장	10884	10541	20180129	21425
20180118	5호선	굽은다리(강동구민회관앞)	10949	10469	20180121	21418
20180206	4호선	이촌(국립중앙박물관)	10130	11287	20180209	21417
20180121	1호선	시청	10954	10463	20180124	21417
20180114	4호선	서울역	6493	14922	20180117	21415
20180123	경인선	오류동	11088	10321	20180126	21409
20180115	2호선	신정네거리	10550	10859	20180118	21409
20180212	2호선	아현	10807	10591	20180215	21398
20180205	3호선	대청	11335	10060	20180208	21395
20180203	2호선	상왕십리	11039	10355	20180206	21394
20180131	3호선	대청	11334	10060	20180203	21394
20180128	2호선	당산	10028	11358	20180131	21386
20180206	경부선	석수	11428	9954	20180209	21382
20180118	2호선	신정네거리	10449	10930	20180121	21379
20180118	3호선	대청	11288	10083	20180121	21371
20180129	경부선	석수	11502	9864	20180201	21366
20180119	4호선	이촌(국립중앙박물관)	10137	11229	20180122	21366
20180207	경부선	명학	10590	10773	20180210	21363
20180117	5호선	굽은다리(강동구민회관앞)	10827	10534	20180120	21361
20180204	5호선	강동	11092	10258	20180207	21350
20180125	공항철도 1호선	계양	11088	10262	20180128	21350
20180127	5호선	여의도	10096	11253	20180130	21349
20180201	일산선	주엽	10581	10767	20180204	21348
20180208	7호선	굴포천	10353	10994	20180211	21347
20180113	9호선2단계	봉은사	10832	10512	20180116	21344
20180119	경부선	오산	11304	10038	20180122	21342
20180131	5호선	고덕	10991	10349	20180203	21340
20180206	3호선	대청	11288	10047	20180209	21335
20180123	9호선	김포공항	9374	11951	20180126	21325
20180117	8호선	석촌	10523	10802	20180120	21325
20180126	공항철도 1호선	계양	11094	10220	20180129	21314
20180206	3호선	옥수	10338	10965	20180209	21303
20180207	8호선	석촌	10467	10835	20180210	21302
20180120	공항철도 1호선	홍대입구	10498	10800	20180123	21298
20180118	5호선	고덕	10802	10491	20180121	21293
20180201	6호선	봉화산(서울의료원)	11049	10242	20180204	21291
20180115	3호선	일원	10399	10892	20180118	21291
20180123	3호선	가락시장	10753	10536	20180126	21289
20180212	6호선	광흥창(서강)	10679	10605	20180215	21284
20180123	2호선	아현	10811	10471	20180126	21282
20180208	경인선	제물포	10947	10331	20180211	21278
20180117	5호선	영등포시장	10191	11086	20180120	21277
20180203	3호선	약수	10908	10366	20180206	21274
20180129	7호선	중곡	10954	10319	20180201	21273
20180122	2호선	신정네거리	10433	10840	20180125	21273
20180118	경의선	일산	10774	10499	20180121	21273
20180207	경원선	외대앞	10954	10318	20180210	21272
20180201	7호선	굴포천	10423	10847	20180204	21270
20180212	일산선	주엽	10483	10786	20180215	21269
20180205	분당선	강남구청	9834	11435	20180208	21269
20180131	일산선	주엽	10481	10787	20180203	21268
20180206	공항철도 1호선	계양	11025	10242	20180209	21267
20180130	3호선	대청	11239	10028	20180202	21267
20180117	3호선	일원	10538	10729	20180120	21267
20180128	3호선	수서	10636	10630	20180131	21266
20180119	3호선	대청	11260	10004	20180122	21264
20180131	8호선	석촌	10477	10780	20180203	21257
20180115	6호선	광흥창(서강)	10775	10479	20180118	21254
20180117	경원선	방학	10738	10513	20180120	21251
20180127	7호선	어린이대공원(세종대)	10830	10420	20180130	21250
20180117	6호선	봉화산(서울의료원)	11071	10177	20180120	21248
20180120	2호선	상왕십리	11087	10160	20180123	21247
20180122	2호선	아현	10674	10565	20180125	21239
20180120	경인선	오류동	10924	10314	20180123	21238
20180122	6호선	광흥창(서강)	10641	10590	20180125	21231
20180212	7호선	굴포천	10281	10944	20180215	21225
20180206	8호선	복정	11745	9479	20180209	21224
20180127	7호선	부천시청	10607	10617	20180130	21224
20180115	5호선	영등포시장	10237	10986	20180118	21223
20180112	경원선	외대앞	10946	10276	20180115	21222
20180201	경인선	구일	10607	10611	20180204	21218
20180114	7호선	대림(구로구청)	10850	10351	20180117	21201
20180131	6호선	봉화산(서울의료원)	11131	10056	20180203	21187
20180212	5호선	영등포시장	10173	11002	20180215	21175
20180129	분당선	강남구청	9878	11293	20180201	21171
20180122	7호선	춘의	10594	10576	20180125	21170
20180205	5호선	고덕	10783	10386	20180208	21169
20180119	6호선	봉화산(서울의료원)	11110	10059	20180122	21169
20180208	6호선	신당	10378	10786	20180211	21164
20180129	6호선	증산(명지대앞)	10726	10436	20180201	21162
20180113	분당선	오리	11877	9283	20180116	21160
20180127	일산선	대화	11518	9635	20180130	21153
20180205	경부선	명학	10560	10592	20180208	21152
20180205	3호선	옥수	10280	10863	20180208	21143
20180118	5호선	영등포시장	10112	11031	20180121	21143
20180212	3호선	대청	11081	10057	20180215	21138
20180119	분당선	영통	10520	10613	20180122	21133
20180122	3호선	일원	10288	10837	20180125	21125
20180114	일산선	삼송	10493	10632	20180117	21125
20180122	7호선	대림(구로구청)	10642	10478	20180125	21120
20180124	공항철도 1호선	계양	10904	10215	20180127	21119
20180131	6호선	광흥창(서강)	10590	10528	20180203	21118
20180130	6호선	광흥창(서강)	10595	10523	20180202	21118
20180112	경부선	석수	11448	9668	20180115	21116
20180201	2호선	신정네거리	10341	10771	20180204	21112
20180117	경인선	중동	10944	10168	20180120	21112
20180115	경원선	방학	10695	10414	20180118	21109
20180115	경인선	제물포	10941	10168	20180118	21109
20180204	1호선	동묘앞	10517	10591	20180207	21108
20180201	8호선	석촌	10341	10762	20180204	21103
20180206	2호선	아현	10671	10424	20180209	21095
20180115	3호선	대청	11150	9945	20180118	21095
20180206	6호선	광흥창(서강)	10503	10591	20180209	21094
20180130	5호선	굽은다리(강동구민회관앞)	10623	10471	20180202	21094
20180115	2호선	아현	10708	10383	20180118	21091
20180208	6호선	봉화산(서울의료원)	10993	10097	20180211	21090
20180206	5호선	둔촌동	10398	10683	20180209	21081
20180118	경원선	방학	10666	10412	20180121	21078
20180204	분당선	죽전	9460	11614	20180207	21074
20180205	5호선	둔촌동	10345	10727	20180208	21072
20180204	6호선	응암	10470	10601	20180207	21071
20180119	7호선	도봉산	9875	11187	20180122	21062
20180120	6호선	석계	10663	10396	20180123	21059
20180124	경부선	금천구청	10585	10467	20180127	21052
20180211	분당선	죽전	9560	11491	20180214	21051
20180118	6호선	봉화산(서울의료원)	10985	10063	20180121	21048
20180208	8호선	석촌	10322	10723	20180211	21045
20180126	2호선	종합운동장	10172	10873	20180129	21045
20180122	5호선	고덕	10656	10387	20180125	21043
20180123	8호선	복정	11649	9384	20180126	21033
20180113	3호선	대치	11036	9987	20180116	21023
20180113	2호선	뚝섬	10464	10558	20180116	21022
20180118	7호선	굴포천	10105	10910	20180121	21015
20180127	4호선	신용산	10224	10789	20180130	21013
20180129	경원선	석계	9924	11088	20180201	21012
20180126	경부선	금천구청	10742	10267	20180129	21009
20180115	5호선	굽은다리(강동구민회관앞)	10773	10231	20180118	21004
20180205	경원선	외대앞	10686	10314	20180208	21000
20180117	7호선	보라매	10417	10580	20180120	20997
20180115	경인선	중동	10889	10107	20180118	20996
20180211	7호선	상봉(시외버스터미널)	10960	10035	20180214	20995
20180205	2호선	아현	10553	10441	20180208	20994
20180115	5호선	고덕	10647	10339	20180118	20986
20180125	경부선	금천구청	10753	10232	20180128	20985
20180204	7호선	대림(구로구청)	10675	10307	20180207	20982
20180131	3호선	동대입구	9921	11061	20180203	20982
20180205	6호선	광흥창(서강)	10489	10487	20180208	20976
20180129	6호선	상수	9868	11106	20180201	20974
20180203	5호선	군자(능동)	9077	11896	20180206	20973
20180207	경인선	제물포	10673	10292	20180210	20965
20180211	3호선	수서	10415	10549	20180214	20964
20180206	5호선	고덕	10664	10298	20180209	20962
20180117	7호선	도봉산	9653	11307	20180120	20960
20180206	경원선	외대앞	10658	10301	20180209	20959
20180119	1호선	동묘앞	10214	10743	20180122	20957
20180206	3호선	일원	10334	10622	20180209	20956
20180208	경인선	중동	10896	10058	20180211	20954
20180211	6호선	합정	11563	9388	20180214	20951
20180207	경원선	방학	10660	10289	20180210	20949
20180123	7호선	대림(구로구청)	10385	10563	20180126	20948
20180212	8호선	석촌	10277	10670	20180215	20947
20180125	7호선	상도	10769	10177	20180128	20946
20180113	공항철도 1호선	홍대입구	10108	10838	20180116	20946
20180115	7호선	굴포천	10182	10763	20180118	20945
20180112	8호선	복정	11623	9322	20180115	20945
20180201	경원선	방학	10670	10274	20180204	20944
20180131	경인선	제물포	10801	10141	20180203	20942
20180205	7호선	대림(구로구청)	10506	10435	20180208	20941
20180122	3호선	대청	11059	9878	20180125	20937
20180211	7호선	대림(구로구청)	10543	10393	20180214	20936
20180130	6호선	신당	10344	10592	20180202	20936
20180203	2호선	잠실나루	10718	10217	20180206	20935
20180127	4호선	숙대입구(갈월)	10673	10259	20180130	20932
20180118	8호선	석촌	10258	10674	20180121	20932
20180206	6호선	신당	10145	10774	20180209	20919
20180114	6호선	응암	10525	10394	20180117	20919
20180205	8호선	복정	11574	9344	20180208	20918
20180203	6호선	석계	10467	10451	20180206	20918
20180118	경인선	제물포	10848	10066	20180121	20914
20180122	경원선	방학	10711	10200	20180125	20911
20180201	3호선	동대입구	9931	10978	20180204	20909
20180122	경인선	제물포	10836	10071	20180125	20907
20180112	경원선	석계	9837	11070	20180115	20907
20180122	6호선	봉화산(서울의료원)	10853	10053	20180125	20906
20180207	5호선	굽은다리(강동구민회관앞)	10765	10136	20180210	20901
20180207	4호선	이촌(국립중앙박물관)	9965	10931	20180210	20896
20180113	경인선	오류동	10753	10142	20180116	20895
20180206	경부선	명학	10520	10374	20180209	20894
20180123	3호선	대청	11010	9884	20180126	20894
20180118	경인선	중동	10794	10081	20180121	20875
20180207	일산선	주엽	10273	10600	20180210	20873
20180126	7호선	온수(성공회대입구)	10803	10068	20180129	20871
20180122	5호선	굽은다리(강동구민회관앞)	10573	10298	20180125	20871
20180114	4호선	미아(서울사이버대학)	10870	10001	20180117	20871
20180131	경인선	중동	10809	10060	20180203	20869
20180124	분당선	강남구청	9645	11222	20180127	20867
20180130	경원선	방학	10489	10374	20180202	20863
20180205	2호선	신정네거리	10243	10618	20180208	20861
20180112	6호선	증산(명지대앞)	10773	10083	20180115	20856
20180205	7호선	굴포천	10137	10717	20180208	20854
20180123	7호선	온수(성공회대입구)	10854	9999	20180126	20853
20180113	경부선	오산	11017	9835	20180116	20852
20180122	8호선	석촌	10035	10815	20180125	20850
20180205	경원선	석계	9853	10996	20180208	20849
20180113	2호선	상왕십리	10848	10001	20180116	20849
20180123	3호선	옥수	10149	10699	20180126	20848
20180123	경부선	명학	10318	10509	20180126	20827
20180117	5호선	고덕	10650	10172	20180120	20822
20180119	경인선	부개	10825	9995	20180122	20820
20180122	7호선	굴포천	10103	10716	20180125	20819
20180112	3호선	옥수	10160	10656	20180115	20816
20180131	7호선	도봉산	9664	11147	20180203	20811
20180206	경원선	석계	9928	10878	20180209	20806
20180211	일산선	삼송	10393	10401	20180214	20794
20180117	경원선	광운대	10727	10062	20180120	20789
20180128	7호선	상봉(시외버스터미널)	10720	10068	20180131	20788
20180204	1호선	종로5가	10531	10255	20180207	20786
20180207	7호선	보라매	10203	10581	20180210	20784
20180125	2호선	종합운동장	9798	10986	20180128	20784
20180125	분당선	강남구청	9595	11189	20180128	20784
20180207	6호선	봉화산(서울의료원)	10797	9986	20180210	20783
20180127	7호선	수락산	10794	9989	20180130	20783
20180207	7호선	굴포천	10079	10703	20180210	20782
20180203	일산선	백석	10301	10480	20180206	20781
20180130	9호선2단계	언주	10564	10207	20180202	20771
20180120	4호선	이촌(국립중앙박물관)	10103	10668	20180123	20771
20180201	5호선	굽은다리(강동구민회관앞)	10765	10005	20180204	20770
20180125	경인선	오류동	10712	10056	20180128	20768
20180118	7호선	도봉산	9611	11157	20180121	20768
20180113	6호선	석계	10436	10332	20180116	20768
20180125	3호선	가락시장	10548	10219	20180128	20767
20180112	5호선	둔촌동	10192	10574	20180115	20766
20180114	공항철도 1호선	서울역	11498	9266	20180117	20764
20180204	일산선	삼송	10421	10341	20180207	20762
20180112	7호선	대림(구로구청)	10220	10534	20180115	20754
20180130	7호선	도봉산	9358	11390	20180202	20748
20180201	경인선	중동	10758	9989	20180204	20747
20180211	5호선	강동	10802	9941	20180214	20743
20180124	7호선	상도	10668	10074	20180127	20742
20180131	7호선	춘의	10472	10269	20180203	20741
20180121	2호선	신당	9963	10770	20180124	20733
20180118	3호선	동대입구	9899	10823	20180121	20722
20180205	경인선	제물포	10722	9994	20180208	20716
20180129	7호선	대림(구로구청)	10432	10283	20180201	20715
20180126	경인선	오류동	10677	10038	20180129	20715
20180206	8호선	석촌	10067	10647	20180209	20714
20180208	5호선	굽은다리(강동구민회관앞)	10638	10073	20180211	20711
20180114	6호선	합정	11284	9427	20180117	20711
20180115	8호선	석촌	10062	10644	20180118	20706
20180123	7호선	중곡	10611	10094	20180126	20705
20180204	2호선	당산	9719	10985	20180207	20704
20180123	5호선	둔촌동	10220	10484	20180126	20704
20180119	경부선	신길	11431	9267	20180122	20698
20180201	7호선	대림(구로구청)	10309	10382	20180204	20691
20180130	분당선	선정릉	10149	10535	20180202	20684
20180212	경원선	방학	10462	10217	20180215	20679
20180211	6호선	응암	10298	10380	20180214	20678
20180123	경원선	석계	9721	10956	20180126	20677
20180131	7호선	보라매	10178	10498	20180203	20676
20180129	3호선	일원	10124	10551	20180201	20675
20180208	7호선	도봉산	9515	11155	20180211	20670
20180112	7호선	온수(성공회대입구)	10722	9944	20180115	20666
20180124	경인선	오류동	10572	10093	20180127	20665
20180113	경원선	회룡	10532	10126	20180116	20658
20180122	5호선	영등포시장	9882	10772	20180125	20654
20180125	7호선	온수(성공회대입구)	10773	9880	20180128	20653
20180130	7호선	대림(구로구청)	10217	10434	20180202	20651
20180129	경부선	명학	10287	10364	20180201	20651
20180127	공항철도 1호선	서울역	10720	9931	20180130	20651
20180123	8호선	석촌	10004	10642	20180126	20646
20180122	경인선	중동	10698	9947	20180125	20645
20180115	공항철도 1호선	서울역	11271	9374	20180118	20645
20180205	7호선	보라매	10221	10423	20180208	20644
20180129	경원선	외대앞	10434	10205	20180201	20639
20180201	7호선	보라매	10201	10437	20180204	20638
20180212	6호선	봉화산(서울의료원)	10737	9900	20180215	20637
20180129	5호선	둔촌동	10137	10495	20180201	20632
20180127	분당선	수내	10693	9933	20180130	20626
20180117	경부선	신길	11387	9229	20180120	20616
20180128	6호선	합정	11289	9324	20180131	20613
20180128	4호선	동대문	10067	10543	20180131	20610
20180206	9호선	김포공항	9440	11169	20180209	20609
20180203	경원선	회룡	10463	10146	20180206	20609
20180129	3호선	옥수	10057	10552	20180201	20609
20180120	경부선	오산	10885	9724	20180123	20609
20180206	7호선	대림(구로구청)	10299	10303	20180209	20602
20180127	경인선	소사	10464	10138	20180130	20602
20180119	5호선	송정	10653	9946	20180122	20599
20180131	7호선	대림(구로구청)	10187	10410	20180203	20597
20180205	5호선	영등포시장	9917	10676	20180208	20593
20180208	7호선	대림(구로구청)	10241	10339	20180211	20580
20180115	3호선	동대입구	9765	10812	20180118	20577
20180112	경인선	제물포	10709	9868	20180115	20577
20180131	경인선	부개	10686	9888	20180203	20574
20180130	경인선	중동	10537	10037	20180202	20574
20180112	7호선	중곡	10795	9777	20180115	20572
20180126	7호선	중곡	10716	9854	20180129	20570
20180212	경인선	제물포	10680	9888	20180215	20568
20180120	7호선	공릉(서울과학기술대)	10399	10169	20180123	20568
20180201	경인선	제물포	10585	9982	20180204	20567
20180212	경인선	중동	10674	9890	20180215	20564
20180128	6호선	응암	10203	10357	20180131	20560
20180206	2호선	신정네거리	10028	10527	20180209	20555
20180130	7호선	춘의	10466	10087	20180202	20553
20180206	7호선	굴포천	9932	10619	20180209	20551
20180126	6호선	증산(명지대앞)	10649	9901	20180129	20550
20180126	5호선	둔촌동	9864	10683	20180129	20547
20180206	6호선	봉화산(서울의료원)	10648	9896	20180209	20544
20180211	4호선	서울역	6188	14354	20180214	20542
20180128	7호선	대림(구로구청)	10510	10032	20180131	20542
20180114	7호선	이수	10424	10117	20180117	20541
20180120	7호선	대림(구로구청)	9833	10705	20180123	20538
20180115	7호선	도봉산	9615	10922	20180118	20537
20180205	8호선	석촌	10037	10493	20180208	20530
20180125	2호선	한양대	10046	10478	20180128	20524
20180113	5호선	광나루(장신대)	10625	9897	20180116	20522
20180204	6호선	합정	11252	9268	20180207	20520
20180114	2호선	신당	9898	10622	20180117	20520
20180203	2호선	을지로4가	10412	10107	20180206	20519
20180117	4호선	이촌(국립중앙박물관)	9737	10778	20180120	20515
20180112	경부선	명학	10278	10219	20180115	20497
20180125	6호선	증산(명지대앞)	10437	10059	20180128	20496
20180121	5호선	아차산(어린이대공원후문)	10234	10261	20180124	20495
20180129	2호선	아현	10295	10199	20180201	20494
20180126	경원선	외대앞	10501	9993	20180129	20494
20180118	4호선	이촌(국립중앙박물관)	9684	10790	20180121	20474
20180115	6호선	봉화산(서울의료원)	10688	9786	20180118	20474
20180201	7호선	도봉산	9323	11148	20180204	20471
20180203	7호선	숭실대입구(살피재)	10363	10104	20180206	20467
20180112	7호선	굴포천	9963	10502	20180115	20465
20180127	7호선	중계	10687	9772	20180130	20459
20180206	5호선	영등포시장	9855	10596	20180209	20451
20180208	7호선	춘의	10274	10173	20180211	20447
20180121	공항철도 1호선	서울역	11371	9075	20180124	20446
20180129	5호선	고덕	10366	10077	20180201	20443
20180119	6호선	신당	10103	10337	20180122	20440
20180113	분당선	망포	11052	9384	20180116	20436
20180121	5호선	종로3가	10837	9582	20180124	20419
20180207	7호선	대림(구로구청)	10167	10251	20180210	20418
20180131	6호선	신당	10035	10383	20180203	20418
20180112	2호선	신정네거리	9983	10429	20180115	20412
20180204	4호선	서울역	6221	14189	20180207	20410
20180208	공항철도 1호선	서울역	10865	9541	20180211	20406
20180126	3호선	옥수	10003	10401	20180129	20404
20180124	7호선	중곡	10515	9889	20180127	20404
20180119	9호선2단계	언주	10172	10232	20180122	20404
20180203	6호선	새절(신사)	10399	10001	20180206	20400
20180114	7호선	사가정	10367	10031	20180117	20398
20180131	분당선	선정릉	9714	10683	20180203	20397
20180113	7호선	대림(구로구청)	9677	10717	20180116	20394
20180129	7호선	굴포천	9917	10476	20180201	20393
20180119	공항철도 1호선	검암	10203	10184	20180122	20387
20180122	7호선	도봉산	9468	10917	20180125	20385
20180121	2호선	성수	9940	10442	20180124	20382
20180129	2호선	신정네거리	9979	10402	20180201	20381
20180212	5호선	굽은다리(강동구민회관앞)	10464	9915	20180215	20379
20180118	경부선	신길	11111	9266	20180121	20377
20180113	일산선	대화	11136	9240	20180116	20376
20180124	5호선	둔촌동	9901	10469	20180127	20370
20180211	경부선	병점	9586	10782	20180214	20368
20180112	5호선	영등포시장	9734	10624	20180115	20358
20180126	8호선	복정	11340	9008	20180129	20348
20180119	7호선	보라매	10191	10152	20180122	20343
20180124	7호선	온수(성공회대입구)	10572	9769	20180127	20341
20180123	6호선	광흥창(서강)	10120	10218	20180126	20338
20180125	6호선	광흥창(서강)	10191	10142	20180128	20333
20180128	일산선	삼송	10257	10073	20180131	20330
20180129	8호선	복정	11195	9134	20180201	20329
20180206	경인선	제물포	10457	9869	20180209	20326
20180119	7호선	춘의	10372	9953	20180122	20325
20180121	4호선	미아(서울사이버대학)	10597	9727	20180124	20324
20180120	5호선	신정(은행정)	11155	9159	20180123	20314
20180208	3호선	동대입구	9727	10586	20180211	20313
20180119	공항철도 1호선	홍대입구	9813	10484	20180122	20297
20180212	9호선2단계	언주	10174	10120	20180215	20294
20180112	6호선	광흥창(서강)	10225	10069	20180115	20294
20180205	6호선	봉화산(서울의료원)	10654	9639	20180208	20293
20180129	5호선	영등포시장	9737	10556	20180201	20293
20180212	7호선	춘의	10193	10099	20180215	20292
20180207	경인선	중동	10477	9814	20180210	20291
20180128	4호선	서울역	6272	14017	20180131	20289
20180201	경인선	부개	10475	9808	20180204	20283
20180207	7호선	춘의	10190	10088	20180210	20278
20180117	7호선	춘의	10174	10099	20180120	20273
20180208	경인선	부개	10505	9761	20180211	20266
20180125	2호선	아현	10253	10013	20180128	20266
20180121	7호선	사가정	10342	9923	20180124	20265
20180118	경인선	부개	10566	9697	20180121	20263
20180127	1호선	동묘앞	9896	10366	20180130	20262
20180124	경부선	명학	9965	10297	20180127	20262
20180208	분당선	선정릉	9641	10620	20180211	20261
20180205	7호선	도봉산	9424	10833	20180208	20257
20180115	경인선	부개	10504	9748	20180118	20252
20180123	7호선	굴포천	9802	10448	20180126	20250
20180130	4호선	이촌(국립중앙박물관)	9376	10872	20180202	20248
20180130	7호선	보라매	10072	10167	20180202	20239
20180126	경부선	석수	10933	9302	20180129	20235
20180122	3호선	동대입구	9701	10528	20180125	20229
20180127	7호선	남구로	9927	10297	20180130	20224
20180118	7호선	춘의	10193	10031	20180121	20224
20180122	경인선	부개	10433	9783	20180125	20216
20180203	공항철도 1호선	홍대입구	9581	10631	20180206	20212
20180203	6호선	마포구청	10643	9567	20180206	20210
20180124	경부선	평택	10214	9996	20180127	20210
20180129	8호선	석촌	9813	10395	20180201	20208
20180206	7호선	보라매	10071	10136	20180209	20207
20180203	5호선	신정(은행정)	10995	9209	20180206	20204
20180212	7호선	보라매	10109	10094	20180215	20203
20180123	5호선	굽은다리(강동구민회관앞)	10304	9897	20180126	20201
20180115	경부선	신길	11174	9019	20180118	20193
20180117	경인선	부개	10538	9647	20180120	20185
20180205	일산선	주엽	9930	10253	20180208	20183
20180128	2호선	성수	9778	10403	20180131	20181
20180113	4호선	이촌(국립중앙박물관)	9702	10479	20180116	20181
20180124	3호선	가락시장	10327	9853	20180127	20180
20180123	3호선	일원	9876	10304	20180126	20180
20180125	7호선	중곡	10418	9758	20180128	20176
20180119	일산선	정발산	9513	10663	20180122	20176
20180125	경부선	평택	10243	9930	20180128	20173
20180201	7호선	춘의	10217	9950	20180204	20167
20180126	3호선	대청	10625	9540	20180129	20165
20180125	8호선	복정	11294	8871	20180128	20165
20180212	분당선	선정릉	9646	10518	20180215	20164
20180124	6호선	증산(명지대앞)	10287	9875	20180127	20162
20180124	7호선	대림(구로구청)	10044	10116	20180127	20160
20180120	8호선	남한산성입구(성남법원.검찰청)	10783	9376	20180123	20159
20180207	7호선	도봉산	9366	10791	20180210	20157
20180126	8호선	석촌	9797	10359	20180129	20156
20180208	9호선2단계	언주	9973	10175	20180211	20148
20180112	2호선	아현	10294	9852	20180115	20146
20180120	분당선	망포	10886	9254	20180123	20140
20180129	5호선	굽은다리(강동구민회관앞)	10282	9852	20180201	20134
20180124	8호선	복정	11233	8901	20180127	20134
20180130	경인선	부개	10349	9782	20180202	20131
20180128	2호선	신당	9691	10433	20180131	20124
20180119	경원선	신이문	10772	9351	20180122	20123
20180201	3호선	대청	10662	9459	20180204	20121
20180125	경부선	석수	10712	9409	20180128	20121
20180212	7호선	도봉산	9383	10733	20180215	20116
20180128	분당선	죽전	9218	10895	20180131	20113
20180125	5호선	둔촌동	9923	10190	20180128	20113
20180207	분당선	선정릉	9623	10486	20180210	20109
20180124	3호선	옥수	9756	10346	20180127	20102
20180129	일산선	주엽	9859	10231	20180201	20090
20180127	5호선	광나루(장신대)	10449	9641	20180130	20090
20180206	7호선	도봉산	9279	10809	20180209	20088
20180131	9호선2단계	언주	9951	10137	20180203	20088
20180125	3호선	옥수	9795	10292	20180128	20087
20180123	7호선	도봉산	9282	10800	20180126	20082
20180122	경부선	신길	10900	9182	20180125	20082
20180126	9호선2단계	언주	10080	10000	20180129	20080
20180130	경인선	제물포	10394	9685	20180202	20079
20180131	경부선	신길	11083	8995	20180203	20078
20180117	분당선	선정릉	9587	10489	20180120	20076
20180207	3호선	동대입구	9544	10527	20180210	20071
20180113	6호선	새절(신사)	10330	9735	20180116	20065
20180114	4호선	한성대입구(삼선교)	10111	9952	20180117	20063
20180112	8호선	석촌	9859	10199	20180115	20058
20180204	공항철도 1호선	서울역	10903	9154	20180207	20057
20180126	경원선	석계	9397	10658	20180129	20055
20180203	7호선	공릉(서울과학기술대)	10130	9906	20180206	20036
20180206	경원선	방학	10162	9870	20180209	20032
20180121	7호선	이수	10224	9808	20180124	20032
20180120	2호선	을지로4가	10180	9849	20180123	20029
20180112	3호선	대청	10621	9407	20180115	20028
20180112	5호선	굽은다리(강동구민회관앞)	10300	9727	20180115	20027
20180206	일산선	주엽	9821	10203	20180209	20024
20180211	4호선	숙대입구(갈월)	10189	9831	20180214	20020
20180122	7호선	보라매	9951	10067	20180125	20018
20180131	6호선	돌곶이	10374	9643	20180203	20017
20180123	3호선	동대입구	9641	10376	20180126	20017
20180126	7호선	대림(구로구청)	9926	10090	20180129	20016
20180112	분당선	영통	9957	10057	20180115	20014
20180117	6호선	신당	9879	10132	20180120	20011
20180131	경원선	신이문	10631	9371	20180203	20002
20180201	분당선	선정릉	9504	10494	20180204	19998
20180129	6호선	광흥창(서강)	10042	9956	20180201	19998
20180205	경부선	신길	11032	8963	20180208	19995
20180127	4호선	당고개	10275	9719	20180130	19994
20180120	일산선	원당	10199	9794	20180123	19993
20180125	7호선	대림(구로구청)	9922	10069	20180128	19991
20180201	경원선	신이문	10563	9426	20180204	19989
20180117	5호선	송정	10265	9724	20180120	19989
20180206	7호선	춘의	10087	9901	20180209	19988
20180120	7호선	숭실대입구(살피재)	10150	9829	20180123	19979
20180113	7호선	공릉(서울과학기술대)	10124	9852	20180116	19976
20180119	안산선	한대앞	10132	9843	20180122	19975
20180124	2호선	아현	10012	9955	20180127	19967
20180126	7호선	굴포천	9610	10355	20180129	19965
20180118	공항철도 1호선	검암	9926	10038	20180121	19964
20180127	3호선	약수	10286	9673	20180130	19959
20180129	3호선	대청	10538	9413	20180201	19951
20180124	3호선	대청	10508	9443	20180127	19951
20180123	2호선	신정네거리	9755	10193	20180126	19948
20180114	분당선	태평	10082	9857	20180117	19939
20180212	경인선	부개	10362	9576	20180215	19938
20180120	6호선	월곡(동덕여대)	10188	9737	20180123	19925
20180124	경부선	석수	10753	9171	20180127	19924
20180115	2호선	한양대	9427	10488	20180118	19915
20180122	경의선	일산	9988	9924	20180125	19912
20180207	9호선2단계	언주	9895	10014	20180210	19909
20180205	7호선	춘의	9940	9969	20180208	19909
20180128	경부선	병점	9399	10509	20180131	19908
20180123	5호선	고덕	10162	9745	20180126	19907
20180205	경원선	방학	10173	9727	20180208	19900
20180113	5호선	신정(은행정)	11000	8898	20180116	19898
20180117	경원선	신이문	10504	9391	20180120	19895
20180206	분당선	선정릉	9522	10372	20180209	19894
20180207	경원선	신이문	10516	9374	20180210	19890
20180113	8호선	남한산성입구(성남법원.검찰청)	10665	9221	20180116	19886
20180123	6호선	봉화산(서울의료원)	10381	9501	20180126	19882
20180118	경원선	신이문	10494	9381	20180121	19875
20180212	분당선	영통	9919	9955	20180215	19874
20180119	경의선	일산	10057	9817	20180122	19874
20180115	5호선	송정	10136	9737	20180118	19873
20180115	7호선	보라매	9894	9977	20180118	19871
20180205	5호선	굽은다리(강동구민회관앞)	10095	9771	20180208	19866
20180207	경인선	부개	10224	9636	20180210	19860
20180125	경원선	외대앞	10141	9715	20180128	19856
20180122	5호선	송정	10034	9817	20180125	19851
20180120	경원선	석계	9646	10197	20180123	19843
20180115	7호선	춘의	9960	9880	20180118	19840
20180125	경원선	석계	9246	10591	20180128	19837
20180119	경부선	의왕	10246	9591	20180122	19837
20180120	7호선	내방	9871	9965	20180123	19836
20180117	6호선	대흥(서강대앞)	9737	10099	20180120	19836
20180124	6호선	광흥창(서강)	9851	9980	20180127	19831
20180119	분당선	선정릉	9481	10348	20180122	19829
20180131	5호선	송정	10165	9660	20180203	19825
20180125	7호선	굴포천	9697	10127	20180128	19824
20180118	7호선	보라매	9861	9960	20180121	19821
20180125	경부선	명학	9833	9984	20180128	19817
20180125	8호선	석촌	9715	10101	20180128	19816
20180127	2호선	상왕십리	10271	9542	20180130	19813
20180117	분당선	영통	9770	10041	20180120	19811
20180205	분당선	선정릉	9466	10344	20180208	19810
20180208	경원선	신이문	10569	9235	20180211	19804
20180120	3호선	동대입구	9341	10462	20180123	19803
20180117	경의선	일산	10126	9675	20180120	19801
20180211	2호선	성수	9649	10151	20180214	19800
20180119	안산선	정왕	9710	10088	20180122	19798
20180123	5호선	영등포시장	9550	10243	20180126	19793
20180211	6호선	상수	9489	10296	20180214	19785
20180122	공항철도 1호선	서울역	10771	9003	20180125	19774
20180129	6호선	봉화산(서울의료원)	10279	9493	20180201	19772
20180207	6호선	대흥(서강대앞)	9571	10198	20180210	19769
20180130	6호선	고려대(종암)	10108	9661	20180202	19769
20180118	분당선	선정릉	9381	10388	20180121	19769
20180211	공항철도 1호선	서울역	10538	9230	20180214	19768
20180119	6호선	동묘앞	9814	9954	20180122	19768
20180126	6호선	광흥창(서강)	9865	9902	20180129	19767
20180119	일산선	마두	9702	10053	20180122	19755
20180130	경원선	신이문	10269	9485	20180202	19754
20180203	7호선	대림(구로구청)	9410	10335	20180206	19745
20180124	3호선	동대입구	9483	10256	20180127	19739
20180207	경부선	신길	10918	8818	20180210	19736
20180130	5호선	송정	9814	9919	20180202	19733
20180114	5호선	종로3가	10561	9169	20180117	19730
20180126	5호선	굽은다리(강동구민회관앞)	10157	9571	20180129	19728
20180112	경부선	오산	10385	9341	20180115	19726
20180119	안산선	고잔	10064	9661	20180122	19725
20180121	5호선	목동	9822	9898	20180124	19720
20180208	4호선	이촌(국립중앙박물관)	9399	10318	20180211	19717
20180122	경원선	신이문	10366	9350	20180125	19716
20180203	4호선	이촌(국립중앙박물관)	9507	10208	20180206	19715
20180129	7호선	도봉산	9189	10520	20180201	19709
20180205	경인선	중동	10263	9439	20180208	19702
20180122	분당선	선정릉	9449	10246	20180125	19695
20180204	4호선	동대문	9586	10103	20180207	19689
20180123	7호선	춘의	9899	9789	20180126	19688
20180211	2호선	신당	9451	10236	20180214	19687
20180128	7호선	이수	9983	9702	20180131	19685
20180118	9호선2단계	언주	9648	10037	20180121	19685
20180206	경인선	중동	10135	9548	20180209	19683
20180123	9호선2단계	언주	9828	9849	20180126	19677
20180121	7호선	수락산	9964	9713	20180124	19677
20180127	3호선	대치	10469	9206	20180130	19675
20180124	분당선	선정릉	9390	10283	20180127	19673
20180201	6호선	돌곶이	10148	9522	20180204	19670
20180114	5호선	아차산(어린이대공원후문)	9842	9828	20180117	19670
20180121	2호선	영등포구청	9768	9899	20180124	19667
20180121	1호선	신설동	10091	9568	20180124	19659
20180205	6호선	신당	9620	10038	20180208	19658
20180203	8호선	남한산성입구(성남법원.검찰청)	10493	9162	20180206	19655
20180118	5호선	송정	10053	9602	20180121	19655
20180121	8호선	암사	10119	9533	20180124	19652
20180125	3호선	대청	10338	9312	20180128	19650
20180118	6호선	신당	9547	10103	20180121	19650
20180123	분당선	선정릉	9410	10238	20180126	19648
20180211	4호선	미아(서울사이버대학)	10366	9279	20180214	19645
20180112	5호선	고덕	10044	9586	20180115	19630
20180131	경부선	의왕	10032	9596	20180203	19628
20180120	7호선	신풍	10013	9609	20180123	19622
20180124	7호선	굴포천	9495	10124	20180127	19619
20180113	7호선	숭실대입구(살피재)	10038	9577	20180116	19615
20180208	5호선	송정	9900	9712	20180211	19612
20180128	4호선	미아(서울사이버대학)	10148	9463	20180131	19611
20180125	5호선	굽은다리(강동구민회관앞)	9949	9658	20180128	19607
20180117	6호선	돌곶이	10066	9538	20180120	19604
20180201	4호선	이촌(국립중앙박물관)	9188	10415	20180204	19603
20180124	경원선	외대앞	9975	9627	20180127	19602
20180208	8호선	가락시장	9053	10548	20180211	19601
20180119	9호선	흑석(중앙대입구)	9597	10001	20180122	19598
20180208	경부선	신길	10822	8773	20180211	19595
20180124	5호선	굽은다리(강동구민회관앞)	9981	9613	20180127	19594
20180129	분당선	선정릉	9382	10207	20180201	19589
20180115	경원선	신이문	10402	9183	20180118	19585
20180212	8호선	가락시장	9067	10516	20180215	19583
20180201	6호선	신당	9541	10041	20180204	19582
20180126	2호선	신정네거리	9618	9962	20180129	19580
20180114	경부선	성균관대	9645	9932	20180117	19577
20180125	9호선2단계	언주	9632	9944	20180128	19576
20180123	경부선	신길	10767	8808	20180126	19575
20180208	6호선	대흥(서강대앞)	9482	10092	20180211	19574
20180118	공항철도 1호선	서울역	10638	8933	20180121	19571
20180205	경인선	부개	10138	9432	20180208	19570
20180201	경부선	신길	10825	8745	20180204	19570
20180204	4호선	미아(서울사이버대학)	10211	9355	20180207	19566
20180201	1호선	동묘앞	9511	10055	20180204	19566
20180123	경인선	제물포	10089	9464	20180126	19553
20180126	5호선	영등포시장	9424	10128	20180129	19552
20180119	안산선	오이도	10031	9519	20180122	19550
20180203	분당선	망포	10367	9175	20180206	19542
20180131	분당선	영통	9645	9894	20180203	19539
20180130	6호선	돌곶이	10019	9520	20180202	19539
20180113	일산선	원당	9974	9565	20180116	19539
20180130	6호선	대흥(서강대앞)	9498	10040	20180202	19538
20180122	9호선2단계	언주	9809	9721	20180125	19530
20180204	7호선	사가정	9857	9671	20180207	19528
20180117	공항철도 1호선	검암	9749	9778	20180120	19527
20180131	경의선	일산	9944	9576	20180203	19520
20180204	4호선	한성대입구(삼선교)	9836	9682	20180207	19518
20180114	분당선	한티	9777	9739	20180117	19516
20180115	경부선	오산	9835	9679	20180118	19514
20180204	경부선	병점	9197	10316	20180207	19513
20180120	7호선	군자(능동)	12445	7066	20180123	19511
20180124	8호선	석촌	9496	10013	20180127	19509
20180117	9호선2단계	언주	9740	9757	20180120	19497
20180117	일산선	정발산	9654	9841	20180120	19495
20180122	일산선	마두	9508	9983	20180125	19491
20180117	경인선	백운	9813	9674	20180120	19487
20180130	경부선	신길	10705	8781	20180202	19486
20180114	8호선	암사	10047	9438	20180117	19485
20180120	6호선	한강진	8907	10576	20180123	19483
20180212	5호선	송정	9885	9592	20180215	19477
20180207	공항철도 1호선	서울역	10460	9017	20180210	19477
20180126	경부선	명학	9681	9792	20180129	19473
20180205	9호선2단계	언주	9689	9775	20180208	19464
20180201	공항철도 1호선	서울역	10158	9306	20180204	19464
20180206	9호선2단계	언주	9674	9789	20180209	19463
20180201	9호선2단계	언주	9594	9865	20180204	19459
20180125	분당선	선정릉	9219	10238	20180128	19457
20180117	경부선	의왕	10021	9436	20180120	19457
20180204	7호선	이수	9964	9489	20180207	19453
20180113	6호선	마포구청	10316	9137	20180116	19453
20180129	경원선	방학	9887	9565	20180201	19452
20180125	5호선	영등포시장	9435	10013	20180128	19448
20180129	경인선	중동	10087	9355	20180201	19442
20180201	5호선	송정	9812	9622	20180204	19434
20180122	4호선	이촌(국립중앙박물관)	9144	10289	20180125	19433
20180115	분당선	선정릉	9213	10219	20180118	19432
20180212	경부선	신길	10747	8684	20180215	19431
20180127	2호선	잠실나루	10026	9405	20180130	19431
20180124	9호선2단계	언주	9732	9698	20180127	19430
20180124	3호선	일원	9414	10014	20180127	19428
20180114	2호선	성수	9323	10087	20180117	19410
20180126	6호선	신당	9541	9865	20180129	19406
20180123	일산선	주엽	9473	9933	20180126	19406
20180115	경의선	일산	9925	9480	20180118	19405
20180127	분당선	오리	10736	8664	20180130	19400
20180112	6호선	봉화산(서울의료원)	10183	9210	20180115	19393
20180115	4호선	이촌(국립중앙박물관)	9263	10129	20180118	19392
20180201	경의선	일산	9916	9475	20180204	19391
20180203	6호선	한강진	8777	10605	20180206	19382
20180124	경원선	석계	9066	10307	20180127	19373
20180120	6호선	마포구청	10345	9028	20180123	19373
20180115	공항철도 1호선	검암	9705	9663	20180118	19368
20180203	경부선	오산	10165	9193	20180206	19358
20180112	9호선2단계	언주	9675	9677	20180115	19352
20180112	공항철도 1호선	검암	9734	9616	20180115	19350
20180211	분당선	한티	9674	9674	20180214	19348
20180127	5호선	군자(능동)	8292	11056	20180130	19348
20180121	분당선	태평	9876	9472	20180124	19348
20180212	경원선	신이문	10324	9021	20180215	19345
20180207	6호선	돌곶이	10022	9322	20180210	19344
20180205	공항철도 1호선	서울역	10270	9071	20180208	19341
20180125	2호선	신정네거리	9431	9909	20180128	19340
20180123	7호선	보라매	9658	9682	20180126	19340
20180112	2호선	한양대	9379	9961	20180115	19340
20180119	6호선	대흥(서강대앞)	9490	9845	20180122	19335
20180120	경인선	구일	9604	9730	20180123	19334
20180112	경인선	중동	10073	9258	20180115	19331
20180129	7호선	춘의	9684	9640	20180201	19324
20180125	3호선	동대입구	9190	10134	20180128	19324
20180121	9호선	김포공항	8426	10898	20180124	19324
20180127	2호선	뚝섬	9727	9595	20180130	19322
20180119	3호선	금호	10113	9201	20180122	19314
20180112	3호선	일원	9764	9548	20180115	19312
20180208	7호선	천왕	10012	9299	20180211	19311
20180206	경인선	부개	9945	9358	20180209	19303
20180119	8호선	가락시장	8809	10490	20180122	19299
20180121	경부선	성균관대	9454	9841	20180124	19295
20180118	6호선	대흥(서강대앞)	9419	9876	20180121	19295
20180112	7호선	춘의	9813	9482	20180115	19295
20180211	7호선	이수	9876	9417	20180214	19293
20180124	7호선	춘의	9689	9601	20180127	19290
20180123	경인선	중동	10037	9250	20180126	19287
20180118	경원선	광운대	9968	9318	20180121	19286
20180126	분당선	선정릉	9185	10100	20180129	19285
20180129	경부선	신길	10657	8625	20180201	19282
20180121	4호선	한성대입구(삼선교)	9724	9558	20180124	19282
20180208	6호선	돌곶이	9977	9304	20180211	19281
20180121	9호선	당산	9885	9387	20180124	19272
20180203	경원선	외대앞	10030	9239	20180206	19269
20180128	경부선	노량진	10164	9103	20180131	19267
20180119	경인선	백운	9839	9426	20180122	19265
20180131	공항철도 1호선	검암	9609	9655	20180203	19264
20180124	6호선	봉화산(서울의료원)	10011	9253	20180127	19264
20180115	분당선	영통	9482	9779	20180118	19261
20180130	경의선	일산	9460	9799	20180202	19259
20180129	경인선	제물포	9937	9322	20180201	19259
20180208	9호선	흑석(중앙대입구)	9390	9868	20180211	19258
20180131	안산선	고잔	9745	9506	20180203	19251
20180124	2호선	신정네거리	9389	9860	20180127	19249
20180131	일산선	정발산	9414	9831	20180203	19245
20180125	3호선	일원	9456	9783	20180128	19239
20180117	일산선	마두	9408	9829	20180120	19237
20180113	7호선	군자(능동)	12348	6884	20180116	19232
20180204	분당선	태평	9758	9473	20180207	19231
20180124	6호선	신당	9399	9832	20180127	19231
20180117	6호선	고려대(종암)	9834	9385	20180120	19219
20180115	6호선	신당	9212	9999	20180118	19211
20180119	공항철도 1호선	김포공항	12062	7142	20180122	19204
20180119	경원선	광운대	10018	9185	20180122	19203
20180126	3호선	일원	9559	9643	20180129	19202
20180115	6호선	고려대(종암)	9778	9423	20180118	19201
20180113	5호선	서대문	9824	9374	20180116	19198
20180207	5호선	송정	9725	9472	20180210	19197
20180118	안산선	고잔	9740	9456	20180121	19196
20180126	6호선	봉화산(서울의료원)	10040	9149	20180129	19189
20180122	경부선	오산	9519	9669	20180125	19188
20180205	경원선	신이문	10146	9038	20180208	19184
20180118	분당선	영통	9545	9638	20180121	19183
20180128	9호선	김포공항	8294	10886	20180131	19180
20180122	공항철도 1호선	검암	9663	9516	20180125	19179
20180127	7호선	대림(구로구청)	9230	9947	20180130	19177
20180118	6호선	고려대(종암)	9716	9454	20180121	19170
20180120	3호선	녹번	10297	8869	20180123	19166
20180120	6호선	동묘앞	10032	9131	20180123	19163
20180125	6호선	봉화산(서울의료원)	9945	9217	20180128	19162
20180211	7호선	사가정	9739	9422	20180214	19161
20180119	6호선	돌곶이	9968	9192	20180122	19160
20180114	5호선	목동	9398	9761	20180117	19159
20180127	경부선	독산	9434	9723	20180130	19157
20180129	9호선2단계	언주	9529	9627	20180201	19156
20180123	2호선	한양대	9150	10006	20180126	19156
20180113	2호선	을지로4가	9803	9353	20180116	19156
20180131	6호선	고려대(종암)	9816	9338	20180203	19154
20180211	4호선	한성대입구(삼선교)	9629	9522	20180214	19151
20180204	8호선	암사	9860	9288	20180207	19148
20180208	경부선	의왕	9876	9270	20180211	19146
20180112	일산선	주엽	9399	9742	20180115	19141
20180211	경부선	노량진	10022	9114	20180214	19136
20180122	6호선	대흥(서강대앞)	9271	9865	20180125	19136
20180115	6호선	대흥(서강대앞)	9307	9828	20180118	19135
20180212	경부선	의왕	9840	9292	20180215	19132
20180204	5호선	아차산(어린이대공원후문)	9644	9487	20180207	19131
20180204	1호선	시청	9917	9211	20180207	19128
20180119	3호선	경찰병원	9592	9535	20180122	19127
20180114	분당선	정자	9249	9878	20180117	19127
20180120	7호선	먹골	9781	9344	20180123	19125
20180121	4호선	숙대입구(갈월)	9776	9348	20180124	19124
20180117	2호선	한양대	9204	9919	20180120	19123
20180118	일산선	마두	9340	9781	20180121	19121
20180201	8호선	가락시장	8724	10396	20180204	19120
20180123	경의선	일산	9705	9414	20180126	19119
20180117	경부선	오산	9695	9419	20180120	19114
20180121	5호선	장한평	9589	9524	20180124	19113
20180118	경부선	의왕	9760	9353	20180121	19113
20180201	경부선	의왕	9764	9348	20180204	19112
20180207	2호선	한양대	8911	10199	20180210	19110
20180212	공항철도 1호선	검암	9628	9479	20180215	19107
20180208	1호선	동묘앞	9372	9735	20180211	19107
20180128	7호선	사가정	9624	9479	20180131	19103
20180128	공항철도 1호선	서울역	10568	8533	20180131	19101
20180212	경부선	오산	9794	9304	20180215	19098
20180112	7호선	도봉산	8904	10192	20180115	19096
20180130	경부선	의왕	9768	9327	20180202	19095
20180212	6호선	신당	9331	9761	20180215	19092
20180122	3호선	경찰병원	9555	9535	20180125	19090
20180125	7호선	춘의	9597	9489	20180128	19086
20180207	경의선	일산	9719	9366	20180210	19085
20180119	6호선	고려대(종암)	9901	9178	20180122	19079
20180131	6호선	대흥(서강대앞)	9263	9815	20180203	19078
20180201	분당선	영통	9496	9580	20180204	19076
20180123	6호선	신당	9369	9704	20180126	19073
20180128	5호선	장한평	9537	9534	20180131	19071
20180125	5호선	고덕	9759	9308	20180128	19067
20180130	6호선	동묘앞	9464	9597	20180202	19061
20180121	경부선	오산	9051	10010	20180124	19061
20180127	일산선	백석	9544	9513	20180130	19057
20180118	경부선	오산	9695	9357	20180121	19052
20180119	2호선	한양대	8996	10055	20180122	19051
20180125	일산선	주엽	9363	9684	20180128	19047
20180115	경부선	의왕	9761	9284	20180118	19045
20180212	4호선	이촌(국립중앙박물관)	8986	10051	20180215	19037
20180203	일산선	원당	9644	9389	20180206	19033
20180114	5호선	장한평	9607	9424	20180117	19031
20180112	4호선	이촌(국립중앙박물관)	9028	10001	20180115	19029
20180203	경인선	오류동	9803	9224	20180206	19027
20180212	경의선	일산	9745	9278	20180215	19023
20180205	2호선	한양대	8908	10111	20180208	19019
20180204	2호선	신당	9189	9828	20180207	19017
20180131	7호선	천왕	9904	9111	20180203	19015
20180208	분당선	영통	9397	9617	20180211	19014
20180206	5호선	송정	9629	9385	20180209	19014
20180124	5호선	영등포시장	9100	9914	20180127	19014
20180130	3호선	금호	9458	9553	20180202	19011
20180128	9호선	당산	9845	9166	20180131	19011
20180131	5호선	명일	9172	9835	20180203	19007
20180117	공항철도 1호선	서울역	10586	8415	20180120	19001
20180203	7호선	신풍	9677	9319	20180206	18996
20180125	6호선	신당	9347	9637	20180128	18984
20180115	안산선	고잔	9794	9189	20180118	18983
20180211	5호선	종로3가	10400	8581	20180214	18981
20180205	경의선	일산	9724	9256	20180208	18980
20180115	일산선	마두	9331	9647	20180118	18978
20180130	일산선	마두	9103	9874	20180202	18977
20180212	6호선	동묘앞	9302	9672	20180215	18974
20180120	경부선	금천구청	9501	9470	20180123	18971
20180205	6호선	돌곶이	9667	9300	20180208	18967
20180129	경인선	부개	9890	9076	20180201	18966
20180205	5호선	송정	9582	9383	20180208	18965
20180208	경부선	오산	9661	9300	20180211	18961
20180128	4호선	숙대입구(갈월)	9799	9157	20180131	18956
20180203	9호선	여의도	9890	9061	20180206	18951
20180130	공항철도 1호선	검암	9483	9463	20180202	18946
20180126	7호선	춘의	9589	9357	20180129	18946
20180207	7호선	천왕	9824	9119	20180210	18943
20180131	경원선	광운대	9769	9174	20180203	18943
20180118	3호선	경찰병원	9468	9471	20180121	18939
20180115	9호선2단계	언주	9365	9574	20180118	18939
20180127	6호선	새절(신사)	9621	9317	20180130	18938
20180117	안산선	고잔	9592	9345	20180120	18937
20180121	7호선	남구로	9610	9321	20180124	18931
20180115	6호선	돌곶이	9767	9160	20180118	18927
20180112	경부선	신길	10625	8302	20180115	18927
20180211	8호선	암사	9715	9211	20180214	18926
20180125	경인선	제물포	9772	9154	20180128	18926
20180211	5호선	장한평	9476	9446	20180214	18922
20180128	4호선	한성대입구(삼선교)	9444	9470	20180131	18914
20180126	7호선	도봉산	8852	10061	20180129	18913
20180130	안산선	고잔	9714	9197	20180202	18911
20180206	경부선	신길	10498	8412	20180209	18910
20180206	6호선	대흥(서강대앞)	9139	9771	20180209	18910
20180129	7호선	보라매	9432	9477	20180201	18909
20180122	경부선	의왕	9605	9303	20180125	18908
20180211	6호선	망원	9075	9826	20180214	18901
20180115	6호선	동묘앞	9383	9516	20180118	18899
20180201	7호선	천왕	9797	9096	20180204	18893
20180128	8호선	암사	9645	9247	20180131	18892
20180212	6호선	대흥(서강대앞)	9176	9712	20180215	18888
20180203	7호선	군자(능동)	11880	7008	20180206	18888
20180119	7호선	천왕	9947	8940	20180122	18887
20180128	5호선	종로3가	10210	8675	20180131	18885
20180112	경원선	방학	9618	9265	20180115	18883
20180203	3호선	녹번	10236	8646	20180206	18882
20180120	6호선	디지털미디어시티	9191	9690	20180123	18881
20180131	3호선	금호	9883	8994	20180203	18877
20180129	3호선	동대입구	9005	9871	20180201	18876
20180208	3호선	금호	9788	9087	20180211	18875
20180118	8호선	가락시장	8748	10125	20180121	18873
20180120	9호선	여의도	9808	9063	20180123	18871
20180128	분당선	태평	9557	9303	20180131	18860
20180130	9호선	양천향교	9301	9556	20180202	18857
20180129	공항철도 1호선	서울역	10164	8692	20180201	18856
20180127	6호선	석계	9343	9511	20180130	18854
20180115	경원선	광운대	9814	9040	20180118	18854
20180201	공항철도 1호선	검암	9465	9386	20180204	18851
20180130	9호선	흑석(중앙대입구)	9111	9740	20180202	18851
20180131	경인선	백운	9583	9267	20180203	18850
20180212	3호선	동대입구	9123	9726	20180215	18849
20180128	5호선	목동	9209	9640	20180131	18849
20180212	6호선	돌곶이	9739	9103	20180215	18842
20180118	경인선	백운	9521	9318	20180121	18839
20180131	일산선	마두	9113	9722	20180203	18835
20180113	경원선	석계	9090	9745	20180116	18835
20180113	3호선	녹번	10123	8707	20180116	18830
20180201	9호선	흑석(중앙대입구)	9194	9634	20180204	18828
20180125	7호선	도봉산	8836	9992	20180128	18828
20180129	5호선	송정	9547	9280	20180201	18827
20180212	안산선	고잔	9638	9188	20180215	18826
20180114	분당선	수서	9558	9268	20180117	18826
20180208	경원선	광운대	9718	9106	20180211	18824
20180114	9호선	김포공항	8010	10810	20180117	18820
20180205	6호선	대흥(서강대앞)	9123	9693	20180208	18816
20180118	2호선	한양대	8962	9854	20180121	18816
20180130	8호선	가락시장	8638	10176	20180202	18814
20180114	1호선	신설동	9780	9033	20180117	18813
20180118	6호선	돌곶이	9769	9038	20180121	18807
20180124	7호선	도봉산	8615	10189	20180127	18804
20180123	경원선	신이문	9949	8855	20180126	18804
20180212	7호선	천왕	9732	9068	20180215	18800
20180208	2호선	한양대	8627	10168	20180211	18795
20180126	경인선	제물포	9736	9056	20180129	18792
20180123	4호선	이촌(국립중앙박물관)	8830	9960	20180126	18790
20180206	경원선	신이문	9949	8839	20180209	18788
20180114	7호선	수락산	9502	9283	20180117	18785
20180112	경인선	부개	9884	8900	20180115	18784
20180114	4호선	숙대입구(갈월)	9714	9068	20180117	18782
20180117	9호선	흑석(중앙대입구)	9094	9683	20180120	18777
20180119	5호선	명일	9200	9576	20180122	18776
20180201	6호선	동묘앞	9303	9470	20180204	18773
20180201	5호선	명일	9190	9582	20180204	18772
20180114	경부선	오산	8868	9902	20180117	18770
20180212	3호선	경찰병원	9398	9371	20180215	18769
20180212	9호선	흑석(중앙대입구)	9113	9653	20180215	18766
20180121	2호선	방배	9257	9503	20180124	18760
20180130	공항철도 1호선	서울역	10296	8463	20180202	18759
20180119	과천선	선바위	10457	8295	20180122	18752
20180122	안산선	고잔	9650	9096	20180125	18746
20180124	7호선	보라매	9323	9419	20180127	18742
20180131	9호선	양천향교	9239	9502	20180203	18741
20180206	2호선	한양대	8727	10013	20180209	18740
20180120	5호선	서대문	9591	9149	20180123	18740
20180117	9호선	양천향교	9298	9441	20180120	18739
20180115	경인선	백운	9538	9198	20180118	18736
20180204	5호선	장한평	9435	9298	20180207	18733
20180212	경원선	광운대	9649	9083	20180215	18732
20180207	일산선	정발산	9209	9519	20180210	18728
20180112	분당선	선정릉	8840	9887	20180115	18727
20180131	공항철도 1호선	서울역	10311	8415	20180203	18726
20180207	분당선	영통	9256	9469	20180210	18725
20180123	공항철도 1호선	검암	9402	9321	20180126	18723
20180122	6호선	돌곶이	9630	9093	20180125	18723
20180130	3호선	경찰병원	9287	9432	20180202	18719
20180126	공항철도 1호선	검암	9354	9361	20180129	18715
20180118	안산선	한대앞	9486	9229	20180121	18715
20180207	5호선	명일	9021	9693	20180210	18714
20180203	6호선	디지털미디어시티	9074	9639	20180206	18713
20180123	경원선	방학	9485	9226	20180126	18711
20180117	8호선	가락시장	8690	10021	20180120	18711
20180126	일산선	주엽	9152	9557	20180129	18709
20180121	분당선	한티	9462	9247	20180124	18709
20180126	5호선	고덕	9565	9143	20180129	18708
20180112	6호선	신당	9184	9521	20180115	18705
20180212	경인선	백운	9467	9235	20180215	18702
20180208	공항철도 1호선	검암	9434	9267	20180211	18701
20180207	9호선	흑석(중앙대입구)	9062	9636	20180210	18698
20180203	7호선	마들	9826	8865	20180206	18691
20180117	7호선	천왕	9771	8920	20180120	18691
20180204	4호선	숙대입구(갈월)	9581	9109	20180207	18690
20180123	6호선	대흥(서강대앞)	9060	9625	20180126	18685
20180129	경원선	신이문	9897	8784	20180201	18681
20180114	7호선	남구로	9501	9178	20180117	18679
20180124	5호선	고덕	9527	9149	20180127	18676
20180130	5호선	행당	9536	9138	20180202	18674
20180117	3호선	금호	9693	8980	20180120	18673
20180207	3호선	금호	9608	9063	20180210	18671
20180207	경부선	의왕	9534	9134	20180210	18668
20180211	5호선	목동	9199	9467	20180214	18666
20180127	공항철도 1호선	홍대입구	9012	9652	20180130	18664
20180121	7호선	신대방삼거리	9346	9314	20180124	18660
20180114	7호선	면목	9345	9311	20180117	18656
20180130	5호선	명일	8882	9772	20180202	18654
20180117	안산선	한대앞	9454	9191	20180120	18645
20180117	5호선	명일	9012	9631	20180120	18643
20180201	6호선	대흥(서강대앞)	9015	9625	20180204	18640
20180113	7호선	내방	9308	9328	20180116	18636
20180113	7호선	먹골	9522	9114	20180116	18636
20180211	9호선	당산	9598	9028	20180214	18626
20180121	중앙선	구리	9024	9602	20180124	18626
20180204	5호선	목동	9256	9369	20180207	18625
20180127	5호선	신정(은행정)	10122	8498	20180130	18620
20180201	3호선	금호	9641	8978	20180204	18619
20180203	7호선	먹골	9481	9136	20180206	18617
20180131	9호선	신방화	9362	9249	20180203	18611
20180126	분당선	영통	9226	9382	20180129	18608
20180122	2호선	한양대	8844	9762	20180125	18606
20180207	공항철도 1호선	검암	9391	9204	20180210	18595
20180130	경원선	광운대	9531	9064	20180202	18595
20180125	7호선	보라매	9259	9335	20180128	18594
20180113	7호선	신풍	9440	9154	20180116	18594
20180114	2호선	방배	9203	9388	20180117	18591
20180131	8호선	가락시장	8546	10040	20180203	18586
20180211	경부선	성균관대	9198	9376	20180214	18574
20180124	경인선	중동	9614	8960	20180127	18574
20180206	공항철도 1호선	서울역	9912	8658	20180209	18570
20180124	경인선	제물포	9531	9036	20180127	18567
20180212	3호선	금호	9595	8965	20180215	18560
20180128	분당선	한티	9313	9247	20180131	18560
20180211	분당선	태평	9391	9168	20180214	18559
20180204	7호선	남구로	9318	9241	20180207	18559
20180201	2호선	한양대	8743	9815	20180204	18558
20180122	분당선	영통	9088	9461	20180125	18549
20180201	경원선	광운대	9637	8909	20180204	18546
20180120	7호선	마들	9723	8823	20180123	18546
20180118	3호선	금호	9632	8912	20180121	18544
20180129	공항철도 1호선	검암	9368	9170	20180201	18538
20180208	3호선	경찰병원	9266	9268	20180211	18534
20180117	3호선	경찰병원	9277	9248	20180120	18525
20180206	6호선	돌곶이	9556	8966	20180209	18522
20180120	경원선	외대앞	9573	8947	20180123	18520
20180123	3호선	경찰병원	9231	9280	20180126	18511
20180208	5호선	행당	9800	8709	20180211	18509
20180130	분당선	영통	9110	9399	20180202	18509
20180113	7호선	마들	9621	8887	20180116	18508
20180204	분당선	한티	9367	9140	20180207	18507
20180208	6호선	고려대(종암)	9315	9190	20180211	18505
20180112	경원선	신이문	9934	8567	20180115	18501
20180118	7호선	천왕	9684	8811	20180121	18495
20180115	9호선	흑석(중앙대입구)	8908	9586	20180118	18494
20180205	경부선	의왕	9389	9104	20180208	18493
20180208	6호선	동묘앞	9079	9412	20180211	18491
20180131	9호선	흑석(중앙대입구)	8955	9536	20180203	18491
20180121	7호선	면목	9317	9174	20180124	18491
20180122	경원선	광운대	9496	8992	20180125	18488
20180123	공항철도 1호선	서울역	10204	8281	20180126	18485
20180208	9호선	양천향교	9113	9369	20180211	18482
20180113	5호선	마포	9123	9357	20180116	18480
20180117	1호선	동묘앞	9045	9434	20180120	18479
20180204	2호선	방배	9066	9411	20180207	18477
20180204	2호선	성수	8944	9520	20180207	18464
20180131	3호선	경찰병원	9191	9273	20180203	18464
20180128	경부선	성균관대	9159	9305	20180131	18464
20180126	4호선	이촌(국립중앙박물관)	8637	9827	20180129	18464
20180131	5호선	행당	9847	8616	20180203	18463
20180126	경원선	방학	9399	9059	20180129	18458
20180121	분당선	정자	9063	9395	20180124	18458
20180118	9호선	흑석(중앙대입구)	9002	9452	20180121	18454
20180212	2호선	한양대	8673	9778	20180215	18451
20180204	2호선	영등포구청	9123	9327	20180207	18450
20180203	7호선	내방	9208	9242	20180206	18450
20180122	5호선	명일	8818	9632	20180125	18450
20180205	7호선	천왕	9575	8874	20180208	18449
20180212	일산선	마두	9045	9402	20180215	18447
20180115	3호선	경찰병원	9185	9261	20180118	18446
20180131	2호선	한양대	8584	9860	20180203	18444
20180128	5호선	아차산(어린이대공원후문)	9315	9127	20180131	18442
20180208	5호선	명일	9015	9426	20180211	18441
20180123	5호선	송정	9363	9076	20180126	18439
20180207	6호선	동묘앞	9104	9332	20180210	18436
20180112	7호선	보라매	9231	9205	20180115	18436
20180113	6호선	월곡(동덕여대)	9413	9020	20180116	18433
20180125	경인선	중동	9656	8776	20180128	18432
20180129	6호선	신당	8941	9490	20180201	18431
20180122	6호선	신당	8919	9508	20180125	18427
20180122	3호선	금호	9446	8980	20180125	18426
20180130	7호선	천왕	9475	8948	20180202	18423
20180123	경인선	부개	9517	8901	20180126	18418
20180119	9호선	양천향교	9246	9172	20180122	18418
20180201	6호선	고려대(종암)	9309	9108	20180204	18417
20180125	공항철도 1호선	서울역	9850	8563	20180128	18413
20180114	3호선	동대입구	8734	9675	20180117	18409
20180204	분당선	수서	9297	9111	20180207	18408
20180126	경인선	중동	9602	8806	20180129	18408
20180112	9호선	흑석(중앙대입구)	8990	9418	20180115	18408
20180203	6호선	월곡(동덕여대)	9343	9062	20180206	18405
20180208	경인선	백운	9363	9040	20180211	18403
20180208	일산선	마두	8995	9408	20180211	18403
20180127	경원선	회룡	9334	9067	20180130	18401
20180128	7호선	신대방삼거리	9292	9106	20180131	18398
20180204	9호선	당산	9499	8898	20180207	18397
20180122	경인선	백운	9199	9198	20180125	18397
20180126	7호선	보라매	9209	9181	20180129	18390
20180118	6호선	동묘앞	9067	9318	20180121	18385
20180205	9호선	흑석(중앙대입구)	8814	9568	20180208	18382
20180122	공항철도 1호선	김포공항	10769	7612	20180125	18381
20180117	공항철도 1호선	홍대입구	9155	9222	20180120	18377
20180122	6호선	고려대(종암)	9264	9108	20180125	18372
20180129	6호선	돌곶이	9438	8928	20180201	18366
20180115	안산선	한대앞	9264	9101	20180118	18365
20180114	중앙선	구리	9006	9353	20180117	18359
20180206	경부선	의왕	9371	8982	20180209	18353
20180201	일산선	마두	9021	9330	20180204	18351
20180113	분당선	영통	9178	9173	20180116	18351
20180119	5호선	행당	9823	8527	20180122	18350
20180131	경부선	오산	9441	8908	20180203	18349
20180122	7호선	천왕	9529	8818	20180125	18347
20180131	6호선	동묘앞	9074	9271	20180203	18345
20180207	9호선	양천향교	9054	9289	20180210	18343
20180117	5호선	행당	9721	8614	20180120	18335
20180208	안산선	고잔	9411	8921	20180211	18332
20180206	경의선	일산	9186	9146	20180209	18332
20180124	일산선	주엽	8956	9372	20180127	18328
20180118	5호선	명일	8893	9429	20180121	18322
20180127	경부선	오산	9599	8721	20180130	18320
20180120	일산선	정발산	8659	9659	20180123	18318
20180113	6호선	안암(고대병원앞)	9182	9135	20180116	18317
20180130	중앙선	도농	9463	8852	20180202	18315
20180207	8호선	가락시장	8340	9974	20180210	18314
20180201	경인선	백운	9333	8981	20180204	18314
20180129	6호선	동묘앞	9002	9311	20180201	18313
20180118	공항철도 1호선	홍대입구	8977	9334	20180121	18311
20180115	9호선	양천향교	9098	9206	20180118	18304
20180205	6호선	고려대(종암)	9158	9142	20180208	18300
20180205	3호선	경찰병원	9145	9155	20180208	18300
20180201	안산선	고잔	9334	8966	20180204	18300
20180207	경원선	광운대	9493	8802	20180210	18295
20180205	3호선	동대입구	8906	9384	20180208	18290
20180124	공항철도 1호선	서울역	9845	8445	20180127	18290
20180126	경부선	오산	9695	8588	20180129	18283
20180117	6호선	동묘앞	9037	9245	20180120	18282
20180115	3호선	금호	9457	8825	20180118	18282
20180118	일산선	정발산	8896	9381	20180121	18277
20180211	9호선	김포공항	7767	10508	20180214	18275
20180126	공항철도 1호선	김포공항	11560	6714	20180129	18274
20180125	경원선	신이문	9661	8612	20180128	18273
20180212	5호선	명일	8925	9346	20180215	18271
20180112	5호선	송정	9536	8730	20180115	18266
20180127	6호선	마포구청	9790	8475	20180130	18265
20180125	4호선	이촌(국립중앙박물관)	8629	9632	20180128	18261
20180125	공항철도 1호선	검암	9177	9076	20180128	18253
20180130	1호선	동묘앞	8978	9272	20180202	18250
20180127	분당선	망포	9735	8505	20180130	18240
20180115	5호선	명일	8850	9387	20180118	18237
20180211	5호선	아차산(어린이대공원후문)	9238	8993	20180214	18231
20180113	경부선	금천구청	9236	8994	20180116	18230
20180207	경인선	백운	9162	9067	20180210	18229
20180201	5호선	행당	9637	8590	20180204	18227
20180128	2호선	방배	8987	9231	20180131	18218
20180206	7호선	천왕	9405	8810	20180209	18215
20180203	3호선	동대입구	8721	9492	20180206	18213
20180121	7호선	상동	9185	9027	20180124	18212
20180122	8호선	가락시장	8439	9772	20180125	18211
20180130	9호선	신방화	9074	9135	20180202	18209
20180204	9호선	김포공항	7733	10474	20180207	18207
20180201	9호선	양천향교	9021	9186	20180204	18207
20180206	5호선	명일	8843	9358	20180209	18201
20180118	9호선	양천향교	9041	9158	20180121	18199
20180201	3호선	경찰병원	9075	9114	20180204	18189
20180208	중앙선	도농	9603	8584	20180211	18187
20180114	9호선	당산	9382	8804	20180117	18186
20180122	9호선	흑석(중앙대입구)	8709	9473	20180125	18182
20180127	7호선	공릉(서울과학기술대)	9149	9027	20180130	18176
20180119	중앙선	도농	9710	8460	20180122	18170
20180211	2호선	방배	8911	9254	20180214	18165
20180121	6호선	망원	8709	9451	20180124	18160
20180212	9호선	양천향교	9018	9141	20180215	18159
20180115	7호선	천왕	9402	8747	20180118	18149
20180125	6호선	돌곶이	9340	8807	20180128	18147
20180130	일산선	정발산	8908	9238	20180202	18146
20180119	9호선	신방화	9214	8932	20180122	18146
20180113	6호선	디지털미디어시티	8955	9191	20180116	18146
20180117	안산선	오이도	9175	8970	20180120	18145
20180123	6호선	고려대(종암)	9162	8981	20180126	18143
20180122	안산선	한대앞	9114	9028	20180125	18142
20180205	4호선	이촌(국립중앙박물관)	8542	9597	20180208	18139
20180118	공항철도 1호선	김포공항	10888	7250	20180121	18138
20180112	공항철도 1호선	홍대입구	8637	9500	20180115	18137
20180203	5호선	영등포시장	8655	9479	20180206	18134
20180120	7호선	중화	9448	8686	20180123	18134
20180125	경원선	방학	9246	8887	20180128	18133
20180211	분당선	정자	8875	9248	20180214	18123
20180131	공항철도 1호선	홍대입구	8807	9316	20180203	18123
20180114	경인선	소사	9220	8903	20180117	18123
20180203	경원선	석계	8707	9415	20180206	18122
20180205	6호선	동묘앞	8790	9331	20180208	18121
20180124	경원선	방학	9265	8856	20180127	18121
20180119	경원선	양주	9695	8423	20180122	18118
20180207	일산선	마두	8851	9266	20180210	18117
20180211	7호선	면목	9091	9022	20180214	18113
20180121	2호선	을지로3가	9199	8912	20180124	18111
20180206	3호선	금호	9365	8744	20180209	18109
20180127	8호선	남한산성입구(성남법원.검찰청)	9729	8377	20180130	18106
20180201	9호선	신방화	9195	8907	20180204	18102
20180204	분당선	정자	8785	9310	20180207	18095
20180120	3호선	종로3가	6583	11511	20180123	18094
20180127	7호선	숭실대입구(살피재)	9182	8905	20180130	18087
20180203	일산선	정발산	8658	9427	20180206	18085
20180129	경의선	일산	9233	8851	20180201	18084
20180204	경부선	노량진	9524	8557	20180207	18081
20180119	5호선	길동	8774	9306	20180122	18080
20180117	5호선	마곡	9686	8390	20180120	18076
20180131	5호선	길동	8823	9252	20180203	18075
20180207	5호선	행당	9502	8569	20180210	18071
20180207	경부선	오산	9188	8882	20180210	18070
20180119	7호선	태릉입구	9479	8591	20180122	18070
20180124	경부선	신길	10052	8017	20180127	18069
20180123	경부선	의왕	9215	8854	20180126	18069
20180122	9호선	양천향교	8968	9100	20180125	18068
20180205	공항철도 1호선	검암	9130	8934	20180208	18064
20180205	3호선	금호	9295	8769	20180208	18064
20180131	과천선	선바위	9801	8260	20180203	18061
20180128	경부선	오산	8428	9632	20180131	18060
20180126	5호선	송정	9231	8829	20180129	18060
20180121	경인선	소사	9235	8822	20180124	18057
20180206	공항철도 1호선	검암	9110	8943	20180209	18053
20180114	7호선	상동	9099	8954	20180117	18053
20180203	3호선	종로3가	6549	11502	20180206	18051
20180126	6호선	동묘앞	8894	9148	20180129	18042
20180130	경인선	백운	9058	8981	20180202	18039
20180112	6호선	고려대(종암)	9191	8846	20180115	18037
20180131	1호선	동묘앞	8788	9248	20180203	18036
20180130	2호선	한양대	8815	9220	20180202	18035
20180126	경원선	신이문	9610	8425	20180129	18035
20180122	5호선	행당	9406	8629	20180125	18035
20180208	안산선	한대앞	9068	8966	20180211	18034
20180207	3호선	경찰병원	9033	9000	20180210	18033
20180113	7호선	장승배기	9263	8768	20180116	18031
20180205	경원선	광운대	9219	8801	20180208	18020
20180119	중앙선	망우	9092	8928	20180122	18020
20180205	일산선	마두	8824	9186	20180208	18010
20180115	8호선	가락시장	8226	9783	20180118	18009
20180201	경부선	오산	9107	8901	20180204	18008
20180117	과천선	선바위	9832	8174	20180120	18006
20180128	1호선	신설동	9082	8923	20180131	18005
20180118	1호선	동묘앞	8730	9275	20180121	18005
20180212	6호선	고려대(종암)	9132	8872	20180215	18004
20180115	1호선	동묘앞	8778	9225	20180118	18003
20180205	5호선	명일	8682	9316	20180208	17998
20180119	5호선	마곡	9866	8132	20180122	17998
20180118	과천선	선바위	9799	8198	20180121	17997
20180203	7호선	중화	9177	8819	20180206	17996
20180130	5호선	애오개	8747	9248	20180202	17995
20180123	6호선	돌곶이	9258	8737	20180126	17995
20180113	5호선	영등포시장	8696	9299	20180116	17995
20180129	7호선	천왕	9299	8695	20180201	17994
20180113	9호선	여의도	9240	8754	20180116	17994
20180122	안산선	오이도	9207	8786	20180125	17993
20180129	경부선	의왕	9180	8811	20180201	17991
20180112	6호선	동묘앞	8891	9098	20180115	17989
20180129	경부선	오산	9007	8980	20180201	17987
20180203	7호선	장승배기	9257	8727	20180206	17984
20180129	6호선	대흥(서강대앞)	8733	9251	20180201	17984
20180131	중앙선	도농	9572	8407	20180203	17979
20180118	5호선	행당	9510	8469	20180121	17979
20180129	분당선	영통	8818	9153	20180201	17971
20180124	경원선	신이문	9469	8502	20180127	17971
20180208	공항철도 1호선	홍대입구	8829	9140	20180211	17969
20180124	4호선	이촌(국립중앙박물관)	8434	9535	20180127	17969
20180211	7호선	신대방삼거리	9042	8923	20180214	17965
20180112	6호선	돌곶이	9297	8665	20180115	17962
20180122	6호선	동묘앞	8876	9083	20180125	17959
20180120	8호선	단대오거리	9347	8609	20180123	17956
20180212	안산선	한대앞	9170	8781	20180215	17951
20180207	6호선	고려대(종암)	9137	8814	20180210	17951
20180206	5호선	행당	9431	8518	20180209	17949
20180212	5호선	행당	9478	8470	20180215	17948
20180204	6호선	상수	8563	9383	20180207	17946
20180124	공항철도 1호선	검암	9010	8935	20180127	17945
20180208	과천선	선바위	9833	8111	20180211	17944
20180203	5호선	서대문	9128	8816	20180206	17944
20180212	1호선	동묘앞	8806	9134	20180215	17940
20180211	7호선	어린이대공원(세종대)	9111	8826	20180214	17937
20180129	안산선	고잔	9255	8674	20180201	17929
20180206	6호선	고려대(종암)	9063	8865	20180209	17928
20180120	7호선	장승배기	9181	8741	20180123	17922
20180117	중앙선	도농	9497	8424	20180120	17921
20180128	7호선	면목	8975	8939	20180131	17914
20180121	분당선	수서	9005	8909	20180124	17914
20180130	과천선	선바위	9842	8069	20180202	17911
20180211	2호선	영등포구청	8862	9048	20180214	17910
20180205	분당선	영통	8804	9106	20180208	17910
20180129	3호선	경찰병원	8870	9039	20180201	17909
20180128	7호선	남구로	9090	8812	20180131	17902
20180208	일산선	정발산	8718	9179	20180211	17897
20180130	5호선	길동	8574	9322	20180202	17896
20180121	5호선	답십리	9345	8549	20180124	17894
20180130	5호선	마곡	9729	8163	20180202	17892
20180120	5호선	마포	8939	8944	20180123	17883
20180125	경부선	신길	9839	8043	20180128	17882
20180117	9호선	신방화	9025	8856	20180120	17881
20180112	일산선	정발산	8512	9362	20180115	17874
20180123	분당선	영통	8864	9008	20180126	17872
20180117	5호선	길동	8647	9222	20180120	17869
20180112	6호선	대흥(서강대앞)	8832	9035	20180115	17867
20180123	9호선	양천향교	8836	9028	20180126	17864
20180204	7호선	상동	9047	8816	20180207	17863
20180211	7호선	남구로	9080	8776	20180214	17856
20180126	6호선	대흥(서강대앞)	8700	9154	20180129	17854
20180205	5호선	행당	9346	8507	20180208	17853
20180129	경인선	백운	9068	8785	20180201	17853
20180115	공항철도 1호선	홍대입구	9061	8792	20180118	17853
20180201	공항철도 1호선	홍대입구	8598	9253	20180204	17851
20180129	일산선	마두	8810	9041	20180201	17851
20180126	경부선	신길	9958	7890	20180129	17848
20180125	경인선	부개	9310	8532	20180128	17842
20180206	9호선	신방화	8913	8927	20180209	17840
20180125	공항철도 1호선	김포공항	10933	6906	20180128	17839
20180204	5호선	종로3가	9803	8034	20180207	17837
20180120	6호선	안암(고대병원앞)	8988	8842	20180123	17830
20180206	9호선	흑석(중앙대입구)	8639	9188	20180209	17827
20180204	경부선	성균관대	8758	9065	20180207	17823
20180131	5호선	애오개	8950	8870	20180203	17820
20180204	7호선	면목	8925	8891	20180207	17816
20180121	과천선	정부과천청사	9262	8553	20180124	17815
20180131	안산선	한대앞	8948	8865	20180203	17813
20180206	경원선	광운대	9197	8614	20180209	17811
20180124	6호선	돌곶이	9138	8673	20180127	17811
20180122	일산선	정발산	8825	8983	20180125	17808
20180118	9호선	신방화	8928	8877	20180121	17805
20180206	6호선	동묘앞	8800	9004	20180209	17804
20180129	경원선	광운대	9141	8663	20180201	17804
20180115	공항철도 1호선	김포공항	10387	7414	20180118	17801
20180212	일산선	정발산	8707	9093	20180215	17800
20180211	7호선	청담	8541	9259	20180214	17800
20180201	일산선	정발산	8603	9195	20180204	17798
20180212	9호선	증미	8655	9140	20180215	17795
20180113	3호선	동대입구	8412	9377	20180116	17789
20180123	안산선	고잔	9100	8688	20180126	17788
20180115	9호선	신방화	8960	8828	20180118	17788
20180121	9호선	염창	9088	8698	20180124	17786
20180127	7호선	먹골	8975	8809	20180130	17784
20180130	공항철도 1호선	홍대입구	8803	8975	20180202	17778
20180112	경부선	의왕	9179	8599	20180115	17778
20180206	3호선	경찰병원	8852	8922	20180209	17774
20180114	6호선	망원	8622	9146	20180117	17768
20180205	경인선	백운	8957	8810	20180208	17767
20180130	9호선	증미	8873	8893	20180202	17766
20180122	안산선	정왕	8384	9381	20180125	17765
20180204	7호선	신대방삼거리	8910	8854	20180207	17764
20180206	8호선	가락시장	8217	9541	20180209	17758
20180205	9호선	신방화	8889	8869	20180208	17758
20180115	5호선	마곡	9544	8210	20180118	17754
20180121	2호선	종합운동장	8147	9602	20180124	17749
20180212	과천선	선바위	9716	8032	20180215	17748
20180114	2호선	을지로3가	9036	8711	20180117	17747
20180117	경부선	화서	9025	8720	20180120	17745
20180206	분당선	영통	8833	8910	20180209	17743
20180130	안산선	한대앞	8935	8806	20180202	17741
20180208	안산선	오이도	8931	8809	20180211	17740
20180115	중앙선	도농	9405	8330	20180118	17735
20180119	경부선	화서	8990	8744	20180122	17734
20180112	공항철도 1호선	김포공항	10805	6925	20180115	17730
20180207	안산선	고잔	9051	8676	20180210	17727
20180131	공항철도 1호선	김포공항	10539	7186	20180203	17725
20180122	중앙선	도농	9418	8307	20180125	17725
20180119	5호선	애오개	8898	8824	20180122	17722
20180117	공항철도 1호선	김포공항	10458	7263	20180120	17721
20180130	공항철도 1호선	김포공항	10888	6828	20180202	17716
20180114	2호선	영등포구청	8848	8868	20180117	17716
20180118	안산선	오이도	8974	8740	20180121	17714
20180205	8호선	가락시장	8167	9545	20180208	17712
20180211	과천선	정부과천청사	9185	8523	20180214	17708
20180207	9호선	신방화	8939	8768	20180210	17707
20180207	과천선	선바위	9745	7962	20180210	17707
20180120	7호선	남성	9286	8415	20180123	17701
20180123	9호선	흑석(중앙대입구)	8564	9131	20180126	17695
20180120	5호선	공덕	8698	8996	20180123	17694
20180120	5호선	영등포시장	8436	9256	20180123	17692
20180126	경인선	부개	9240	8445	20180129	17685
20180207	1호선	동묘앞	8659	9025	20180210	17684
20180125	6호선	대흥(서강대앞)	8606	9077	20180128	17683
20180212	5호선	길동	8597	9082	20180215	17679
20180114	7호선	신대방삼거리	8933	8745	20180117	17678
20180131	5호선	마곡	9444	8230	20180203	17674
20180118	중앙선	도농	9396	8277	20180121	17673
20180208	3호선	독립문	8782	8887	20180211	17669
20180112	경의선	일산	9039	8630	20180115	17669
20180129	9호선	흑석(중앙대입구)	8520	9148	20180201	17668
20180115	일산선	정발산	8698	8970	20180118	17668
20180201	과천선	선바위	9637	8030	20180204	17667
20180113	일산선	정발산	8377	9287	20180116	17664
20180113	7호선	남성	9215	8447	20180116	17662
20180128	분당선	수서	8976	8685	20180131	17661
20180128	분당선	정자	8579	9080	20180131	17659
20180129	2호선	한양대	8136	9516	20180201	17652
20180115	5호선	행당	9358	8293	20180118	17651
20180120	6호선	녹사평(용산구청)	8104	9546	20180123	17650
20180211	2호선	을지로3가	8983	8664	20180214	17647
20180118	5호선	길동	8605	9038	20180121	17643
20180211	1호선	신설동	9046	8596	20180214	17642
20180113	6호선	동묘앞	9203	8439	20180116	17642
20180122	9호선	신방화	8854	8784	20180125	17638
20180123	5호선	명일	8523	9114	20180126	17637
20180120	경부선	석수	9311	8326	20180123	17637
20180201	공항철도 1호선	김포공항	10725	6911	20180204	17636
20180131	분당선	서울숲	8821	8815	20180203	17636
20180122	5호선	길동	8562	9074	20180125	17636
20180121	7호선	중계	9097	8539	20180124	17636
20180208	5호선	길동	8630	9005	20180211	17635
20180205	9호선	양천향교	8761	8873	20180208	17634
20180201	중앙선	도농	9407	8224	20180204	17631
20180117	안산선	정왕	8430	9201	20180120	17631
20180203	7호선	남성	9041	8588	20180206	17629
20180122	경원선	양주	9361	8266	20180125	17627
20180207	5호선	길동	8559	9067	20180210	17626
20180127	7호선	군자(능동)	11147	6478	20180130	17625
20180206	9호선	양천향교	8623	8999	20180209	17622
20180124	6호선	대흥(서강대앞)	8606	9011	20180127	17617
20180122	5호선	마곡	9478	8139	20180125	17617
20180125	분당선	영통	8744	8871	20180128	17615
20180203	경부선	금천구청	8893	8718	20180206	17611
20180124	경인선	부개	9130	8472	20180127	17602
20180115	과천선	선바위	9680	7921	20180118	17601
20180128	6호선	망원	8594	9005	20180131	17599
20180126	공항철도 1호선	홍대입구	8205	9394	20180129	17599
20180205	경부선	오산	8878	8714	20180208	17592
20180208	공항철도 1호선	김포공항	10770	6821	20180211	17591
20180121	7호선	청담	8428	9163	20180124	17591
20180207	안산선	한대앞	8833	8757	20180210	17590
20180119	3호선	독립문	8786	8803	20180122	17589
20180123	안산선	한대앞	8956	8632	20180126	17588
20180121	4호선	당고개	8845	8743	20180124	17588
20180117	경부선	관악	9029	8557	20180120	17586
20180126	5호선	행당	9399	8183	20180129	17582
20180206	안산선	고잔	9037	8540	20180209	17577
20180129	공항철도 1호선	김포공항	10621	6956	20180201	17577
20180211	7호선	수락산	8920	8656	20180214	17576
20180124	2호선	한양대	8484	9088	20180127	17572
20180119	5호선	여의나루	8520	9052	20180122	17572
20180204	4호선	당고개	8887	8682	20180207	17569
20180120	분당선	영통	8831	8724	20180123	17555
20180203	5호선	상일동	9191	8358	20180206	17549
20180212	공항철도 1호선	김포공항	10134	7414	20180215	17548
20180207	5호선	애오개	8690	8857	20180210	17547
20180115	안산선	정왕	8340	9204	20180118	17544
20180123	3호선	금호	9064	8479	20180126	17543
20180123	경원선	광운대	9020	8522	20180126	17542
20180115	안산선	오이도	8938	8600	20180118	17538
20180212	5호선	마곡	9432	8105	20180215	17537
20180129	9호선	양천향교	8660	8877	20180201	17537
20180127	경인선	오류동	9013	8523	20180130	17536
20180119	분당선	기흥	9092	8444	20180122	17536
20180129	6호선	고려대(종암)	8865	8669	20180201	17534
20180126	6호선	돌곶이	9169	8364	20180129	17533
20180120	6호선	증산(명지대앞)	9032	8501	20180123	17533
20180114	5호선	답십리	9110	8422	20180117	17532
20180117	7호선	태릉입구	9102	8425	20180120	17527
20180114	과천선	정부과천청사	9112	8414	20180117	17526
20180129	4호선	이촌(국립중앙박물관)	8237	9288	20180201	17525
20180122	과천선	선바위	9681	7840	20180125	17521
20180126	일산선	마두	8553	8967	20180129	17520
20180212	공항철도 1호선	홍대입구	8723	8796	20180215	17519
20180113	8호선	단대오거리	9035	8483	20180116	17518
20180130	경부선	오산	8864	8648	20180202	17512
20180118	5호선	마곡	9442	8069	20180121	17511
20180129	5호선	명일	8456	9052	20180201	17508
20180201	안산선	한대앞	8828	8678	20180204	17506
20180129	3호선	금호	9067	8431	20180201	17498
20180123	7호선	천왕	9083	8415	20180126	17498
20180115	5호선	길동	8436	9061	20180118	17497
20180122	분당선	가천대	8079	9411	20180125	17490
20180117	3호선	독립문	8727	8759	20180120	17486
20180114	7호선	중계	9035	8450	20180117	17485
20180114	6호선	상수	8154	9331	20180117	17485
20180123	5호선	행당	9193	8291	20180126	17484
20180207	안산선	오이도	8817	8658	20180210	17475
20180112	안산선	정왕	8642	8832	20180115	17474
20180125	3호선	경찰병원	8788	8675	20180128	17463
20180130	분당선	서울숲	8709	8751	20180202	17460
20180112	안산선	고잔	8974	8486	20180115	17460
20180119	경부선	관악	9025	8433	20180122	17458
20180130	7호선	태릉입구	9121	8328	20180202	17449
20180114	9호선	염창	8986	8461	20180117	17447
20180212	안산선	오이도	8825	8618	20180215	17443
20180203	6호선	증산(명지대앞)	8936	8507	20180206	17443
20180201	5호선	길동	8488	8948	20180204	17436
20180125	5호선	송정	8859	8575	20180128	17434
20180126	3호선	금호	9068	8360	20180129	17428
20180113	7호선	중화	9068	8357	20180116	17425
20180208	9호선	신방화	8814	8609	20180211	17423
20180212	분당선	기흥	8938	8478	20180215	17416
20180203	6호선	화랑대(서울여대입구)	9709	7706	20180206	17415
20180212	중앙선	도농	9238	8173	20180215	17411
20180131	9호선	증미	8495	8914	20180203	17409
20180124	5호선	송정	8823	8584	20180127	17407
20180124	공항철도 1호선	김포공항	10395	7011	20180127	17406
20180203	6호선	동묘앞	9070	8331	20180206	17401
20180126	6호선	고려대(종암)	8840	8561	20180129	17401
20180128	7호선	수락산	8831	8567	20180131	17398
20180203	5호선	마포	8661	8736	20180206	17397
20180127	7호선	내방	8734	8662	20180130	17396
20180201	안산선	오이도	8759	8635	20180204	17394
20180122	공항철도 1호선	홍대입구	8578	8816	20180125	17394
20180204	6호선	망원	8347	9041	20180207	17388
20180205	안산선	고잔	8970	8417	20180208	17387
20180130	5호선	여의나루	9031	8351	20180202	17382
20180114	7호선	어린이대공원(세종대)	8755	8626	20180117	17381
20180128	2호선	영등포구청	8606	8769	20180131	17375
20180125	6호선	동묘앞	8491	8884	20180128	17375
20180211	5호선	광나루(장신대)	8807	8567	20180214	17374
20180207	공항철도 1호선	홍대입구	8525	8848	20180210	17373
20180208	5호선	애오개	8521	8851	20180211	17372
20180128	7호선	상동	8853	8519	20180131	17372
20180112	3호선	경찰병원	8770	8602	20180115	17372
20180207	3호선	독립문	8656	8710	20180210	17366
20180119	5호선	방이	8654	8712	20180122	17366
20180112	안산선	한대앞	8784	8580	20180115	17364
20180128	2호선	을지로3가	8922	8438	20180131	17360
20180123	일산선	마두	8445	8915	20180126	17360
20180120	3호선	옥수	8488	8871	20180123	17359
20180208	7호선	태릉입구	9036	8318	20180211	17354
20180126	9호선	흑석(중앙대입구)	8447	8906	20180129	17353
20180117	5호선	애오개	8596	8757	20180120	17353
20180113	5호선	공덕	8465	8885	20180116	17350
20180211	7호선	상동	8775	8573	20180214	17348
20180118	공항철도 1호선	인천공항2터미널	9155	8193	20180121	17348
20180205	중앙선	도농	9187	8159	20180208	17346
20180127	4호선	이촌(국립중앙박물관)	8548	8798	20180130	17346
20180204	1호선	신설동	8846	8494	20180207	17340
20180201	5호선	애오개	8574	8759	20180204	17333
20180130	5호선	방이	8566	8763	20180202	17329
20180123	공항철도 1호선	김포공항	10368	6961	20180126	17329
20180203	2호선	충정로(경기대입구)	8457	8863	20180206	17320
20180118	5호선	애오개	8652	8661	20180121	17313
20180201	5호선	마곡	9301	8011	20180204	17312
20180115	경원선	양주	9178	8133	20180118	17311
20180112	9호선	양천향교	8699	8610	20180115	17309
20180129	9호선	신방화	8719	8589	20180201	17308
20180128	6호선	상수	8096	9212	20180131	17308
20180212	9호선	신방화	8715	8592	20180215	17307
20180208	5호선	마곡	9259	8042	20180211	17301
20180118	7호선	태릉입구	9037	8264	20180121	17301
20180112	7호선	천왕	9181	8120	20180115	17301
20180118	안산선	정왕	8297	8999	20180121	17296
20180112	3호선	금호	9045	8251	20180115	17296
20180123	분당선	가천대	8035	9254	20180126	17289
20180117	분당선	가천대	8062	9224	20180120	17286
20180206	경인선	백운	8664	8621	20180209	17285
20180131	경부선	관악	8919	8365	20180203	17284
20180127	2호선	을지로4가	8642	8640	20180130	17282
20180126	일산선	정발산	8230	9051	20180129	17281
20180115	9호선	증미	8550	8730	20180118	17280
20180112	과천선	선바위	9659	7615	20180115	17274
20180125	일산선	마두	8341	8932	20180128	17273
20180122	5호선	애오개	8601	8664	20180125	17265
20180120	경인선	제물포	8861	8403	20180123	17264
20180206	일산선	마두	8429	8834	20180209	17263
20180117	경원선	양주	9152	8111	20180120	17263
20180208	경부선	화서	8727	8533	20180211	17260
20180120	공항철도 1호선	계양	9018	8242	20180123	17260
20180125	6호선	고려대(종암)	8788	8470	20180128	17258
20180120	안산선	오이도	8727	8530	20180123	17257
20180112	일산선	마두	8453	8803	20180115	17256
20180131	경부선	화서	8774	8481	20180203	17255
20180207	중앙선	도농	9159	8091	20180210	17250
20180123	경부선	오산	8807	8441	20180126	17248
20180120	경원선	방학	8758	8489	20180123	17247
20180117	5호선	여의나루	8356	8890	20180120	17246
20180206	경부선	오산	8813	8432	20180209	17245
20180205	5호선	애오개	8530	8713	20180208	17243
20180127	7호선	신풍	8740	8498	20180130	17238
20180131	5호선	방이	8522	8711	20180203	17233
20180207	7호선	태릉입구	9000	8222	20180210	17222
20180127	일산선	원당	8715	8505	20180130	17220
20180204	7호선	어린이대공원(세종대)	8697	8522	20180207	17219
20180212	5호선	애오개	8575	8643	20180215	17218
20180206	5호선	애오개	8518	8696	20180209	17214
20180131	안산선	오이도	8774	8434	20180203	17208
20180127	6호선	월곡(동덕여대)	8781	8427	20180130	17208
20180126	7호선	천왕	9063	8144	20180129	17207
20180207	5호선	마곡	9157	8048	20180210	17205
20180129	5호선	행당	9066	8138	20180201	17204
20180127	3호선	녹번	9422	7777	20180130	17199
20180120	경부선	가산디지털단지	7267	9931	20180123	17198
20180125	경의선	일산	8759	8438	20180128	17197
20180127	7호선	마들	9002	8193	20180130	17195
20180203	6호선	녹사평(용산구청)	7891	9301	20180206	17192
20180118	경부선	화서	8702	8488	20180121	17190
20180115	경부선	화서	8706	8469	20180118	17175
20180126	경부선	의왕	8845	8329	20180129	17174
20180125	3호선	금호	8879	8295	20180128	17174
20180124	6호선	고려대(종암)	8681	8493	20180127	17174
20180201	3호선	독립문	8602	8571	20180204	17173
20180131	경원선	양주	9074	8099	20180203	17173
20180114	분당선	수원시청	8722	8447	20180117	17169
20180131	7호선	태릉입구	8961	8207	20180203	17168
20180203	과천선	정부과천청사	9279	7884	20180206	17163
20180204	과천선	정부과천청사	8859	8301	20180207	17160
20180115	7호선	태릉입구	8909	8251	20180118	17160
20180112	5호선	명일	8358	8802	20180115	17160
20180203	8호선	단대오거리	8844	8312	20180206	17156
20180121	5호선	우장산	8406	8746	20180124	17152
20180128	중앙선	구리	8241	8909	20180131	17150
20180119	6호선	한강진	7735	9415	20180122	17150
20180208	경원선	망월사	8546	8600	20180211	17146
20180208	9호선	증미	8411	8735	20180211	17146
20180125	5호선	명일	8271	8870	20180128	17141
20180211	경인선	소사	8689	8446	20180214	17135
20180211	분당선	수서	8624	8509	20180214	17133
20180115	5호선	애오개	8633	8500	20180118	17133
20180204	7호선	청담	8236	8891	20180207	17127
20180124	9호선	양천향교	8452	8675	20180127	17127
20180128	9호선	염창	8656	8470	20180131	17126
20180207	공항철도 1호선	김포공항	10367	6754	20180210	17121
20180114	경부선	대방	8560	8559	20180117	17119
20180205	안산선	한대앞	8658	8459	20180208	17117
20180127	9호선	여의도	9018	8097	20180130	17115
20180120	6호선	화랑대(서울여대입구)	9538	7576	20180123	17114
20180112	8호선	가락시장	7703	9410	20180115	17113
20180130	9호선	선유도	8749	8363	20180202	17112
20180112	경원선	광운대	8962	8148	20180115	17110
20180121	4호선	신용산	8377	8732	20180124	17109
20180124	일산선	마두	8318	8789	20180127	17107
20180121	경부선	대방	8487	8619	20180124	17106
20180125	9호선	양천향교	8487	8617	20180128	17104
20180125	5호선	행당	8963	8138	20180128	17101
20180123	8호선	가락시장	7887	9213	20180126	17100
20180129	8호선	가락시장	7883	9213	20180201	17096
20180204	경인선	소사	8639	8456	20180207	17095
20180208	분당선	기흥	8706	8384	20180211	17090
20180118	경부선	관악	8827	8261	20180121	17088
20180208	5호선	방화	8765	8322	20180211	17087
20180204	7호선	수락산	8678	8407	20180207	17085
20180124	경의선	일산	8586	8498	20180127	17084
20180206	5호선	길동	8269	8813	20180209	17082
20180205	과천선	선바위	9377	7700	20180208	17077
20180118	경원선	양주	9026	8048	20180121	17074
20180114	4호선	당고개	8633	8437	20180117	17070
20180120	2호선	충정로(경기대입구)	8275	8793	20180123	17068
20180121	6호선	상수	8023	9043	20180124	17066
20180128	5호선	답십리	8839	8222	20180131	17061
20180119	경부선	군포	8611	8447	20180122	17058
20180126	8호선	가락시장	7740	9317	20180129	17057
20180117	경부선	군포	8501	8555	20180120	17056
20180122	경부선	화서	8648	8405	20180125	17053
20180124	분당선	영통	8386	8666	20180127	17052
20180118	분당선	가천대	7999	9053	20180121	17052
20180126	9호선	양천향교	8523	8528	20180129	17051
20180117	9호선	증미	8398	8651	20180120	17049
20180119	경의선	행신	8649	8399	20180122	17048
20180119	분당선	수원	10376	6670	20180122	17046
20180112	경인선	백운	8693	8353	20180115	17046
20180201	7호선	태릉입구	8840	8204	20180204	17044
20180124	경부선	의왕	8745	8294	20180127	17039
20180208	경원선	양주	9043	7994	20180211	17037
20180204	7호선	중계	8731	8305	20180207	17036
20180205	5호선	길동	8310	8722	20180208	17032
20180122	7호선	태릉입구	8924	8100	20180125	17024
20180128	분당선	수원시청	8544	8479	20180131	17023
20180205	5호선	마곡	9211	7810	20180208	17021
20180204	2호선	을지로3가	8742	8279	20180207	17021
20180126	경의선	일산	8580	8431	20180129	17011
20180205	공항철도 1호선	김포공항	10324	6684	20180208	17008
20180212	경부선	화서	8671	8336	20180215	17007
20180126	3호선	경찰병원	8564	8443	20180129	17007
20180113	3호선	종로3가	6308	10697	20180116	17005
20180117	경원선	망월사	8399	8602	20180120	17001
20180206	3호선	독립문	8492	8508	20180209	17000
20180124	3호선	경찰병원	8537	8463	20180127	17000
20180211	9호선	염창	8649	8349	20180214	16998
20180204	9호선	염창	8648	8348	20180207	16996
20180211	경부선	오산	8119	8872	20180214	16991
20180212	안산선	정왕	8120	8868	20180215	16988
20180124	5호선	명일	8052	8936	20180127	16988
20180119	9호선	증미	8406	8579	20180122	16985
20180201	경원선	양주	9002	7982	20180204	16984
20180123	과천선	선바위	9203	7774	20180126	16977
20180211	5호선	답십리	8795	8179	20180214	16974
20180122	경부선	관악	8733	8241	20180125	16974
20180129	5호선	길동	8199	8774	20180201	16973
20180117	5호선	방이	8414	8558	20180120	16972
20180125	경부선	의왕	8631	8340	20180128	16971
20180123	6호선	동묘앞	8352	8617	20180126	16969
20180131	경부선	군포	8388	8578	20180203	16966
20180211	7호선	중계	8747	8212	20180214	16959
20180123	5호선	길동	8237	8720	20180126	16957
20180122	1호선	동묘앞	8222	8733	20180125	16955
20180125	7호선	천왕	8876	8076	20180128	16952
20180124	3호선	금호	8746	8200	20180127	16946
20180211	5호선	발산	8319	8619	20180214	16938
20180130	중앙선	망우	8420	8516	20180202	16936
20180205	안산선	오이도	8654	8281	20180208	16935
20180125	경원선	광운대	8708	8224	20180128	16932
20180112	5호선	행당	9031	7901	20180115	16932
20180118	5호선	방이	8374	8550	20180121	16924
20180126	2호선	한양대	8082	8841	20180129	16923
20180204	5호선	답십리	8663	8255	20180207	16918
20180118	중앙선	망우	8541	8375	20180121	16916
20180207	9호선	증미	8180	8734	20180210	16914
20180117	중앙선	망우	8525	8383	20180120	16908
20180212	경원선	양주	8949	7955	20180215	16904
20180122	경의선	행신	8480	8424	20180125	16904
20180206	중앙선	도농	8951	7952	20180209	16903
20180206	안산선	한대앞	8552	8351	20180209	16903
20180211	3호선	동대입구	8618	8280	20180214	16898
20180121	5호선	발산	8182	8715	20180124	16897
20180124	7호선	천왕	8808	8084	20180127	16892
20180129	중앙선	도농	8987	7903	20180201	16890
20180131	안산선	정왕	8000	8889	20180203	16889
20180121	7호선	어린이대공원(세종대)	8491	8398	20180124	16889
20180126	과천선	선바위	9429	7459	20180129	16888
20180201	5호선	방이	8362	8525	20180204	16887
20180119	9호선2단계	선정릉	8407	8480	20180122	16887
20180112	9호선	신방화	8540	8342	20180115	16882
20180112	안산선	오이도	8677	8204	20180115	16881
20180113	경부선	가산디지털단지	7219	9660	20180116	16879
20180127	6호선	디지털미디어시티	8187	8690	20180130	16877
20180126	경원선	광운대	8759	8116	20180129	16875
20180211	분당선	압구정로데오	8166	8706	20180214	16872
20180131	5호선	여의나루	8128	8739	20180203	16867
20180124	5호선	행당	8838	8024	20180127	16862
20180112	5호선	길동	8186	8674	20180115	16860
20180127	경원선	외대앞	8764	8094	20180130	16858
20180129	과천선	선바위	9249	7605	20180201	16854
20180115	분당선	가천대	7839	9015	20180118	16854
20180206	과천선	선바위	9222	7630	20180209	16852
20180126	안산선	고잔	8615	8236	20180129	16851
20180128	경인선	소사	8547	8297	20180131	16844
20180121	분당선	수원시청	8507	8333	20180124	16840
20180208	5호선	방이	8338	8499	20180211	16837
20180123	일산선	정발산	8138	8699	20180126	16837
20180130	3호선	독립문	8287	8543	20180202	16830
20180203	5호선	공덕	8318	8511	20180206	16829
20180131	9호선	선유도	8432	8395	20180203	16827
20180201	9호선	증미	8202	8622	20180204	16824
20180131	분당선	기흥	8606	8207	20180203	16813
20180122	경부선	군포	8303	8510	20180125	16813
20180208	경부선	관악	8674	8135	20180211	16809
20180113	5호선	굽은다리(강동구민회관앞)	8711	8094	20180116	16805
20180112	5호선	마곡	9310	7490	20180115	16800
20180127	일산선	정발산	7990	8806	20180130	16796
20180201	안산선	정왕	8020	8774	20180204	16794
20180120	7호선	도봉산	7303	9489	20180123	16792
20180113	6호선	증산(명지대앞)	8583	8206	20180116	16789
20180125	9호선	흑석(중앙대입구)	8148	8630	20180128	16778
20180130	6호선	보문	8619	8158	20180202	16777
20180131	경원선	망월사	8373	8399	20180203	16772
20180131	중앙선	망우	8513	8256	20180203	16769
20180128	7호선	청담	8025	8743	20180131	16768
20180122	중앙선	망우	8425	8343	20180125	16768
20180120	3호선	가락시장	8664	8098	20180123	16762
20180212	9호선	선유도	8368	8393	20180215	16761
20180204	중앙선	구리	8118	8642	20180207	16760
20180129	안산선	한대앞	8443	8316	20180201	16759
20180211	9호선2단계	봉은사	8670	8083	20180214	16753
20180113	공항철도 1호선	계양	8678	8073	20180116	16751
20180120	7호선	부평구청	9310	7440	20180123	16750
20180115	중앙선	망우	8550	8198	20180118	16748
20180204	경부선	오산	7882	8862	20180207	16744
20180123	5호선	애오개	8206	8537	20180126	16743
20180123	중앙선	도농	8816	7925	20180126	16741
20180113	3호선	옥수	8195	8546	20180116	16741
20180124	경원선	광운대	8624	8114	20180127	16738
20180205	9호선	증미	8143	8594	20180208	16737
20180211	분당선	수원시청	8443	8292	20180214	16735
20180123	9호선	신방화	8452	8279	20180126	16731
20180207	5호선	방이	8246	8483	20180210	16729
20180120	5호선	상일동	8913	7815	20180123	16728
20180127	경원선	석계	8163	8562	20180130	16725
20180126	5호선	명일	8142	8583	20180129	16725
20180115	5호선	여의나루	7957	8766	20180118	16723
20180206	일산선	정발산	8135	8586	20180209	16721
20180127	7호선	남성	8707	8014	20180130	16721
20180211	중앙선	구리	8029	8691	20180214	16720
20180201	경부선	화서	8371	8348	20180204	16719
20180203	3호선	옥수	8155	8562	20180206	16717
20180129	5호선	마곡	8892	7824	20180201	16716
20180118	9호선	증미	8237	8479	20180121	16716
20180126	안산선	한대앞	8403	8310	20180129	16713
20180120	5호선	굽은다리(강동구민회관앞)	8714	7996	20180123	16710
20180207	경원선	망월사	8277	8428	20180210	16705
20180115	경부선	군포	8262	8440	20180118	16702
20180113	경부선	석수	8873	7828	20180116	16701
20180120	경인선	중동	8637	8058	20180123	16695
20180120	경부선	천안	8415	8280	20180123	16695
20180203	경원선	방학	8527	8167	20180206	16694
20180122	9호선	증미	8168	8524	20180125	16692
20180127	5호선	서대문	8351	8337	20180130	16688
20180115	경부선	관악	8632	8055	20180118	16687
20180124	9호선	흑석(중앙대입구)	8043	8637	20180127	16680
20180118	3호선	독립문	8355	8324	20180121	16679
20180118	경부선	군포	8342	8335	20180121	16677
20180207	6호선	한강진	7692	8982	20180210	16674
20180117	9호선	선유도	8442	8231	20180120	16673
20180208	5호선	여의나루	7932	8739	20180211	16671
20180201	중앙선	망우	8525	8146	20180204	16671
20180123	경인선	백운	8502	8166	20180126	16668
20180128	5호선	발산	8202	8464	20180131	16666
20180120	2호선	아현	8473	8188	20180123	16661
20180203	2호선	아현	8452	8207	20180206	16659
20180125	8호선	가락시장	7670	8988	20180128	16658
20180123	5호선	마곡	9014	7644	20180126	16658
20180124	경부선	오산	8468	8189	20180127	16657
20180113	경인선	제물포	8572	8079	20180116	16651
20180117	분당선	기흥	8474	8171	20180120	16645
20180118	분당선	기흥	8436	8207	20180121	16643
20180119	분당선	서울숲	8369	8273	20180122	16642
20180114	경인선	오류동	8794	7847	20180117	16641
20180130	경원선	양주	8686	7954	20180202	16640
20180206	5호선	마곡	8874	7765	20180209	16639
20180207	5호선	방화	8560	8064	20180210	16624
20180203	경부선	석수	8726	7889	20180206	16615
20180118	9호선2단계	선정릉	8204	8407	20180121	16611
20180208	6호선	한강진	7554	9056	20180211	16610
20180203	7호선	상도	8620	7988	20180206	16608
20180124	안산선	한대앞	8346	8262	20180127	16608
20180127	7호선	장승배기	8520	8084	20180130	16604
20180203	경인선	제물포	8588	8013	20180206	16601
20180126	5호선	애오개	8194	8404	20180129	16598
20180114	5호선	우장산	8135	8454	20180117	16589
20180124	일산선	정발산	8115	8473	20180127	16588
20180129	5호선	애오개	8245	8342	20180201	16587
20180208	중앙선	망우	8415	8169	20180211	16584
20180125	안산선	한대앞	8453	8126	20180128	16579
20180121	9호선2단계	봉은사	8517	8062	20180124	16579
20180204	2호선	문래	8244	8329	20180207	16573
20180130	경부선	관악	8404	8169	20180202	16573
20180121	2호선	문래	8175	8398	20180124	16573
20180113	안산선	오이도	8434	8137	20180116	16571
20180205	7호선	태릉입구	8603	7958	20180208	16561
20180125	안산선	고잔	8516	8045	20180128	16561
20180201	분당선	기흥	8449	8110	20180204	16559
20180119	분당선	가천대	7973	8577	20180122	16550
20180201	경부선	관악	8494	8053	20180204	16547
20180204	3호선	동대입구	8168	8377	20180207	16545
20180131	3호선	독립문	8187	8358	20180203	16545
20180201	분당선	서울숲	8330	8213	20180204	16543
20180201	경원선	망월사	8277	8265	20180204	16542
20180125	9호선	신방화	8303	8239	20180128	16542
20180114	분당선	압구정로데오	7934	8608	20180117	16542
20180119	경의선	탄현	8469	8072	20180122	16541
20180129	9호선	증미	8053	8477	20180201	16530
20180124	6호선	동묘앞	8078	8447	20180127	16525
20180112	5호선	애오개	8250	8274	20180115	16524
20180129	일산선	정발산	8123	8400	20180201	16523
20180203	2호선	신정네거리	8166	8353	20180206	16519
20180130	안산선	오이도	8386	8132	20180202	16518
20180123	안산선	오이도	8359	8159	20180126	16518
20180206	안산선	오이도	8395	8113	20180209	16508
20180212	7호선	태릉입구	8679	7824	20180215	16503
20180124	안산선	고잔	8426	8075	20180127	16501
20180121	경원선	회룡	8363	8138	20180124	16501
20180208	분당선	서울숲	8227	8273	20180211	16500
20180117	9호선2단계	선정릉	8127	8370	20180120	16497
20180206	9호선	선유도	8298	8196	20180209	16494
20180121	분당선	압구정로데오	7875	8618	20180124	16493
20180211	4호선	당고개	8235	8256	20180214	16491
20180208	안산선	정왕	7860	8630	20180211	16490
20180120	7호선	상도	8635	7855	20180123	16490
20180124	경인선	백운	8301	8188	20180127	16489
20180126	9호선	신방화	8370	8116	20180129	16486
20180117	경의선	행신	8406	8080	20180120	16486
20180207	경원선	양주	8623	7858	20180210	16481
20180128	경부선	대방	8152	8326	20180131	16478
20180120	안산선	고잔	8247	8230	20180123	16477
20180120	경인선	부개	8596	7876	20180123	16472
20180208	9호선2단계	선정릉	8078	8391	20180211	16469
20180125	5호선	애오개	8077	8390	20180128	16467
20180114	7호선	청담	7977	8490	20180117	16467
20180212	분당선	도곡	7960	8506	20180215	16466
20180207	5호선	여의나루	7985	8481	20180210	16466
20180126	5호선	길동	8052	8411	20180129	16463
20180205	경원선	양주	8693	7769	20180208	16462
20180203	공항철도 1호선	계양	8425	8035	20180206	16460
20180115	경의선	행신	8466	7992	20180118	16458
20180208	9호선	선유도	8200	8257	20180211	16457
20180127	8호선	단대오거리	8433	8023	20180130	16456
20180126	안산선	정왕	8054	8402	20180129	16456
20180131	6호선	한강진	7594	8859	20180203	16453
20180130	경부선	군포	8247	8205	20180202	16452
20180120	일산선	주엽	8232	8220	20180123	16452
20180117	6호선	한강진	7571	8875	20180120	16446
20180124	5호선	마곡	8817	7626	20180127	16443
20180115	분당선	기흥	8321	8121	20180118	16442
20180122	경원선	망월사	8167	8270	20180125	16437
20180206	공항철도 1호선	홍대입구	8184	8251	20180209	16435
20180212	경부선	관악	8483	7951	20180215	16434
20180128	4호선	당고개	8321	8113	20180131	16434
20180113	6호선	녹사평(용산구청)	7551	8882	20180116	16433
20180131	9호선2단계	선정릉	8072	8359	20180203	16431
20180130	분당선	도곡	8074	8355	20180202	16429
20180206	9호선	증미	8050	8377	20180209	16427
20180129	경원선	양주	8596	7828	20180201	16424
20180204	7호선	학동	8037	8386	20180207	16423
20180130	안산선	정왕	7883	8540	20180202	16423
20180204	분당선	수원시청	8212	8210	20180207	16422
20180207	분당선	서울숲	8197	8224	20180210	16421
20180208	6호선	구산	9356	7063	20180211	16419
20180123	공항철도 1호선	홍대입구	8032	8387	20180126	16419
20180212	경부선	군포	8174	8243	20180215	16417
20180127	3호선	동대입구	7763	8651	20180130	16414
20180122	분당선	기흥	8177	8235	20180125	16412
20180123	9호선	선유도	8304	8106	20180126	16410
20180206	공항철도 1호선	김포공항	9742	6666	20180209	16408
20180113	2호선	신정네거리	8197	8209	20180116	16406
20180206	1호선	동묘앞	8075	8330	20180209	16405
20180124	8호선	가락시장	7547	8858	20180127	16405
20180131	6호선	보문	8528	7870	20180203	16398
20180125	경인선	백운	8219	8178	20180128	16397
20180212	중앙선	망우	8244	8151	20180215	16395
20180120	2호선	신정네거리	8166	8229	20180123	16395
20180127	7호선	중화	8467	7923	20180130	16390
20180114	4호선	신용산	8095	8293	20180117	16388
20180201	9호선2단계	선정릉	8105	8281	20180204	16386
20180117	5호선	방화	8410	7974	20180120	16384
20180205	일산선	정발산	7957	8425	20180208	16382
20180201	경부선	군포	8185	8195	20180204	16380
20180125	분당선	가천대	7622	8756	20180128	16378
20180125	과천선	선바위	8974	7402	20180128	16376
20180123	경원선	양주	8613	7761	20180126	16374
20180211	5호선	우장산	7953	8420	20180214	16373
20180130	경부선	화서	8197	8176	20180202	16373
20180127	5호선	공덕	8047	8325	20180130	16372
20180113	7호선	상도	8580	7792	20180116	16372
20180206	7호선	태릉입구	8541	7829	20180209	16370
20180126	분당선	가천대	7810	8558	20180129	16368
20180121	3호선	약수	8442	7917	20180124	16359
20180119	경원선	망월사	8262	8097	20180122	16359
20180205	공항철도 1호선	홍대입구	7920	8435	20180208	16355
20180119	8호선	몽촌토성(평화의문)	7969	8384	20180122	16353
20180127	5호선	마포	8176	8174	20180130	16350
20180119	6호선	보문	8634	7715	20180122	16349
20180118	9호선	선유도	8127	8221	20180121	16348
20180113	7호선	부평구청	9049	7294	20180116	16343
20180207	9호선2단계	선정릉	8001	8340	20180210	16341
20180129	공항철도 1호선	홍대입구	8071	8267	20180201	16338
20180130	경의선	행신	8211	8125	20180202	16336
20180113	7호선	굴포천	8090	8246	20180116	16336
20180113	2호선	충정로(경기대입구)	8014	8322	20180116	16336
20180207	경부선	화서	8203	8131	20180210	16334
20180203	3호선	가락시장	8536	7796	20180206	16332
20180203	경부선	가산디지털단지	6811	9521	20180206	16332
20180207	9호선	선유도	8163	8168	20180210	16331
20180125	5호선	길동	7997	8333	20180128	16330
20180119	9호선	선유도	8371	7958	20180122	16329
20180131	8호선	몽촌토성(평화의문)	7970	8355	20180203	16325
20180122	9호선	선유도	8165	8156	20180125	16321
20180112	7호선	태릉입구	8579	7739	20180115	16318
20180131	경의선	행신	8425	7892	20180203	16317
20180113	경원선	방학	8290	8027	20180116	16317
20180112	분당선	수원	9690	6627	20180115	16317
20180131	5호선	방화	8427	7888	20180203	16315
20180129	안산선	오이도	8307	8001	20180201	16308
20180203	5호선	굽은다리(강동구민회관앞)	8497	7808	20180206	16305
20180128	5호선	우장산	7971	8332	20180131	16303
20180112	9호선	증미	7995	8306	20180115	16301
20180124	5호선	애오개	7956	8340	20180127	16296
20180126	7호선	태릉입구	8461	7832	20180129	16293
20180123	9호선	증미	7963	8322	20180126	16285
20180208	경부선	군포	8136	8148	20180211	16284
20180212	5호선	방이	8033	8232	20180215	16265
20180130	8호선	몽촌토성(평화의문)	7927	8337	20180202	16264
20180130	9호선2단계	선정릉	8058	8201	20180202	16259
20180207	경부선	군포	8183	8075	20180210	16258
20180130	분당선	기흥	8110	8147	20180202	16257
20180205	3호선	독립문	8105	8149	20180208	16254
20180121	7호선	논현	8004	8250	20180124	16254
20180206	경원선	양주	8621	7629	20180209	16250
20180119	5호선	방화	8466	7784	20180122	16250
20180118	경의선	행신	8344	7901	20180121	16245
20180208	경의선	행신	8403	7841	20180211	16244
20180212	9호선2단계	선정릉	7933	8309	20180215	16242
20180125	경부선	오산	8373	7869	20180128	16242
20180212	경원선	망월사	8097	8140	20180215	16237
20180129	분당선	가천대	7628	8606	20180201	16234
20180131	일산선	원흥	8600	7629	20180203	16229
20180113	2호선	아현	8309	7919	20180116	16228
20180124	5호선	길동	7919	8307	20180127	16226
20180124	9호선	신방화	8109	8115	20180127	16224
20180205	6호선	구산	9055	7168	20180208	16223
20180119	5호선	김포공항	8754	7467	20180122	16221
20180207	분당선	기흥	8163	8057	20180210	16220
20180212	분당선	수원	9769	6448	20180215	16217
20180212	경의선	행신	8223	7994	20180215	16217
20180124	과천선	선바위	8933	7284	20180127	16217
20180205	경부선	화서	8169	8045	20180208	16214
20180204	경부선	대방	8030	8183	20180207	16213
20180201	9호선	선유도	8067	8145	20180204	16212
20180117	분당선	서울숲	8134	8073	20180120	16207
20180119	과천선	경마공원	8062	8144	20180122	16206
20180122	5호선	방이	8016	8176	20180125	16192
20180127	6호선	동묘앞	8394	7797	20180130	16191
20180113	6호선	한강진	7246	8943	20180116	16189
20180119	2호선	양천구청	7884	8296	20180122	16180
20180129	안산선	정왕	7742	8437	20180201	16179
20180204	5호선	우장산	7862	8314	20180207	16176
20180124	공항철도 1호선	홍대입구	7770	8405	20180127	16175
20180126	안산선	오이도	8307	7866	20180129	16173
20180118	분당선	서울숲	8077	8094	20180121	16171
20180118	5호선	여의나루	7773	8396	20180121	16169
20180204	분당선	압구정로데오	7795	8360	20180207	16155
20180211	분당선	수내	8236	7918	20180214	16154
20180123	안산선	정왕	7712	8442	20180126	16154
20180131	9호선	마곡나루	8352	7800	20180203	16152
20180119	분당선	도곡	8171	7976	20180122	16147
20180130	경원선	망월사	8018	8125	20180202	16143
20180121	공항철도 1호선	홍대입구	8434	7709	20180124	16143
20180119	9호선	마곡나루	8625	7506	20180122	16131
20180118	5호선	방화	8268	7861	20180121	16129
20180113	안산선	고잔	8020	8107	20180116	16127
20180124	9호선	선유도	8086	8040	20180127	16126
20180119	6호선	구산	9198	6922	20180122	16120
20180112	중앙선	도농	8574	7544	20180115	16118
20180208	분당선	도곡	7991	8126	20180211	16117
20180118	6호선	보문	8541	7575	20180121	16116
20180207	중앙선	망우	8096	8019	20180210	16115
20180130	6호선	구산	8816	7297	20180202	16113
20180115	9호선2단계	선정릉	7924	8189	20180118	16113
20180201	6호선	구산	9042	7068	20180204	16110
20180129	7호선	태릉입구	8420	7688	20180201	16108
20180208	6호선	보문	8449	7653	20180211	16102
20180203	분당선	영통	8162	7940	20180206	16102
20180114	3호선	약수	8229	7870	20180117	16099
20180123	7호선	태릉입구	8368	7730	20180126	16098
20180117	6호선	보문	8499	7599	20180120	16098
20180208	2호선	양천구청	7864	8232	20180211	16096
20180115	5호선	방이	8030	8065	20180118	16095
20180115	9호선	선유도	8002	8091	20180118	16093
20180117	경의선	탄현	8200	7890	20180120	16090
20180112	6호선	한강진	7222	8867	20180115	16089
20180206	5호선	방이	7971	8114	20180209	16085
20180114	분당선	수내	8184	7891	20180117	16075
20180114	경원선	회룡	8084	7990	20180117	16074
20180113	일산선	주엽	7989	8084	20180116	16073
20180120	7호선	굴포천	7840	8232	20180123	16072
20180127	경부선	금천구청	8139	7930	20180130	16069
20180205	5호선	방화	8193	7871	20180208	16064
20180120	5호선	송정	8144	7920	20180123	16064
20180121	7호선	신중동	8254	7805	20180124	16059
20180129	1호선	동묘앞	7902	8154	20180201	16056
20180131	분당선	도곡	7837	8212	20180203	16049
20180131	7호선	뚝섬유원지	8162	7886	20180203	16048
20180121	5호선	광나루(장신대)	8293	7754	20180124	16047
20180207	분당선	도곡	7809	8234	20180210	16043
20180206	6호선	구산	9065	6978	20180209	16043
20180112	경의선	행신	8180	7863	20180115	16043
20180205	1호선	동묘앞	7841	8198	20180208	16039
20180114	일산선	대화	8269	7768	20180117	16037
20180206	분당선	기흥	8136	7899	20180209	16035
20180123	경부선	군포	8007	8016	20180126	16023
20180205	9호선	선유도	7997	8024	20180208	16021
20180120	5호선	둔촌동	8032	7986	20180123	16018
20180114	2호선	잠실나루	8020	7996	20180117	16016
20180112	경원선	양주	8548	7468	20180115	16016
20180207	경부선	관악	8286	7726	20180210	16012
20180205	분당선	기흥	8056	7950	20180208	16006
20180113	6호선	화랑대(서울여대입구)	8808	7198	20180116	16006
20180113	5호선	상일동	8464	7539	20180116	16003
20180126	5호선	마곡	8811	7191	20180129	16002
20180122	경의선	탄현	8077	7925	20180125	16002
20180113	경인선	중동	8339	7663	20180116	16002
20180118	6호선	한강진	7343	8654	20180121	15997
20180122	8호선	몽촌토성(평화의문)	7819	8169	20180125	15988
20180201	경의선	행신	8163	7817	20180204	15980
20180113	경인선	부개	8299	7681	20180116	15980
20180130	일산선	원흥	8326	7643	20180202	15969
20180206	분당선	서울숲	8020	7944	20180209	15964
20180123	5호선	방이	7927	8037	20180126	15964
20180206	경부선	화서	8060	7903	20180209	15963
20180205	분당선	도곡	7807	8154	20180208	15961
20180208	일산선	원흥	8476	7482	20180211	15958
20180125	5호선	마곡	8539	7416	20180128	15955
20180207	경의선	행신	8234	7719	20180210	15953
20180115	3호선	독립문	7933	8020	20180118	15953
20180114	일산선	백석	8162	7786	20180117	15948
20180207	안산선	정왕	7508	8439	20180210	15947
20180114	7호선	신중동	8188	7755	20180117	15943
20180121	5호선	군자(능동)	6863	9079	20180124	15942
20180212	3호선	독립문	7822	8119	20180215	15941
20180119	7호선	뚝섬유원지	8188	7752	20180122	15940
20180130	7호선	뚝섬유원지	7921	8016	20180202	15937
20180125	9호선	증미	7805	8131	20180128	15936
20180115	경원선	망월사	7992	7943	20180118	15935
20180122	9호선2단계	선정릉	7798	8132	20180125	15930
20180129	분당선	기흥	7992	7937	20180201	15929
20180125	공항철도 1호선	홍대입구	7588	8340	20180128	15928
20180206	6호선	한강진	7376	8549	20180209	15925
20180122	일산선	원흥	8383	7541	20180125	15924
20180207	6호선	구산	9072	6851	20180210	15923
20180201	6호선	한강진	7344	8576	20180204	15920
20180201	8호선	몽촌토성(평화의문)	7760	8157	20180204	15917
20180114	과천선	평촌	7999	7918	20180117	15917
20180123	9호선2단계	선정릉	7916	8000	20180126	15916
20180121	6호선	새절(신사)	8014	7902	20180124	15916
20180130	경의선	탄현	7863	8052	20180202	15915
20180126	경인선	백운	8108	7806	20180129	15914
20180112	5호선	방이	7934	7979	20180115	15913
20180127	분당선	영통	8023	7889	20180130	15912
20180201	분당선	도곡	7770	8139	20180204	15909
20180114	7호선	논현	7814	8095	20180117	15909
20180206	경부선	관악	8073	7835	20180209	15908
20180117	2호선	양천구청	7721	8187	20180120	15908
20180115	경의선	탄현	8177	7731	20180118	15908
20180114	5호선	발산	7786	8122	20180117	15908
20180112	분당선	기흥	8160	7748	20180115	15908
20180127	5호선	영등포시장	7727	8179	20180130	15906
20180117	9호선	마곡나루	8276	7626	20180120	15902
20180123	경부선	관악	8183	7716	20180126	15899
20180129	5호선	방이	7856	8042	20180201	15898
20180121	경인선	오류동	8369	7529	20180124	15898
20180211	7호선	신중동	8148	7745	20180214	15893
20180207	6호선	보문	8308	7584	20180210	15892
20180115	5호선	방화	8217	7675	20180118	15892
20180129	경부선	군포	7890	8001	20180201	15891
20180126	9호선	증미	7794	8096	20180129	15890
20180129	9호선	선유도	7959	7926	20180201	15885
20180114	2호선	한양대	7955	7928	20180117	15883
20180201	일산선	원흥	8456	7417	20180204	15873
20180212	2호선	양천구청	7691	8181	20180215	15872
20180212	5호선	방화	8132	7738	20180215	15870
20180208	6호선	효창공원앞	8263	7607	20180211	15870
20180204	2호선	종합운동장	7527	8342	20180207	15869
20180205	안산선	정왕	7544	8324	20180208	15868
20180124	9호선	증미	7722	8145	20180127	15867
20180205	경부선	군포	7834	8032	20180208	15866
20180211	경부선	대방	7864	8000	20180214	15864
20180122	5호선	여의나루	7646	8218	20180125	15864
20180121	7호선	학동	7840	8022	20180124	15862
20180117	분당선	도곡	7909	7950	20180120	15859
20180205	5호선	방이	7798	8059	20180208	15857
20180205	경부선	관악	8213	7643	20180208	15856
20180206	5호선	방화	8084	7770	20180209	15854
20180127	6호선	안암(고대병원앞)	7972	7881	20180130	15853
20180203	7호선	굴포천	7841	8009	20180206	15850
20180115	2호선	양천구청	7706	8142	20180118	15848
20180131	경의선	탄현	8160	7685	20180203	15845
20180123	경부선	화서	8039	7805	20180126	15844
20180117	8호선	몽촌토성(평화의문)	7665	8177	20180120	15842
20180122	6호선	보문	8241	7599	20180125	15840
20180208	7호선	뚝섬유원지	8072	7762	20180211	15834
20180201	7호선	뚝섬유원지	8020	7813	20180204	15833
20180123	분당선	기흥	8062	7765	20180126	15827
20180207	일산선	원흥	8475	7350	20180210	15825
20180121	과천선	평촌	7887	7938	20180124	15825
20180112	경부선	군포	7997	7827	20180115	15824
20180211	4호선	이촌(국립중앙박물관)	7643	8177	20180214	15820
20180203	일산선	주엽	7906	7914	20180206	15820
20180115	7호선	뚝섬유원지	8024	7796	20180118	15820
20180203	9호선	등촌	7816	8003	20180206	15819
20180123	경의선	행신	7999	7820	20180126	15819
20180207	9호선	마곡나루	8236	7579	20180210	15815
20180203	7호선	부평구청	8751	7059	20180206	15810
20180129	경부선	화서	7995	7814	20180201	15809
20180201	6호선	보문	8265	7542	20180204	15807
20180201	5호선	여의나루	7589	8216	20180204	15805
20180120	경부선	남영	7765	8038	20180123	15803
20180114	공항철도 1호선	홍대입구	8300	7502	20180117	15802
20180212	9호선	마곡나루	8193	7607	20180215	15800
20180112	중앙선	망우	7965	7828	20180115	15793
20180129	경부선	관악	8166	7622	20180201	15788
20180206	경부선	군포	7869	7918	20180209	15787
20180122	5호선	방화	8064	7721	20180125	15785
20180118	경원선	망월사	7914	7863	20180121	15777
20180121	6호선	공덕	7985	7785	20180124	15770
20180206	9호선2단계	선정릉	7848	7918	20180209	15766
20180126	9호선2단계	선정릉	7865	7899	20180129	15764
20180131	6호선	구산	8855	6906	20180203	15761
20180120	공항철도 1호선	김포공항	9567	6194	20180123	15761
20180125	일산선	정발산	7752	8007	20180128	15759
20180130	9호선	마곡나루	8235	7521	20180202	15756
20180123	분당선	서울숲	7883	7873	20180126	15756
20180212	6호선	보문	8277	7478	20180215	15755
20180114	2호선	시청	8771	6983	20180117	15754
20180204	분당선	수내	7955	7796	20180207	15751
20180118	경의선	탄현	8030	7721	20180121	15751
20180128	7호선	어린이대공원(세종대)	7924	7824	20180131	15748
20180128	일산선	대화	8245	7501	20180131	15746
20180212	일산선	원흥	8366	7378	20180215	15744
20180120	8호선	강동구청	7873	7867	20180123	15740
20180112	경부선	화서	7971	7766	20180115	15737
20180125	9호선	선유도	7901	7834	20180128	15735
20180118	8호선	몽촌토성(평화의문)	7569	8161	20180121	15730
20180115	6호선	보문	8226	7502	20180118	15728
20180204	5호선	발산	7749	7978	20180207	15727
20180126	분당선	수원	9440	6287	20180129	15727
20180206	안산선	정왕	7555	8168	20180209	15723
20180211	7호선	부천시청	7852	7867	20180214	15719
20180128	7호선	중계	8033	7683	20180131	15716
20180125	중앙선	도농	8284	7431	20180128	15715
20180207	2호선	양천구청	7684	8027	20180210	15711
20180117	5호선	김포공항	8305	7402	20180120	15707
20180130	5호선	양평	7892	7811	20180202	15703
20180118	2호선	양천구청	7611	8091	20180121	15702
20180130	5호선	방화	7940	7761	20180202	15701
20180114	5호선	군자(능동)	6731	8969	20180117	15700
20180205	경원선	망월사	7835	7863	20180208	15698
20180112	9호선	선유도	7903	7793	20180115	15696
20180201	5호선	개롱	7870	7825	20180204	15695
20180115	9호선	마곡나루	8091	7602	20180118	15693
20180201	5호선	방화	8051	7641	20180204	15692
20180114	9호선	흑석(중앙대입구)	7917	7774	20180117	15691
20180118	5호선	김포공항	8533	7157	20180121	15690
20180211	공항철도 1호선	홍대입구	8047	7635	20180214	15682
20180208	분당선	수원	9504	6176	20180211	15680
20180203	7호선	도봉산	6729	8950	20180206	15679
20180131	5호선	김포공항	8519	7154	20180203	15673
20180126	과천선	경마공원	7772	7901	20180129	15673
20180203	안산선	고잔	7869	7802	20180206	15671
20180128	3호선	약수	7987	7684	20180131	15671
20180212	5호선	여의나루	7469	8200	20180215	15669
20180122	3호선	독립문	7729	7938	20180125	15667
20180124	7호선	태릉입구	8104	7562	20180127	15666
20180131	5호선	양평	7748	7914	20180203	15662
20180120	과천선	정부과천청사	8467	7193	20180123	15660
20180208	분당선	가천대	7302	8357	20180211	15659
20180112	5호선	여의나루	7672	7980	20180115	15652
20180126	중앙선	도농	8284	7366	20180129	15650
20180204	9호선2단계	봉은사	8092	7553	20180207	15645
20180126	경원선	양주	8318	7325	20180129	15643
20180120	경인선	백운	7929	7714	20180123	15643
20180205	5호선	여의나루	7533	8108	20180208	15641
20180206	경원선	망월사	7835	7804	20180209	15639
20180130	6호선	효창공원앞	8047	7586	20180202	15633
20180120	중앙선	망우	7925	7706	20180123	15631
20180120	경원선	양주	8394	7236	20180123	15630
20180207	5호선	양평	7797	7830	20180210	15627
20180115	분당선	도곡	7735	7887	20180118	15622
20180128	분당선	압구정로데오	7589	8032	20180131	15621
20180118	일산선	원흥	8545	7076	20180121	15621
20180112	경부선	관악	8093	7528	20180115	15621
20180204	7호선	논현	7452	8165	20180207	15617
20180204	과천선	평촌	7846	7760	20180207	15606
20180206	5호선	여의나루	7571	8032	20180209	15603
20180122	분당선	도곡	7734	7869	20180125	15603
20180208	9호선	마곡나루	8103	7498	20180211	15601
20180113	7호선	도봉산	6749	8848	20180116	15597
20180126	분당선	기흥	7962	7632	20180129	15594
20180129	중앙선	망우	7825	7767	20180201	15592
20180205	경의선	행신	7937	7649	20180208	15586
20180126	9호선	선유도	7899	7687	20180129	15586
20180121	4호선	이촌(국립중앙박물관)	7483	8097	20180124	15580
20180208	5호선	개롱	7752	7821	20180211	15573
20180201	경의선	탄현	7880	7689	20180204	15569
20180125	7호선	태릉입구	8016	7551	20180128	15567
20180126	5호선	김포공항	8621	6945	20180129	15566
20180205	9호선2단계	선정릉	7609	7956	20180208	15565
20180122	6호선	구산	8583	6981	20180125	15564
20180113	경인선	백운	7995	7568	20180116	15563
20180113	3호선	가락시장	8063	7499	20180116	15562
20180212	5호선	김포공항	8403	7150	20180215	15553
20180201	2호선	양천구청	7525	8028	20180204	15553
20180125	5호선	방이	7716	7835	20180128	15551
20180208	8호선	몽촌토성(평화의문)	7589	7956	20180211	15545
20180120	8호선	복정	8545	6996	20180123	15541
20180127	3호선	종로3가	5776	9759	20180130	15535
20180124	분당선	가천대	7206	8329	20180127	15535
20180118	분당선	수원	9426	6108	20180121	15534
20180211	3호선	약수	7913	7620	20180214	15533
20180121	분당선	오리	8372	7160	20180124	15532
20180120	공항철도 1호선	인천공항2터미널	8302	7229	20180123	15531
20180125	안산선	오이도	7912	7616	20180128	15528
20180201	9호선	마곡나루	8016	7510	20180204	15526
20180119	일산선	원흥	8600	6923	20180122	15523
20180113	5호선	송정	7855	7668	20180116	15523
20180204	분당선	오리	8333	7187	20180207	15520
20180118	9호선	마곡나루	8052	7467	20180121	15519
20180126	5호선	방이	7760	7758	20180129	15518
20180113	경부선	천안	7919	7596	20180116	15515
20180122	2호선	양천구청	7502	8012	20180125	15514
20180112	9호선2단계	선정릉	7652	7858	20180115	15510
20180117	6호선	구산	8786	6722	20180120	15508
20180203	경의선	일산	7789	7718	20180206	15507
20180114	7호선	공릉(서울과학기술대)	7587	7920	20180117	15507
20180208	경의선	탄현	7958	7546	20180211	15504
20180212	경의선	탄현	7980	7518	20180215	15498
20180124	5호선	방이	7670	7828	20180127	15498
20180119	경부선	당정	7981	7516	20180122	15497
20180212	6호선	구산	8690	6806	20180215	15496
20180207	6호선	효창공원앞	8070	7418	20180210	15488
20180121	일산선	백석	7939	7549	20180124	15488
20180124	중앙선	도농	8159	7327	20180127	15486
20180120	7호선	중곡	8070	7416	20180123	15486
20180114	5호선	광나루(장신대)	7848	7635	20180117	15483
20180121	분당선	수내	7787	7695	20180124	15482
20180131	5호선	개롱	7760	7720	20180203	15480
20180125	안산선	정왕	7448	8032	20180128	15480
20180125	9호선2단계	선정릉	7638	7842	20180128	15480
20180120	9호선	등촌	7873	7606	20180123	15479
20180130	2호선	양천구청	7377	8101	20180202	15478
20180127	공항철도 1호선	김포공항	9756	5722	20180130	15478
20180128	3호선	동대입구	7461	8014	20180131	15475
20180118	6호선	구산	8769	6706	20180121	15475
20180119	경원선	지행	7790	7684	20180122	15474
20180122	9호선	마곡나루	8025	7448	20180125	15473
20180120	경원선	신이문	8210	7261	20180123	15471
20180212	5호선	양평	7733	7737	20180215	15470
20180130	5호선	개롱	7620	7848	20180202	15468
20180127	7호선	상도	8111	7347	20180130	15458
20180131	2호선	양천구청	7528	7928	20180203	15456
20180115	분당선	수원	9313	6132	20180118	15445
20180207	8호선	몽촌토성(평화의문)	7371	8072	20180210	15443
20180203	경인선	중동	8012	7431	20180206	15443
20180114	8호선	남한산성입구(성남법원.검찰청)	8106	7337	20180117	15443
20180205	6호선	보문	8064	7378	20180208	15442
20180131	분당선	수원	9319	6123	20180203	15442
20180118	5호선	개롱	7669	7773	20180121	15442
20180119	6호선	효창공원앞	8062	7379	20180122	15441
20180203	공항철도 1호선	김포공항	9755	5685	20180206	15440
20180114	분당선	오리	8312	7128	20180117	15440
20180112	3호선	독립문	7693	7747	20180115	15440
20180115	6호선	구산	8730	6705	20180118	15435
20180128	4호선	신용산	7431	8001	20180131	15432
20180120	안산선	한대앞	7917	7512	20180123	15429
20180126	중앙선	망우	7720	7706	20180129	15426
20180203	안산선	오이도	7825	7598	20180206	15423
20180205	6호선	효창공원앞	7969	7451	20180208	15420
20180128	분당선	수내	7765	7655	20180131	15420
20180206	6호선	보문	8042	7374	20180209	15416
20180205	5호선	양평	7598	7815	20180208	15413
20180128	7호선	논현	7516	7896	20180131	15412
20180119	6호선	녹사평(용산구청)	7275	8127	20180122	15402
20180206	경의선	행신	7912	7489	20180209	15401
20180121	2호선	잠실나루	7735	7663	20180124	15398
20180121	7호선	부천시청	7790	7608	20180124	15398
20180203	5호선	송정	7805	7591	20180206	15396
20180115	8호선	몽촌토성(평화의문)	7479	7915	20180118	15394
20180123	8호선	몽촌토성(평화의문)	7510	7877	20180126	15387
20180203	경인선	부개	7952	7429	20180206	15381
20180203	8호선	강동구청	7602	7778	20180206	15380
20180130	분당선	가천대	7016	8363	20180202	15379
20180123	3호선	독립문	7650	7728	20180126	15378
20180128	2호선	시청	8877	6497	20180131	15374
20180207	5호선	김포공항	8274	7099	20180210	15373
20180129	경의선	행신	7900	7471	20180201	15371
20180117	7호선	뚝섬유원지	7820	7549	20180120	15369
20180120	3호선	독립문	7611	7753	20180123	15364
20180127	3호선	옥수	7441	7922	20180130	15363
20180207	분당선	가천대	7172	8188	20180210	15360
20180206	분당선	도곡	7478	7881	20180209	15359
20180208	5호선	양평	7653	7705	20180211	15358
20180206	9호선	마곡나루	8003	7355	20180209	15358
20180124	안산선	오이도	7821	7537	20180127	15358
20180129	9호선2단계	선정릉	7558	7797	20180201	15355
20180203	5호선	둔촌동	7604	7749	20180206	15353
20180124	9호선2단계	선정릉	7558	7794	20180127	15352
20180118	분당선	도곡	7704	7645	20180121	15349
20180127	6호선	증산(명지대앞)	7953	7389	20180130	15342
20180127	2호선	충정로(경기대입구)	7512	7828	20180130	15340
20180119	6호선	삼각지	8507	6828	20180122	15335
20180113	5호선	둔촌동	7694	7641	20180116	15335
20180114	2호선	문래	7572	7762	20180117	15334
20180130	6호선	한강진	7118	8215	20180202	15333
20180205	중앙선	망우	7860	7471	20180208	15331
20180204	일산선	대화	7990	7341	20180207	15331
20180131	6호선	효창공원앞	7933	7394	20180203	15327
20180122	7호선	뚝섬유원지	7704	7619	20180125	15323
20180201	6호선	효창공원앞	7971	7351	20180204	15322
20180122	5호선	김포공항	8283	7028	20180125	15311
20180129	5호선	여의나루	7379	7931	20180201	15310
20180120	안산선	정왕	7760	7550	20180123	15310
20180205	2호선	양천구청	7505	7803	20180208	15308
20180205	일산선	원흥	8189	7118	20180208	15307
20180129	경원선	망월사	7663	7641	20180201	15304
20180119	5호선	개롱	7752	7552	20180122	15304
20180112	1호선	동묘앞	7464	7840	20180115	15304
20180126	경의선	행신	7860	7442	20180129	15302
20180113	경부선	남영	7553	7747	20180116	15300
20180117	일산선	원흥	8397	6901	20180120	15298
20180117	분당선	수원	9247	6050	20180120	15297
20180126	9호선	마곡나루	8089	7206	20180129	15295
20180119	5호선	양평	7626	7667	20180122	15293
20180112	9호선	마곡나루	8114	7178	20180115	15292
20180212	6호선	효창공원앞	7900	7391	20180215	15291
20180121	7호선	공릉(서울과학기술대)	7501	7790	20180124	15291
20180124	안산선	정왕	7387	7901	20180127	15288
20180128	5호선	군자(능동)	6577	8706	20180131	15283
20180121	일산선	대화	8098	7183	20180124	15281
20180112	과천선	경마공원	7641	7637	20180115	15278
20180208	5호선	김포공항	8271	7001	20180211	15272
20180205	9호선	마곡나루	7854	7418	20180208	15272
20180131	분당선	가천대	7068	8204	20180203	15272
20180123	9호선	마곡나루	7911	7359	20180126	15270
20180113	9호선	등촌	7757	7511	20180116	15268
20180123	중앙선	망우	7648	7619	20180126	15267
20180126	경부선	화서	7751	7512	20180129	15263
20180204	7호선	신중동	7833	7428	20180207	15261
20180122	경원선	가능	7816	7439	20180125	15255
20180115	5호선	개롱	7575	7675	20180118	15250
20180207	7호선	뚝섬유원지	7796	7450	20180210	15246
20180112	6호선	보문	8095	7150	20180115	15245
20180123	5호선	김포공항	8165	7074	20180126	15239
20180211	분당선	오리	7997	7234	20180214	15231
20180206	5호선	양평	7546	7684	20180209	15230
20180201	5호선	김포공항	8373	6854	20180204	15227
20180124	분당선	서울숲	7631	7596	20180127	15227
20180204	3호선	약수	7819	7407	20180207	15226
20180122	5호선	양평	7564	7662	20180125	15226
20180113	분당선	수원	9444	5782	20180116	15226
20180123	1호선	동묘앞	7449	7773	20180126	15222
20180212	3호선	도곡	7718	7502	20180215	15220
20180207	분당선	수원	9231	5989	20180210	15220
20180125	경원선	양주	8063	7154	20180128	15217
20180115	일산선	원흥	8278	6939	20180118	15217
20180121	경부선	독산	7462	7750	20180124	15212
20180128	과천선	평촌	7627	7584	20180131	15211
20180129	일산선	원흥	7997	7213	20180201	15210
20180127	5호선	굽은다리(강동구민회관앞)	7756	7446	20180130	15202
20180115	6호선	효창공원앞	7908	7289	20180118	15197
20180211	6호선	공덕	7667	7527	20180214	15194
20180113	공항철도 1호선	김포공항	9450	5743	20180116	15193
20180121	7호선	군자(능동)	9520	5671	20180124	15191
20180206	6호선	효창공원앞	7829	7359	20180209	15188
20180211	6호선	한강진	7377	7807	20180214	15184
20180211	경인선	오류동	7964	7215	20180214	15179
20180113	중앙선	망우	7537	7640	20180116	15177
20180113	8호선	강동구청	7586	7588	20180116	15174
20180204	4호선	신용산	7295	7877	20180207	15172
20180207	5호선	개롱	7570	7601	20180210	15171
20180206	중앙선	망우	7649	7522	20180209	15171
20180119	경의선	금촌	7758	7413	20180122	15171
20180121	공항철도 1호선	인천공항2터미널	7800	7368	20180124	15168
20180123	6호선	보문	7898	7268	20180126	15166
20180129	9호선	마곡나루	7810	7354	20180201	15164
20180119	3호선	도곡	7610	7553	20180122	15163
20180119	3호선	오금	8021	7141	20180122	15162
20180117	6호선	효창공원앞	7894	7268	20180120	15162
20180201	5호선	양평	7563	7596	20180204	15159
20180117	5호선	개롱	7537	7622	20180120	15159
20180123	5호선	여의나루	7215	7941	20180126	15156
20180201	분당선	가천대	7005	8149	20180204	15154
20180211	과천선	평촌	7659	7492	20180214	15151
20180115	5호선	양평	7550	7600	20180118	15150
20180113	경의선	일산	7617	7532	20180116	15149
20180124	경부선	군포	7558	7589	20180127	15147
20180212	5호선	개롱	7605	7540	20180215	15145
20180131	5호선	거여	7843	7302	20180203	15145
20180123	경의선	탄현	7755	7390	20180126	15145
20180206	2호선	양천구청	7317	7827	20180209	15144
20180127	과천선	정부과천청사	8114	7029	20180130	15143
20180115	5호선	김포공항	8168	6971	20180118	15139
20180208	경원선	가능	7614	7523	20180211	15137
20180129	경의선	탄현	7784	7353	20180201	15137
20180114	6호선	석계	7530	7606	20180117	15136
20180124	경원선	양주	8040	7095	20180127	15135
20180112	8호선	몽촌토성(평화의문)	7289	7846	20180115	15135
20180208	3호선	오금	7919	7205	20180211	15124
20180203	7호선	중곡	7761	7360	20180206	15121
20180119	경원선	가능	7881	7240	20180122	15121
20180130	3호선	도곡	7482	7635	20180202	15117
20180123	2호선	양천구청	7284	7827	20180126	15111
20180129	5호선	양평	7467	7642	20180201	15109
20180113	5호선	김포공항	7943	7163	20180116	15106
20180113	안산선	정왕	7485	7616	20180116	15101
20180127	2호선	아현	7731	7368	20180130	15099
20180118	7호선	뚝섬유원지	7651	7447	20180121	15098
20180208	경인선	온수(성공회대입구)	7563	7534	20180211	15097
20180212	8호선	몽촌토성(평화의문)	7346	7749	20180215	15095
20180122	분당선	수원	9090	6005	20180125	15095
20180203	8호선	복정	8438	6656	20180206	15094
20180126	경부선	군포	7619	7474	20180129	15093
20180128	경원선	회룡	7715	7376	20180131	15091
20180127	경부선	석수	7951	7134	20180130	15085
20180201	분당선	수원	9122	5958	20180204	15080
20180114	7호선	학동	7460	7620	20180117	15080
20180211	2호선	종합운동장	7257	7822	20180214	15079
20180121	6호선	석계	7464	7615	20180124	15079
20180131	경원선	가능	7704	7361	20180203	15065
20180117	5호선	양평	7542	7523	20180120	15065
20180123	5호선	방화	7739	7324	20180126	15063
20180130	분당선	수원	8960	6102	20180202	15062
20180119	공항철도 1호선	인천공항2터미널	8149	6913	20180122	15062
20180118	3호선	오금	7943	7118	20180121	15061
20180211	7호선	논현	7311	7749	20180214	15060
20180204	7호선	부천시청	7598	7458	20180207	15056
20180125	경부선	화서	7651	7404	20180128	15055
20180117	3호선	오금	7953	7100	20180120	15053
20180114	6호선	공덕	7848	7205	20180117	15053
20180130	5호선	김포공항	8500	6548	20180202	15048
20180124	8호선	몽촌토성(평화의문)	7284	7764	20180127	15048
20180126	1호선	동묘앞	7342	7699	20180129	15041
20180201	경원선	가능	7711	7326	20180204	15037
20180127	공항철도 1호선	계양	7733	7299	20180130	15032
20180206	일산선	원흥	8008	7018	20180209	15026
20180114	7호선	신풍	7740	7286	20180117	15026
20180125	경의선	행신	7762	7263	20180128	15025
20180124	분당선	기흥	7611	7414	20180127	15025
20180205	5호선	개롱	7415	7609	20180208	15024
20180129	6호선	한강진	6992	8031	20180201	15023
20180127	7호선	부평구청	8271	6751	20180130	15022
20180125	분당선	기흥	7640	7381	20180128	15021
20180124	5호선	여의나루	7339	7679	20180127	15018
20180123	6호선	구산	8306	6712	20180126	15018
20180212	분당선	서울숲	7499	7518	20180215	15017
20180204	경원선	회룡	7636	7381	20180207	15017
20180207	경원선	가능	7654	7358	20180210	15012
20180211	경원선	회룡	7578	7428	20180214	15006
20180128	분당선	오리	7982	7024	20180131	15006
20180204	6호선	공덕	7664	7337	20180207	15001
20180129	6호선	보문	7835	7166	20180201	15001
20180114	4호선	이촌(국립중앙박물관)	7209	7792	20180117	15001
20180201	5호선	거여	7725	7272	20180204	14997
20180112	분당선	가천대	7043	7952	20180115	14995
20180211	2호선	문래	7550	7441	20180214	14991
20180114	7호선	부천시청	7464	7522	20180117	14986
20180206	8호선	몽촌토성(평화의문)	7232	7753	20180209	14985
20180120	분당선	수원	9277	5706	20180123	14983
20180207	5호선	거여	7661	7321	20180210	14982
20180203	공항철도 1호선	디지털미디어시티	7858	7115	20180206	14973
20180205	8호선	몽촌토성(평화의문)	7145	7822	20180208	14967
20180212	7호선	뚝섬유원지	7609	7356	20180215	14965
20180127	경원선	방학	7579	7386	20180130	14965
20180203	경인선	백운	7597	7361	20180206	14958
20180126	분당선	서울숲	7568	7389	20180129	14957
20180125	분당선	서울숲	7446	7509	20180128	14955
20180124	경부선	화서	7522	7433	20180127	14955
20180114	6호선	새절(신사)	7509	7444	20180117	14953
20180130	3호선	오금	7795	7149	20180202	14944
20180112	5호선	김포공항	7931	7013	20180115	14944
20180204	경인선	오류동	7854	7089	20180207	14943
20180128	9호선2단계	봉은사	7779	7159	20180131	14938
20180123	경원선	망월사	7504	7434	20180126	14938
20180129	2호선	양천구청	7220	7715	20180201	14935
20180128	7호선	신중동	7619	7314	20180131	14933
20180128	6호선	공덕	7672	7256	20180131	14928
20180126	6호선	보문	7871	7055	20180129	14926
20180118	6호선	효창공원앞	7671	7254	20180121	14925
20180211	경부선	독산	7307	7616	20180214	14923
20180127	2호선	신정네거리	7334	7589	20180130	14923
20180206	분당선	가천대	6784	8135	20180209	14919
20180128	공항철도 1호선	홍대입구	7693	7226	20180131	14919
20180121	7호선	신풍	7631	7287	20180124	14918
20180211	2호선	시청	8310	6605	20180214	14915
20180121	일산선	원당	7614	7299	20180124	14913
20180118	경부선	당정	7684	7229	20180121	14913
20180122	분당선	서울숲	7485	7412	20180125	14897
20180112	5호선	방화	7787	7110	20180115	14897
20180113	7호선	중곡	7735	7160	20180116	14895
20180120	6호선	신당	8347	6541	20180123	14888
20180125	5호선	김포공항	8214	6671	20180128	14885
20180123	일산선	원흥	7855	7030	20180126	14885
20180211	6호선	석계	7510	7374	20180214	14884
20180114	2호선	상왕십리	7638	7244	20180117	14882
20180127	6호선	화랑대(서울여대입구)	8328	6552	20180130	14880
20180115	경부선	당정	7628	7248	20180118	14876
20180127	경부선	가산디지털단지	6317	8554	20180130	14871
20180118	6호선	삼각지	8063	6806	20180121	14869
20180124	9호선	마곡나루	7740	7122	20180127	14862
20180113	과천선	정부과천청사	7967	6895	20180116	14862
20180120	5호선	김포공항	7637	7223	20180123	14860
20180207	경의선	탄현	7552	7306	20180210	14858
20180129	8호선	몽촌토성(평화의문)	7200	7658	20180201	14858
20180114	일산선	정발산	7403	7453	20180117	14856
20180129	5호선	방화	7666	7184	20180201	14850
20180113	경원선	신이문	7895	6955	20180116	14850
20180119	5호선	거여	7763	7084	20180122	14847
20180123	5호선	양평	7340	7504	20180126	14844
20180211	4호선	신용산	7229	7613	20180214	14842
20180120	공항철도 1호선	검암	7400	7441	20180123	14841
20180129	분당선	도곡	7308	7531	20180201	14839
20180203	경원선	신이문	7807	7029	20180206	14836
20180204	공항철도 1호선	홍대입구	7609	7223	20180207	14832
20180121	3호선	동대입구	7120	7707	20180124	14827
20180129	6호선	구산	8262	6564	20180201	14826
20180125	경부선	군포	7366	7460	20180128	14826
20180112	분당선	서울숲	7539	7286	20180115	14825
20180203	8호선	문정	7512	7311	20180206	14823
20180122	6호선	효창공원앞	7644	7178	20180125	14822
20180125	6호선	보문	7788	7031	20180128	14819
20180205	분당선	수원	8936	5881	20180208	14817
20180114	7호선	군자(능동)	9391	5420	20180117	14811
20180113	8호선	복정	8201	6609	20180116	14810
20180114	경부선	천안	7531	7278	20180117	14809
20180126	8호선	몽촌토성(평화의문)	7195	7613	20180129	14808
20180212	분당선	가천대	6771	8033	20180215	14804
20180130	5호선	거여	7544	7255	20180202	14799
20180203	경부선	남영	7170	7624	20180206	14794
20180128	7호선	부천시청	7438	7356	20180131	14794
20180126	5호선	여의나루	7324	7470	20180129	14794
20180128	4호선	이촌(국립중앙박물관)	7145	7641	20180131	14786
20180115	3호선	오금	7902	6881	20180118	14783
20180127	경인선	제물포	7576	7205	20180130	14781
20180126	경부선	관악	7604	7177	20180129	14781
20180128	일산선	정발산	7368	7412	20180131	14780
20180211	7호선	공릉(서울과학기술대)	7290	7488	20180214	14778
20180117	경부선	당정	7538	7238	20180120	14776
20180204	6호선	한강진	7059	7716	20180207	14775
20180119	공항철도 1호선	운서	7318	7457	20180122	14775
20180122	5호선	개롱	7219	7551	20180125	14770
20180115	분당선	서울숲	7400	7367	20180118	14767
20180203	경원선	양주	7950	6811	20180206	14761
20180112	경부선	당정	7641	7118	20180115	14759
20180122	3호선	오금	7807	6951	20180125	14758
20180203	9호선	흑석(중앙대입구)	7307	7445	20180206	14752
20180124	경의선	행신	7608	7141	20180127	14749
20180129	5호선	개롱	7359	7387	20180201	14746
20180211	7호선	신풍	7568	7176	20180214	14744
20180127	7호선	굴포천	7168	7575	20180130	14743
20180124	6호선	보문	7718	7025	20180127	14743
20180123	분당선	도곡	7290	7450	20180126	14740
20180121	8호선	남한산성입구(성남법원.검찰청)	7692	7047	20180124	14739
20180206	경의선	탄현	7553	7185	20180209	14738
20180125	중앙선	망우	7395	7341	20180128	14736
20180211	일산선	백석	7565	7170	20180214	14735
20180125	8호선	몽촌토성(평화의문)	6975	7756	20180128	14731
20180120	공항철도 1호선	디지털미디어시티	7606	7124	20180123	14730
20180112	경원선	망월사	7399	7331	20180115	14730
20180204	7호선	공릉(서울과학기술대)	7205	7517	20180207	14722
20180129	3호선	독립문	7293	7429	20180201	14722
20180127	5호선	상일동	7797	6924	20180130	14721
20180211	일산선	대화	7727	6984	20180214	14711
20180206	분당선	수원	8843	5868	20180209	14711
20180203	5호선	김포공항	7836	6873	20180206	14709
20180124	중앙선	망우	7362	7347	20180127	14709
20180112	분당선	도곡	7338	7363	20180115	14701
20180129	5호선	김포공항	7951	6747	20180201	14698
20180113	3호선	독립문	7364	7334	20180116	14698
20180212	경부선	당정	7496	7200	20180215	14696
20180118	5호선	양평	7331	7360	20180121	14691
20180127	5호선	둔촌동	7513	7175	20180130	14688
20180114	7호선	숭실대입구(살피재)	7208	7478	20180117	14686
20180205	분당선	서울숲	7362	7317	20180208	14679
20180211	2호선	잠실나루	7206	7469	20180214	14675
20180204	6호선	새절(신사)	7288	7386	20180207	14674
20180125	9호선	마곡나루	7572	7100	20180128	14672
20180206	3호선	도곡	7414	7250	20180209	14664
20180117	3호선	도곡	7324	7339	20180120	14663
20180205	경의선	탄현	7468	7192	20180208	14660
20180127	5호선	김포공항	7716	6944	20180130	14660
20180131	공항철도 1호선	운서	7129	7529	20180203	14658
20180127	3호선	가락시장	7607	7051	20180130	14658
20180125	1호선	동묘앞	7222	7419	20180128	14641
20180112	5호선	양평	7368	7273	20180115	14641
20180131	3호선	도곡	7393	7246	20180203	14639
20180206	7호선	뚝섬유원지	7481	7157	20180209	14638
20180121	3호선	대치	7683	6955	20180124	14638
20180129	분당선	수원	8836	5799	20180201	14635
20180131	경부선	당정	7495	7138	20180203	14633
20180201	3호선	오금	7710	6916	20180204	14626
20180121	5호선	신정(은행정)	7723	6900	20180124	14623
20180125	3호선	독립문	7261	7358	20180128	14619
20180124	5호선	김포공항	7981	6637	20180127	14618
20180123	분당선	수원	8909	5709	20180126	14618
20180128	경인선	오류동	7752	6864	20180131	14616
20180128	7호선	신풍	7474	7140	20180131	14614
20180212	3호선	오금	7643	6970	20180215	14613
20180124	5호선	방화	7425	7186	20180127	14611
20180114	분당선	망포	7158	7452	20180117	14610
20180113	경원선	양주	7994	6616	20180116	14610
20180204	5호선	군자(능동)	6354	8255	20180207	14609
20180121	2호선	상왕십리	7406	7202	20180124	14608
20180114	7호선	상도	7553	7055	20180117	14608
20180128	5호선	광나루(장신대)	7494	7112	20180131	14606
20180205	5호선	거여	7482	7123	20180208	14605
20180208	5호선	거여	7524	7079	20180211	14603
20180129	6호선	효창공원앞	7577	7023	20180201	14600
20180123	7호선	뚝섬유원지	7416	7184	20180126	14600
20180131	3호선	오금	7716	6882	20180203	14598
20180120	8호선	석촌	7230	7364	20180123	14594
20180205	분당선	가천대	6699	7892	20180208	14591
20180125	경부선	관악	7560	7028	20180128	14588
20180121	일산선	정발산	7231	7354	20180124	14585
20180205	3호선	도곡	7432	7148	20180208	14580
20180128	7호선	공릉(서울과학기술대)	7199	7378	20180131	14577
20180124	경부선	관악	7498	7076	20180127	14574
20180124	경원선	망월사	7250	7322	20180127	14572
20180203	8호선	석촌	7244	7327	20180206	14571
20180128	2호선	문래	7151	7420	20180131	14571
20180113	5호선	올림픽공원(한국체대)	7426	7142	20180116	14568
20180128	6호선	새절(신사)	7286	7281	20180131	14567
20180203	중앙선	망우	7332	7234	20180206	14566
20180117	경원선	가능	7459	7107	20180120	14566
20180211	일산선	정발산	7196	7369	20180214	14565
20180122	경의선	금촌	7332	7233	20180125	14565
20180208	3호선	도곡	7350	7211	20180211	14561
20180204	5호선	광나루(장신대)	7581	6980	20180207	14561
20180211	5호선	군자(능동)	6328	8232	20180214	14560
20180121	2호선	시청	8122	6435	20180124	14557
20180211	2호선	상왕십리	7413	7143	20180214	14556
20180121	경부선	천안	7465	7091	20180124	14556
20180126	5호선	양평	7296	7259	20180129	14555
20180208	경원선	지행	7376	7170	20180211	14546
20180119	경의선	백마	7567	6976	20180122	14543
20180212	경원선	가능	7503	7039	20180215	14542
20180114	2호선	뚝섬	7177	7362	20180117	14539
20180112	2호선	양천구청	7080	7459	20180115	14539
20180205	5호선	김포공항	7791	6745	20180208	14536
20180126	3호선	독립문	7247	7288	20180129	14535
20180122	경부선	당정	7460	7074	20180125	14534
20180203	경부선	천안	7354	7174	20180206	14528
20180120	3호선	교대(법원.검찰청)	8767	5756	20180123	14523
20180129	분당선	서울숲	7296	7226	20180201	14522
20180122	5호선	거여	7423	7096	20180125	14519
20180114	5호선	여의도	6932	7585	20180117	14517
20180126	5호선	개롱	7262	7254	20180129	14516
20180114	경원선	외대앞	7464	7051	20180117	14515
20180211	7호선	학동	7146	7368	20180214	14514
20180119	경원선	도봉	7386	7127	20180122	14513
20180119	7호선	까치울	7607	6903	20180122	14510
20180206	5호선	김포공항	7932	6577	20180209	14509
20180208	경부선	당정	7382	7121	20180211	14503
20180117	5호선	거여	7511	6992	20180120	14503
20180124	5호선	양평	7234	7267	20180127	14501
20180118	5호선	거여	7458	7042	20180121	14500
20180207	3호선	오금	7702	6796	20180210	14498
20180122	3호선	도곡	7241	7257	20180125	14498
20180211	분당선	망포	7081	7416	20180214	14497
20180207	3호선	도곡	7313	7182	20180210	14495
20180128	7호선	학동	7154	7339	20180131	14493
20180126	5호선	방화	7483	7010	20180129	14493
20180212	5호선	마장	7430	7062	20180215	14492
20180204	2호선	잠실나루	7205	7283	20180207	14488
20180115	경원선	가능	7461	7018	20180118	14479
20180208	7호선	까치울	7523	6954	20180211	14477
20180206	5호선	개롱	7119	7358	20180209	14477
20180206	3호선	오금	7619	6855	20180209	14474
20180120	경부선	신길	8045	6428	20180123	14473
20180204	2호선	상왕십리	7269	7200	20180207	14469
20180120	경부선	명학	7272	7195	20180123	14467
20180204	8호선	남한산성입구(성남법원.검찰청)	7566	6897	20180207	14463
20180113	8호선	석촌	7082	7381	20180116	14463
20180203	6호선	신당	8055	6401	20180206	14456
20180126	7호선	뚝섬유원지	7348	7105	20180129	14453
20180125	5호선	방화	7405	7046	20180128	14451
20180201	경의선	금촌	7298	7151	20180204	14449
20180114	일산선	원당	7324	7123	20180117	14447
20180204	6호선	석계	7157	7287	20180207	14444
20180211	3호선	대치	7587	6852	20180214	14439
20180203	분당선	수원	8913	5525	20180206	14438
20180113	3호선	교대(법원.검찰청)	8827	5601	20180116	14428
20180207	경부선	당정	7337	7090	20180210	14427
20180211	6호선	새절(신사)	7239	7183	20180214	14422
20180125	경원선	망월사	7197	7225	20180128	14422
20180113	안산선	한대앞	7487	6930	20180116	14417
20180118	3호선	도곡	7173	7242	20180121	14415
20180115	5호선	거여	7453	6962	20180118	14415
20180127	일산선	주엽	7220	7194	20180130	14414
20180114	경원선	석계	6935	7477	20180117	14412
20180112	경의선	탄현	7364	7048	20180115	14412
20180118	경의선	백마	7430	6981	20180121	14411
20180129	7호선	뚝섬유원지	7374	7033	20180201	14407
20180208	7호선	반포	7293	7113	20180211	14406
20180125	5호선	양평	7176	7224	20180128	14400
20180118	경원선	가능	7326	7070	20180121	14396
20180121	6호선	마포구청	7542	6853	20180124	14395
20180128	5호선	여의도	6913	7480	20180131	14393
20180125	6호선	구산	8055	6337	20180128	14392
20180201	3호선	도곡	7279	7112	20180204	14391
20180206	5호선	거여	7418	6972	20180209	14390
20180124	6호선	구산	7995	6393	20180127	14388
20180201	경인선	온수(성공회대입구)	7279	7108	20180204	14387
20180207	경인선	온수(성공회대입구)	7219	7164	20180210	14383
20180201	경부선	당정	7297	7083	20180204	14380
20180126	분당선	도곡	7160	7220	20180129	14380
20180120	9호선	흑석(중앙대입구)	7012	7367	20180123	14379
20180208	5호선	마장	7330	7048	20180211	14378
20180205	경원선	가능	7323	7055	20180208	14378
20180113	공항철도 1호선	검암	7072	7302	20180116	14374
20180212	5호선	거여	7446	6924	20180215	14370
20180204	경원선	외대앞	7539	6831	20180207	14370
20180125	5호선	여의나루	6859	7510	20180128	14369
20180113	6호선	삼각지	8354	6014	20180116	14368
20180126	6호선	구산	8069	6282	20180129	14351
20180115	3호선	도곡	7268	7076	20180118	14344
20180114	9호선2단계	봉은사	7376	6965	20180117	14341
20180131	경원선	지행	7177	7163	20180203	14340
20180128	6호선	석계	7113	7225	20180131	14338
20180211	2호선	뚝섬	7041	7296	20180214	14337
20180120	3호선	금호	7480	6851	20180123	14331
20180128	일산선	백석	7358	6972	20180131	14330
20180114	5호선	신정(은행정)	7632	6695	20180117	14327
20180208	경의선	백마	7422	6904	20180211	14326
20180125	경의선	탄현	7306	7020	20180128	14326
20180127	5호선	송정	7170	7155	20180130	14325
20180127	경인선	중동	7384	6941	20180130	14325
20180113	공항철도 1호선	디지털미디어시티	7514	6808	20180116	14322
20180212	7호선	반포	7257	7054	20180215	14311
20180204	일산선	백석	7336	6974	20180207	14310
20180113	9호선	흑석(중앙대입구)	7149	7161	20180116	14310
20180206	경원선	가능	7334	6973	20180209	14307
20180112	6호선	구산	8135	6172	20180115	14307
20180120	경부선	관악	7307	6999	20180123	14306
20180125	분당선	도곡	7062	7241	20180128	14303
20180130	경부선	당정	7352	6943	20180202	14295
20180114	경부선	독산	7031	7264	20180117	14295
20180125	일산선	원흥	7601	6691	20180128	14292
20180119	경부선	천안	7251	7041	20180122	14292
20180120	경의선	금촌	7459	6828	20180123	14287
20180117	경원선	지행	7150	7136	20180120	14286
20180112	경인선	구일	6505	7781	20180115	14286
20180117	7호선	까치울	7307	6976	20180120	14283
20180128	2호선	상왕십리	7199	7080	20180131	14279
20180205	3호선	오금	7599	6679	20180208	14278
20180121	7호선	숭실대입구(살피재)	6953	7324	20180124	14277
20180203	안산선	정왕	7038	7237	20180206	14275
20180118	공항철도 1호선	운서	7027	7247	20180121	14274
20180120	6호선	삼각지	8311	5962	20180123	14273
20180122	경의선	백마	7289	6983	20180125	14272
20180117	경의선	백마	7389	6881	20180120	14270
20180125	분당선	수원	8636	5632	20180128	14268
20180117	경인선	온수(성공회대입구)	7154	7107	20180120	14261
20180204	5호선	신정(은행정)	7446	6814	20180207	14260
20180128	8호선	남한산성입구(성남법원.검찰청)	7486	6773	20180131	14259
20180204	7호선	신풍	7258	6996	20180207	14254
20180131	7호선	까치울	7416	6836	20180203	14252
20180131	경인선	온수(성공회대입구)	7162	7090	20180203	14252
20180119	7호선	반포	7344	6901	20180122	14245
20180205	7호선	뚝섬유원지	7222	7019	20180208	14241
20180130	9호선	샛강	7057	7166	20180202	14223
20180125	6호선	효창공원앞	7302	6919	20180128	14221
20180203	안산선	한대앞	7287	6933	20180206	14220
20180121	경원선	도봉산	8342	5874	20180124	14216
20180117	경원선	도봉	7267	6948	20180120	14215
20180208	5호선	신금호	7027	7187	20180211	14214
20180119	수인선	인천논현	6941	7271	20180122	14212
20180127	9호선	등촌	7108	7100	20180130	14208
20180207	7호선	반포	7174	7032	20180210	14206
20180120	8호선	문정	7208	6990	20180123	14198
20180211	7호선	숭실대입구(살피재)	6963	7230	20180214	14193
20180128	2호선	잠실나루	7075	7118	20180131	14193
20180122	공항철도 1호선	운서	6795	7398	20180125	14193
20180211	6호선	마포구청	7480	6710	20180214	14190
20180130	경원선	가능	7193	6993	20180202	14186
20180126	경의선	탄현	7251	6931	20180129	14182
20180117	7호선	반포	7117	7061	20180120	14178
20180117	6호선	삼각지	7714	6464	20180120	14178
20180207	7호선	까치울	7355	6822	20180210	14177
20180125	2호선	양천구청	6850	7326	20180128	14176
20180115	경의선	금촌	7105	7071	20180118	14176
20180114	3호선	대치	7392	6781	20180117	14173
20180124	2호선	양천구청	6827	7341	20180127	14168
20180127	경인선	부개	7344	6819	20180130	14163
20180211	일산선	원당	7184	6978	20180214	14162
20180130	7호선	용마산	7172	6988	20180202	14160
20180112	5호선	개롱	7143	7011	20180115	14154
20180113	경부선	신길	7894	6257	20180116	14151
20180123	6호선	효창공원앞	7312	6838	20180126	14150
20180120	7호선	태릉입구	7476	6671	20180123	14147
20180126	경원선	망월사	7193	6953	20180129	14146
20180128	7호선	군자(능동)	8831	5312	20180131	14143
20180123	6호선	한강진	6436	7707	20180126	14143
20180128	5호선	신정(은행정)	7521	6621	20180131	14142
20180128	공항철도 1호선	김포공항	8699	5437	20180131	14136
20180127	8호선	강동구청	7051	7085	20180130	14136
20180121	7호선	도봉산	5772	8363	20180124	14135
20180122	경원선	도봉	7145	6983	20180125	14128
20180131	경원선	도봉	7145	6982	20180203	14127
20180129	5호선	거여	7281	6846	20180201	14127
20180129	3호선	오금	7505	6622	20180201	14127
20180120	경원선	도봉산	8579	5543	20180123	14122
20180205	경부선	당정	7197	6917	20180208	14114
20180126	2호선	양천구청	6766	7334	20180129	14100
20180126	일산선	원흥	7586	6512	20180129	14098
20180203	경부선	신길	7902	6193	20180206	14095
20180128	6호선	마포구청	7360	6732	20180131	14092
20180124	분당선	도곡	6917	7172	20180127	14089
20180120	경원선	광운대	7272	6817	20180123	14089
20180207	5호선	마장	7173	6914	20180210	14087
20180121	분당선	망포	6863	7221	20180124	14084
20180122	7호선	까치울	7258	6825	20180125	14083
20180127	6호선	녹사평(용산구청)	6486	7594	20180130	14080
20180121	공항철도 1호선	김포공항	8597	5482	20180124	14079
20180205	경인선	온수(성공회대입구)	7033	7045	20180208	14078
20180115	경의선	백마	7352	6725	20180118	14077
20180127	7호선	중곡	7289	6787	20180130	14076
20180124	분당선	수원	8437	5639	20180127	14076
20180128	7호선	숭실대입구(살피재)	6781	7292	20180131	14073
20180119	경인선	온수(성공회대입구)	7055	7018	20180122	14073
20180121	경원선	석계	6743	7320	20180124	14063
20180201	7호선	까치울	7300	6762	20180204	14062
20180124	일산선	원흥	7474	6583	20180127	14057
20180201	공항철도 1호선	운서	6967	7086	20180204	14053
20180121	2호선	뚝섬	6966	7085	20180124	14051
20180130	7호선	까치울	7202	6846	20180202	14048
20180203	7호선	보라매	7004	7043	20180206	14047
20180118	7호선	까치울	7307	6739	20180121	14046
20180112	3호선	오금	7439	6607	20180115	14046
20180120	경의선	일산	7071	6969	20180123	14040
20180121	6호선	동묘앞	7323	6707	20180124	14030
20180212	7호선	까치울	7268	6760	20180215	14028
20180204	7호선	숭실대입구(살피재)	6905	7120	20180207	14025
20180208	경인선	간석	7281	6741	20180211	14022
20180124	3호선	독립문	6981	7039	20180127	14020
20180131	경의선	금촌	7057	6961	20180203	14018
20180117	경인선	간석	7237	6780	20180120	14017
20180211	5호선	신정(은행정)	7381	6633	20180214	14014
20180112	6호선	효창공원앞	7238	6771	20180115	14009
20180204	3호선	대치	7415	6590	20180207	14005
20180117	경의선	금촌	7055	6949	20180120	14004
20180127	8호선	복정	7735	6268	20180130	14003
20180120	일산선	마두	6910	7087	20180123	13997
20180120	5호선	고덕	7129	6866	20180123	13995
20180118	경인선	온수(성공회대입구)	7100	6894	20180121	13994
20180131	6호선	삼각지	7536	6457	20180203	13993
20180130	경의선	백마	6897	7093	20180202	13990
20180121	경원선	외대앞	7161	6828	20180124	13989
20180120	경부선	화서	7038	6950	20180123	13988
20180118	경의선	금촌	7074	6914	20180121	13988
20180203	공항철도 1호선	검암	6897	7086	20180206	13983
20180126	6호선	한강진	6270	7707	20180129	13977
20180203	5호선	명일	6961	7015	20180206	13976
20180203	3호선	교대(법원.검찰청)	8491	5483	20180206	13974
20180118	경원선	도봉	7094	6880	20180121	13974
20180131	7호선	반포	7084	6887	20180203	13971
20180130	3호선	잠원	6883	7088	20180202	13971
20180127	안산선	오이도	7130	6835	20180130	13965
20180208	경원선	도봉	7123	6840	20180211	13963
20180123	3호선	오금	7417	6541	20180126	13958
20180127	6호선	한강진	6288	7668	20180130	13956
20180127	6호선	신당	7899	6056	20180130	13955
20180211	8호선	남한산성입구(성남법원.검찰청)	7317	6634	20180214	13951
20180206	7호선	까치울	7225	6723	20180209	13948
20180113	6호선	신당	7780	6164	20180116	13944
20180127	경인선	백운	7045	6896	20180130	13941
20180208	경의선	금촌	7076	6864	20180211	13940
20180203	경부선	명학	7032	6907	20180206	13939
20180122	경원선	지행	7042	6897	20180125	13939
20180205	7호선	반포	7008	6927	20180208	13935
20180131	경의선	백마	7276	6655	20180203	13931
20180204	7호선	군자(능동)	8734	5194	20180207	13928
20180130	5호선	마장	7109	6818	20180202	13927
20180204	5호선	여의도	6740	7186	20180207	13926
20180125	5호선	개롱	6832	7092	20180128	13924
20180115	경원선	지행	6999	6925	20180118	13924
20180208	공항철도 1호선	운서	6888	7033	20180211	13921
20180201	경인선	간석	7176	6742	20180204	13918
20180123	경부선	당정	7095	6820	20180126	13915
20180115	경인선	온수(성공회대입구)	6925	6988	20180118	13913
20180126	3호선	오금	7403	6509	20180129	13912
20180121	6호선	한강진	6629	7282	20180124	13911
20180121	경원선	방학	7088	6820	20180124	13908
20180118	경원선	지행	7048	6860	20180121	13908
20180127	분당선	수원	8444	5463	20180130	13907
20180212	경의선	백마	7267	6639	20180215	13906
20180206	경부선	당정	7098	6799	20180209	13897
20180124	6호선	효창공원앞	7132	6765	20180127	13897
20180131	5호선	마장	7180	6714	20180203	13894
20180123	5호선	개롱	6796	7098	20180126	13894
20180127	7호선	도봉산	6035	7858	20180130	13893
20180112	일산선	원흥	7736	6152	20180115	13888
20180201	7호선	반포	6941	6945	20180204	13886
20180130	7호선	반포	7042	6843	20180202	13885
20180112	3호선	도곡	7018	6865	20180115	13883
20180115	7호선	까치울	7218	6664	20180118	13882
20180119	경인선	간석	7246	6632	20180122	13878
20180201	경원선	지행	7037	6840	20180204	13877
20180130	6호선	삼각지	7598	6277	20180202	13875
20180118	7호선	반포	6904	6969	20180121	13873
20180114	6호선	마포구청	7366	6503	20180117	13869
20180113	8호선	문정	7096	6771	20180116	13867
20180211	7호선	군자(능동)	8611	5249	20180214	13860
20180124	7호선	뚝섬유원지	7053	6805	20180127	13858
20180121	5호선	여의도	6556	7300	20180124	13856
20180204	분당선	망포	6846	6997	20180207	13843
20180115	경원선	도봉	7071	6766	20180118	13837
20180124	1호선	동묘앞	6766	7068	20180127	13834
20180207	경원선	지행	6921	6909	20180210	13830
20180201	경의선	백마	7169	6660	20180204	13829
20180129	경부선	당정	7077	6749	20180201	13826
20180126	6호선	효창공원앞	7215	6605	20180129	13820
20180204	4호선	이촌(국립중앙박물관)	6600	7215	20180207	13815
20180124	6호선	한강진	6266	7549	20180127	13815
20180211	경원선	외대앞	7114	6700	20180214	13814
20180112	6호선	삼각지	7526	6283	20180115	13809
20180204	일산선	원당	6968	6837	20180207	13805
20180120	중앙선	도농	7302	6502	20180123	13804
20180123	5호선	거여	7108	6693	20180126	13801
20180113	5호선	고덕	7099	6696	20180116	13795
20180204	경부선	독산	6743	7048	20180207	13791
20180120	6호선	대흥(서강대앞)	6784	7005	20180123	13789
20180127	경부선	천안	7026	6760	20180130	13786
20180206	5호선	마장	6953	6828	20180209	13781
20180128	일산선	원당	6968	6813	20180131	13781
20180124	5호선	개롱	6728	7050	20180127	13778
20180119	5호선	마장	7129	6648	20180122	13777
20180212	경의선	금촌	6970	6803	20180215	13773
20180207	경의선	백마	7168	6605	20180210	13773
20180203	6호선	고려대(종암)	6831	6942	20180206	13773
20180129	경원선	가능	7105	6668	20180201	13773
20180113	경의선	금촌	7258	6512	20180116	13770
20180130	공항철도 1호선	운서	6729	7037	20180202	13766
20180130	경인선	온수(성공회대입구)	6802	6963	20180202	13765
20180115	7호선	반포	6881	6884	20180118	13765
20180124	3호선	오금	7208	6556	20180127	13764
20180119	3호선	잠원	7059	6705	20180122	13764
20180128	분당선	망포	6676	7086	20180131	13762
20180207	공항철도 1호선	운서	6788	6972	20180210	13760
20180206	5호선	신금호	6785	6973	20180209	13758
20180127	7호선	보라매	7001	6754	20180130	13755
20180127	중앙선	망우	6855	6892	20180130	13747
20180207	5호선	신금호	6883	6863	20180210	13746
20180123	경원선	가능	7078	6667	20180126	13745
20180112	5호선	올림픽공원(한국체대)	6730	7015	20180115	13745
20180118	경인선	간석	7081	6660	20180121	13741
20180112	7호선	뚝섬유원지	7068	6673	20180115	13741
20180203	3호선	독립문	6793	6947	20180206	13740
20180203	3호선	금호	7169	6568	20180206	13737
20180128	2호선	뚝섬	6674	7063	20180131	13737
20180124	경의선	탄현	6972	6765	20180127	13737
20180131	3호선	잠원	7096	6640	20180203	13736
20180128	공항철도 1호선	인천공항2터미널	7200	6525	20180131	13725
20180208	경인선	구일	6856	6868	20180211	13724
20180125	7호선	뚝섬유원지	7001	6713	20180128	13714
20180129	3호선	도곡	6910	6798	20180201	13708
20180208	6호선	녹사평(용산구청)	6745	6961	20180211	13706
20180212	경인선	온수(성공회대입구)	6877	6828	20180215	13705
20180201	5호선	마장	7027	6674	20180204	13701
20180119	9호선2단계	종합운동장	7545	6153	20180122	13698
20180117	경인선	구일	6817	6878	20180120	13695
20180120	6호선	봉화산(서울의료원)	7058	6634	20180123	13692
20180120	경부선	의왕	7043	6649	20180123	13692
20180117	공항철도 1호선	운서	6762	6926	20180120	13688
20180203	6호선	돌곶이	7089	6598	20180206	13687
20180131	7호선	용마산	7103	6584	20180203	13687
20180128	3호선	대치	7109	6578	20180131	13687
20180203	5호선	고덕	7023	6660	20180206	13683
20180117	수인선	인천논현	6699	6984	20180120	13683
20180114	경부선	금천구청	6999	6684	20180117	13683
20180203	7호선	온수(성공회대입구)	6872	6804	20180206	13676
20180205	7호선	까치울	7122	6552	20180208	13674
20180203	6호선	삼각지	8059	5607	20180206	13666
20180206	경인선	온수(성공회대입구)	6934	6731	20180209	13665
20180201	경원선	도봉	6943	6721	20180204	13664
20180115	공항철도 1호선	운서	6652	7011	20180118	13663
20180127	9호선	흑석(중앙대입구)	6873	6778	20180130	13651
20180112	5호선	거여	7107	6544	20180115	13651
20180131	경인선	구일	6782	6860	20180203	13642
20180125	3호선	오금	7227	6413	20180128	13640
20180207	경원선	도봉	6898	6741	20180210	13639
20180130	경원선	도봉	6898	6741	20180202	13639
20180119	중앙선	덕소	6857	6776	20180122	13633
20180130	5호선	신금호	6603	7029	20180202	13632
20180127	안산선	고잔	6866	6761	20180130	13627
20180122	경인선	간석	6965	6659	20180125	13624
20180204	일산선	정발산	6886	6737	20180207	13623
20180131	경인선	간석	6949	6674	20180203	13623
20180206	7호선	반포	6914	6701	20180209	13615
20180205	경원선	지행	7023	6588	20180208	13611
20180208	7호선	용마산	7097	6504	20180211	13601
20180125	6호선	한강진	6193	7408	20180128	13601
20180207	경인선	간석	7017	6580	20180210	13597
20180119	경인선	구일	6900	6691	20180122	13591
20180115	3호선	잠원	6963	6628	20180118	13591
20180203	일산선	마두	6707	6883	20180206	13590
20180115	경인선	구일	6756	6834	20180118	13590
20180203	경원선	광운대	6888	6700	20180206	13588
20180121	경부선	금천구청	6977	6611	20180124	13588
20180120	경원선	지행	6815	6768	20180123	13583
20180212	경인선	간석	6972	6600	20180215	13572
20180115	경인선	간석	6994	6575	20180118	13569
20180113	경부선	관악	6904	6664	20180116	13568
20180113	6호선	돌곶이	6921	6642	20180116	13563
20180205	5호선	마장	6858	6703	20180208	13561
20180127	안산선	한대앞	6951	6609	20180130	13560
20180128	경부선	독산	6652	6907	20180131	13559
20180201	5호선	신금호	6769	6789	20180204	13558
20180113	중앙선	도농	7123	6435	20180116	13558
20180119	경의선	문산	6773	6782	20180122	13555
20180203	경부선	관악	6885	6667	20180206	13552
20180118	수인선	인천논현	6706	6844	20180121	13550
20180113	분당선	선릉	4215	9333	20180116	13548
20180127	안산선	정왕	6836	6711	20180130	13547
20180123	3호선	도곡	6812	6733	20180126	13545
20180130	9호선2단계	삼성중앙	6864	6677	20180202	13541
20180118	5호선	마장	6951	6589	20180121	13540
20180205	경의선	백마	7020	6514	20180208	13534
20180207	3호선	잠원	6846	6685	20180210	13531
20180131	5호선	신금호	6797	6734	20180203	13531
20180114	안산선	정왕	6482	7049	20180117	13531
20180117	7호선	용마산	7027	6499	20180120	13526
20180113	경부선	화서	6906	6620	20180116	13526
20180113	5호선	명일	6850	6674	20180116	13524
20180126	6호선	삼각지	7382	6140	20180129	13522
20180123	6호선	삼각지	7319	6203	20180126	13522
20180123	경의선	백마	6966	6554	20180126	13520
20180212	중앙선	상봉(시외버스터미널)	6578	6939	20180215	13517
20180211	5호선	여의도	6511	7000	20180214	13511
20180122	7호선	반포	6734	6777	20180125	13511
20180205	5호선	신금호	6687	6823	20180208	13510
20180212	경원선	지행	6856	6650	20180215	13506
20180120	7호선	온수(성공회대입구)	6812	6694	20180123	13506
20180121	6호선	월곡(동덕여대)	6781	6722	20180124	13503
20180118	중앙선	덕소	6739	6760	20180121	13499
20180117	3호선	잠원	6841	6658	20180120	13499
20180120	경원선	망월사	6795	6703	20180123	13498
20180114	경부선	가산디지털단지	5832	7664	20180117	13496
20180126	5호선	거여	6922	6572	20180129	13494
20180121	안산선	정왕	6325	7161	20180124	13486
20180207	7호선	용마산	6949	6534	20180210	13483
20180113	경부선	명학	6781	6702	20180116	13483
20180119	7호선	용마산	7111	6365	20180122	13476
20180118	경인선	구일	6780	6695	20180121	13475
20180127	8호선	석촌	6586	6888	20180130	13474
20180127	공항철도 1호선	검암	6669	6805	20180130	13474
20180204	2호선	뚝섬	6643	6828	20180207	13471
20180114	7호선	도봉산	5648	7823	20180117	13471
20180204	6호선	마포구청	7041	6429	20180207	13470
20180115	6호선	한강진	6158	7312	20180118	13470
20180212	9호선	샛강	6510	6958	20180215	13468
20180113	일산선	마두	6677	6789	20180116	13466
20180208	중앙선	덕소	6779	6685	20180211	13464
20180113	3호선	금호	7021	6441	20180116	13462
20180212	3호선	잠원	6833	6622	20180215	13455
20180131	중앙선	덕소	6854	6600	20180203	13454
20180123	공항철도 1호선	운서	6684	6770	20180126	13454
20180203	분당선	강남구청	6111	7342	20180206	13453
20180113	7호선	보라매	6811	6642	20180116	13453
20180117	5호선	개화산	7020	6432	20180120	13452
20180201	3호선	잠원	6889	6562	20180204	13451
20180203	중앙선	도농	7065	6382	20180206	13447
20180119	4호선	삼각지	6170	7276	20180122	13446
20180114	7호선	강남구청	6627	6813	20180117	13440
20180128	경원선	외대앞	6860	6579	20180131	13439
20180208	3호선	잠원	6863	6575	20180211	13438
20180207	수인선	인천논현	6605	6833	20180210	13438
20180204	2호선	시청	7587	5845	20180207	13432
20180112	경원선	지행	6760	6671	20180115	13431
20180131	5호선	개화산	6955	6475	20180203	13430
20180206	공항철도 1호선	운서	6607	6821	20180209	13428
20180118	3호선	잠원	6846	6582	20180121	13428
20180130	9호선2단계	종합운동장	7218	6209	20180202	13427
20180117	5호선	마장	6923	6502	20180120	13425
20180207	경의선	금촌	6780	6641	20180210	13421
20180129	공항철도 1호선	운서	6472	6949	20180201	13421
20180130	경인선	간석	6831	6588	20180202	13419
20180127	경원선	신이문	7142	6267	20180130	13409
20180120	6호선	돌곶이	7023	6386	20180123	13409
20180203	분당선	선릉	4108	9298	20180206	13406
20180120	8호선	가락시장	6411	6995	20180123	13406
20180122	6호선	한강진	6183	7222	20180125	13405
20180131	수인선	인천논현	6542	6845	20180203	13387
20180117	중앙선	덕소	6750	6634	20180120	13384
20180128	경부선	천안	6816	6566	20180131	13382
20180119	경원선	도봉산	8491	4891	20180122	13382
20180113	7호선	온수(성공회대입구)	6781	6600	20180116	13381
20180203	3호선	매봉	7048	6332	20180206	13380
20180120	공항철도 1호선	운서	6549	6830	20180123	13379
20180118	6호선	녹사평(용산구청)	6627	6751	20180121	13378
20180212	7호선	용마산	6979	6396	20180215	13375
20180201	6호선	녹사평(용산구청)	6510	6864	20180204	13374
20180203	6호선	봉화산(서울의료원)	6888	6485	20180206	13373
20180201	7호선	용마산	6970	6400	20180204	13370
20180208	5호선	개화산	6988	6379	20180211	13367
20180118	4호선	삼각지	6124	7241	20180121	13365
20180131	9호선2단계	종합운동장	7239	6116	20180203	13355
20180125	5호선	거여	6850	6500	20180128	13350
20180122	경인선	구일	6675	6671	20180125	13346
20180112	경원선	가능	6854	6492	20180115	13346
20180130	경원선	지행	6753	6591	20180202	13344
20180201	중앙선	상봉(시외버스터미널)	6561	6781	20180204	13342
20180130	중앙선	덕소	6514	6827	20180202	13341
20180121	7호선	중화	6837	6504	20180124	13341
20180203	분당선	기흥	6891	6446	20180206	13337
20180112	7호선	까치울	6959	6376	20180115	13335
20180203	8호선	가락시장	6348	6980	20180206	13328
20180126	3호선	도곡	6746	6582	20180129	13328
20180206	7호선	용마산	6862	6465	20180209	13327
20180120	7호선	뚝섬유원지	6837	6488	20180123	13325
20180121	경부선	가산디지털단지	5785	7537	20180124	13322
20180120	6호선	광흥창(서강)	6928	6392	20180123	13320
20180122	5호선	마장	6811	6508	20180125	13319
20180114	공항철도 1호선	김포공항	8021	5298	20180117	13319
20180206	6호선	삼각지	7162	6155	20180209	13317
20180120	5호선	명일	6792	6523	20180123	13315
20180118	5호선	신금호	6600	6707	20180121	13307
20180208	중앙선	상봉(시외버스터미널)	6618	6688	20180211	13306
20180121	경부선	석수	6844	6460	20180124	13304
20180114	6호선	동묘앞	6898	6406	20180117	13304
20180117	5호선	신금호	6673	6629	20180120	13302
20180205	3호선	잠원	6708	6592	20180208	13300
20180127	경부선	남영	6645	6655	20180130	13300
20180121	3호선	녹번	7039	6260	20180124	13299
20180119	5호선	신금호	6687	6612	20180122	13299
20180120	분당선	선릉	4131	9167	20180123	13298
20180122	경인선	온수(성공회대입구)	6674	6618	20180125	13292
20180117	6호선	상월곡(한국과학기술연구원)	6995	6295	20180120	13290
20180207	5호선	개화산	6890	6398	20180210	13288
20180205	7호선	용마산	6828	6459	20180208	13287
20180129	경원선	지행	6672	6612	20180201	13284
20180207	6호선	삼각지	7205	6076	20180210	13281
20180121	7호선	강남구청	6511	6769	20180124	13280
20180115	중앙선	덕소	6710	6569	20180118	13279
20180212	경원선	도봉	6787	6488	20180215	13275
20180123	7호선	까치울	6893	6377	20180126	13270
20180206	경의선	백마	6833	6435	20180209	13268
20180122	중앙선	덕소	6624	6644	20180125	13268
20180205	공항철도 1호선	운서	6501	6766	20180208	13267
20180115	7호선	용마산	6886	6381	20180118	13267
20180114	6호선	안암(고대병원앞)	6428	6836	20180117	13264
20180203	공항철도 1호선	인천공항2터미널	7326	5935	20180206	13261
20180130	6호선	상월곡(한국과학기술연구원)	6829	6429	20180202	13258
20180122	7호선	용마산	6808	6447	20180125	13255
20180126	경부선	당정	6840	6413	20180129	13253
20180121	5호선	김포공항	6954	6296	20180124	13250
20180206	경원선	지행	6716	6530	20180209	13246
20180121	6호선	안암(고대병원앞)	6455	6789	20180124	13244
20180212	수인선	인천논현	6489	6752	20180215	13241
20180129	7호선	까치울	6784	6456	20180201	13240
20180121	7호선	먹골	6598	6641	20180124	13239
20180207	경인선	구일	6523	6711	20180210	13234
20180122	공항철도 1호선	인천공항2터미널	6991	6243	20180125	13234
20180117	9호선2단계	종합운동장	7187	6040	20180120	13227
20180123	경원선	도봉	6688	6533	20180126	13221
20180119	경원선	덕정	6742	6476	20180122	13218
20180118	7호선	용마산	6852	6365	20180121	13217
20180115	수인선	인천논현	6489	6728	20180118	13217
20180203	7호선	태릉입구	7089	6125	20180206	13214
20180203	7호선	천왕	6925	6287	20180206	13212
20180129	경의선	백마	6924	6285	20180201	13209
20180120	분당선	강남구청	5939	7269	20180123	13208
20180119	5호선	개화산	6884	6317	20180122	13201
20180130	경의선	금촌	6548	6652	20180202	13200
20180113	3호선	대청	6970	6224	20180116	13194
20180113	6호선	봉화산(서울의료원)	6754	6436	20180116	13190
20180129	7호선	반포	6612	6577	20180201	13189
20180206	경의선	금촌	6579	6609	20180209	13188
20180128	6호선	월곡(동덕여대)	6781	6407	20180131	13188
20180201	수인선	인천논현	6446	6739	20180204	13185
20180127	7호선	온수(성공회대입구)	6624	6559	20180130	13183
20180125	경부선	당정	6760	6423	20180128	13183
20180128	6호선	한강진	6246	6933	20180131	13179
20180113	경원선	광운대	6739	6439	20180116	13178
20180208	6호선	삼각지	7100	6075	20180211	13175
20180115	5호선	개화산	6766	6407	20180118	13173
20180204	7호선	강남구청	6386	6786	20180207	13172
20180112	6호선	녹사평(용산구청)	6196	6976	20180115	13172
20180130	5호선	개화산	6659	6503	20180202	13162
20180114	8호선	단대오거리	6643	6518	20180117	13161
20180125	공항철도 1호선	운서	6527	6633	20180128	13160
20180120	3호선	대청	6968	6192	20180123	13160
20180121	6호선	디지털미디어시티	6360	6799	20180124	13159
20180206	경원선	도봉	6657	6501	20180209	13158
20180211	7호선	중화	6652	6505	20180214	13157
20180117	6호선	녹사평(용산구청)	6430	6723	20180120	13153
20180127	공항철도 1호선	인천공항2터미널	7264	5888	20180130	13152
20180115	5호선	신금호	6543	6608	20180118	13151
20180205	경의선	금촌	6644	6504	20180208	13148
20180114	7호선	중화	6744	6404	20180117	13148
20180122	수인선	인천논현	6467	6679	20180125	13146
20180208	수인선	인천논현	6506	6636	20180211	13142
20180127	8호선	문정	6735	6407	20180130	13142
20180207	6호선	녹사평(용산구청)	6405	6734	20180210	13139
20180118	경원선	덕정	6641	6496	20180121	13137
20180124	3호선	도곡	6673	6462	20180127	13135
20180115	5호선	마장	6808	6318	20180118	13126
20180129	경의선	금촌	6612	6513	20180201	13125
20180122	3호선	잠원	6559	6565	20180125	13124
20180206	9호선	샛강	6390	6732	20180209	13122
20180120	분당선	기흥	6764	6358	20180123	13122
20180119	중앙선	상봉(시외버스터미널)	6622	6498	20180122	13120
20180127	경원선	양주	7142	5973	20180130	13115
20180204	7호선	장승배기	6504	6608	20180207	13112
20180115	9호선	샛강	6330	6780	20180118	13110
20180113	분당선	강남구청	5947	7162	20180116	13109
20180203	3호선	대청	7024	6083	20180206	13107
20180114	경부선	석수	6688	6419	20180117	13107
20180118	9호선2단계	종합운동장	7201	5903	20180121	13104
20180131	6호선	녹사평(용산구청)	6342	6759	20180203	13101
20180212	6호선	한강진	5953	7140	20180215	13093
20180201	9호선2단계	종합운동장	7102	5991	20180204	13093
20180129	7호선	용마산	6781	6311	20180201	13092
20180201	5호선	을지로4가	6232	6856	20180204	13088
20180201	6호선	삼각지	7084	6002	20180204	13086
20180120	5호선	길동	6465	6618	20180123	13083
20180126	7호선	까치울	6870	6211	20180129	13081
20180124	5호선	거여	6715	6366	20180127	13081
20180203	경원선	망월사	6477	6601	20180206	13078
20180113	경부선	의왕	6726	6348	20180116	13074
20180212	경인선	구일	6501	6571	20180215	13072
20180113	7호선	태릉입구	6944	6128	20180116	13072
20180113	경원선	지행	6535	6534	20180116	13069
20180205	6호선	한강진	5980	7088	20180208	13068
20180122	9호선	샛강	6342	6726	20180125	13068
20180120	7호선	천왕	6842	6224	20180123	13066
20180123	7호선	반포	6587	6473	20180126	13060
20180121	5호선	둔촌동	6464	6594	20180124	13058
20180119	5호선	을지로4가	6075	6983	20180122	13058
20180123	9호선	샛강	6298	6753	20180126	13051
20180122	9호선	개화	7801	5250	20180125	13051
20180123	경원선	지행	6618	6430	20180126	13048
20180117	4호선	삼각지	6012	7036	20180120	13048
20180128	7호선	강남구청	6440	6603	20180131	13043
20180131	6호선	상월곡(한국과학기술연구원)	6907	6133	20180203	13040
20180113	3호선	매봉	6811	6228	20180116	13039
20180207	6호선	상월곡(한국과학기술연구원)	6831	6203	20180210	13034
20180119	6호선	상월곡(한국과학기술연구원)	6947	6087	20180122	13034
20180207	9호선2단계	종합운동장	7088	5942	20180210	13030
20180130	경인선	구일	6364	6664	20180202	13028
20180208	9호선2단계	종합운동장	7114	5913	20180211	13027
20180206	경인선	간석	6783	6244	20180209	13027
20180206	3호선	잠원	6624	6402	20180209	13026
20180201	중앙선	덕소	6589	6435	20180204	13024
20180204	공항철도 1호선	김포공항	8154	4865	20180207	13019
20180118	5호선	개화산	6666	6353	20180121	13019
20180131	공항철도 1호선	인천공항2터미널	7088	5929	20180203	13017
20180121	6호선	증산(명지대앞)	6574	6443	20180124	13017
20180120	9호선2단계	언주	6679	6338	20180123	13017
20180211	공항철도 1호선	김포공항	7867	5144	20180214	13011
20180203	경의선	금촌	6760	6249	20180206	13009
20180122	9호선2단계	종합운동장	7010	5997	20180125	13007
20180205	경인선	간석	6625	6380	20180208	13005
20180112	경의선	백마	6774	6230	20180115	13004
20180212	5호선	신금호	6425	6578	20180215	13003
20180117	경원선	덕정	6544	6457	20180120	13001
20180112	경의선	금촌	6703	6292	20180115	12995
20180112	7호선	반포	6626	6367	20180115	12993
20180113	8호선	가락시장	6169	6816	20180116	12985
20180121	공항철도 1호선	계양	6499	6480	20180124	12979
20180119	경강선	경기광주	6742	6236	20180122	12978
20180126	공항철도 1호선	운서	6424	6552	20180129	12976
20180122	5호선	신금호	6400	6574	20180125	12974
20180204	7호선	남성	6469	6495	20180207	12964
20180124	경부선	당정	6664	6297	20180127	12961
20180208	6호선	상월곡(한국과학기술연구원)	6846	6112	20180211	12958
20180126	경원선	가능	6708	6243	20180129	12951
20180212	5호선	개화산	6653	6293	20180215	12946
20180130	9호선	개화	7370	5576	20180202	12946
20180123	경의선	금촌	6527	6418	20180126	12945
20180125	3호선	도곡	6457	6487	20180128	12944
20180114	경원선	도봉산	7688	5254	20180117	12942
20180127	분당선	강남구청	5950	6990	20180130	12940
20180121	8호선	단대오거리	6634	6305	20180124	12939
20180212	5호선	을지로4가	6052	6876	20180215	12928
20180130	5호선	을지로4가	6269	6657	20180202	12926
20180125	경원선	가능	6622	6304	20180128	12926
20180124	7호선	까치울	6705	6218	20180127	12923
20180122	5호선	을지로4가	6208	6714	20180125	12922
20180115	9호선2단계	종합운동장	6970	5951	20180118	12921
20180114	6호선	월곡(동덕여대)	6563	6352	20180117	12915
20180122	5호선	개화산	6660	6254	20180125	12914
20180130	6호선	녹사평(용산구청)	6410	6501	20180202	12911
20180207	중앙선	상봉(시외버스터미널)	6351	6559	20180210	12910
20180114	7호선	장승배기	6422	6488	20180117	12910
20180121	7호선	남성	6387	6521	20180124	12908
20180118	5호선	을지로4가	6190	6713	20180121	12903
20180203	경부선	화서	6499	6401	20180206	12900
20180119	9호선	샛강	6229	6668	20180122	12897
20180113	분당선	기흥	6673	6224	20180116	12897
20180205	경원선	도봉	6542	6354	20180208	12896
20180123	경인선	간석	6629	6267	20180126	12896
20180126	경원선	지행	6439	6456	20180129	12895
20180124	경원선	가능	6581	6314	20180127	12895
20180122	6호선	상월곡(한국과학기술연구원)	6790	6104	20180125	12894
20180114	경원선	방학	6664	6230	20180117	12894
20180120	7호선	보라매	6534	6357	20180123	12891
20180207	중앙선	덕소	6348	6542	20180210	12890
20180121	안산선	오이도	6471	6417	20180124	12888
20180201	6호선	상월곡(한국과학기술연구원)	6783	6104	20180204	12887
20180131	9호선2단계	삼성중앙	6305	6581	20180203	12886
20180131	5호선	을지로4가	6115	6771	20180203	12886
20180113	경원선	망월사	6420	6466	20180116	12886
20180212	6호선	상월곡(한국과학기술연구원)	6810	6071	20180215	12881
20180126	경인선	온수(성공회대입구)	6344	6534	20180129	12878
20180205	경인선	구일	6405	6472	20180208	12877
20180129	경인선	온수(성공회대입구)	6458	6418	20180201	12876
20180123	5호선	마장	6577	6298	20180126	12875
20180122	경강선	경기광주	6421	6453	20180125	12874
20180119	공항철도 1호선	청라국제도시	6614	6260	20180122	12874
20180212	9호선2단계	종합운동장	6996	5877	20180215	12873
20180212	공항철도 1호선	운서	6334	6538	20180215	12872
20180207	9호선2단계	삼성중앙	6286	6586	20180210	12872
20180128	경원선	석계	6179	6685	20180131	12864
20180119	장항선	온양온천	6466	6398	20180122	12864
20180118	6호선	상월곡(한국과학기술연구원)	6684	6180	20180121	12864
20180120	3호선	매봉	6701	6158	20180123	12859
20180112	경인선	간석	6603	6256	20180115	12859
20180205	9호선	샛강	6161	6697	20180208	12858
20180127	5호선	고덕	6570	6286	20180130	12856
20180125	7호선	까치울	6644	6210	20180128	12854
20180122	경춘선	평내호평	6530	6321	20180125	12851
20180203	2호선	한양대	6211	6639	20180206	12850
20180119	경춘선	평내호평	6499	6351	20180122	12850
20180119	분당선	이매	6359	6486	20180122	12845
20180120	9호선	신방화	6649	6194	20180123	12843
20180120	6호선	월드컵경기장(성산)	6212	6628	20180123	12840
20180201	9호선2단계	삼성중앙	6373	6465	20180204	12838
20180126	7호선	반포	6510	6328	20180129	12838
20180119	5호선	왕십리(성동구청)	5870	6967	20180122	12837
20180204	경부선	천안	6502	6330	20180207	12832
20180128	7호선	중화	6474	6357	20180131	12831
20180122	경원선	덕정	6526	6302	20180125	12828
20180203	경원선	지행	6424	6399	20180206	12823
20180131	9호선	샛강	6065	6755	20180203	12820
20180112	3호선	잠원	6552	6265	20180115	12817
20180117	5호선	을지로4가	6067	6746	20180120	12813
20180126	경의선	금촌	6537	6272	20180129	12809
20180203	9호선	신방화	6585	6218	20180206	12803
20180207	8호선	송파	6299	6502	20180210	12801
20180201	5호선	개화산	6624	6176	20180204	12800
20180121	7호선	장승배기	6351	6449	20180124	12800
20180203	5호선	올림픽공원(한국체대)	6407	6390	20180206	12797
20180126	공항철도 1호선	인천공항2터미널	7067	5730	20180129	12797
20180203	중앙선	상봉(시외버스터미널)	5794	7002	20180206	12796
20180128	경부선	가산디지털단지	5330	7463	20180131	12793
20180121	경인선	제물포	6531	6259	20180124	12790
20180208	9호선2단계	삼성중앙	6252	6537	20180211	12789
20180129	경원선	도봉	6568	6220	20180201	12788
20180124	6호선	삼각지	6819	5966	20180127	12785
20180125	6호선	삼각지	6904	5876	20180128	12780
20180115	5호선	을지로4가	6042	6737	20180118	12779
20180212	중앙선	덕소	6440	6336	20180215	12776
20180119	9호선	개화	7644	5132	20180122	12776
20180119	중앙선	중랑	6523	6247	20180122	12770
20180115	9호선	개화	7616	5149	20180118	12765
20180204	경원선	방학	6560	6204	20180207	12764
20180123	공항철도 1호선	인천공항2터미널	6849	5915	20180126	12764
20180112	9호선2단계	종합운동장	6916	5846	20180115	12762
20180123	7호선	용마산	6649	6112	20180126	12761
20180130	4호선	삼각지	6019	6740	20180202	12759
20180114	3호선	녹번	6796	5963	20180117	12759
20180114	7호선	남성	6389	6369	20180117	12758
20180114	6호선	증산(명지대앞)	6453	6304	20180117	12757
20180207	9호선	샛강	6184	6569	20180210	12753
20180120	3호선	학여울	6508	6245	20180123	12753
20180204	6호선	안암(고대병원앞)	6281	6471	20180207	12752
20180123	3호선	잠원	6444	6301	20180126	12745
20180123	5호선	신금호	6367	6377	20180126	12744
20180212	9호선	개화	7696	5046	20180215	12742
20180127	공항철도 1호선	디지털미디어시티	6693	6047	20180130	12740
20180124	공항철도 1호선	운서	6255	6484	20180127	12739
20180206	9호선2단계	종합운동장	6924	5810	20180209	12734
20180129	5호선	개화산	6529	6205	20180201	12734
20180127	분당선	선릉	3933	8799	20180130	12732
20180114	6호선	디지털미디어시티	6134	6595	20180117	12729
20180130	수인선	인천논현	6172	6554	20180202	12726
20180201	공항철도 1호선	인천공항2터미널	7105	5620	20180204	12725
20180211	3호선	녹번	6729	5991	20180214	12720
20180131	9호선	개화	7648	5071	20180203	12719
20180129	5호선	마장	6500	6219	20180201	12719
20180211	7호선	장승배기	6427	6291	20180214	12718
20180125	7호선	반포	6406	6311	20180128	12717
20180211	7호선	남성	6341	6372	20180214	12713
20180117	9호선	샛강	6138	6570	20180120	12708
20180118	9호선	샛강	6153	6553	20180121	12706
20180204	6호선	월곡(동덕여대)	6368	6335	20180207	12703
20180204	3호선	녹번	6804	5898	20180207	12702
20180208	경원선	덕정	6404	6296	20180211	12700
20180204	6호선	증산(명지대앞)	6319	6376	20180207	12695
20180113	6호선	고려대(종암)	6478	6216	20180116	12694
20180127	3호선	교대(법원.검찰청)	7748	4945	20180130	12693
20180212	9호선2단계	삼성중앙	6157	6530	20180215	12687
20180203	9호선	국회의사당	6294	6389	20180206	12683
20180205	중앙선	덕소	6331	6345	20180208	12676
20180206	경인선	구일	6290	6384	20180209	12674
20180131	4호선	삼각지	5864	6807	20180203	12671
20180112	공항철도 1호선	운서	6417	6254	20180115	12671
20180126	7호선	용마산	6715	5954	20180129	12669
20180114	5호선	둔촌동	6264	6396	20180117	12660
20180211	경부선	금천구청	6405	6253	20180214	12658
20180130	경강선	경기광주	6207	6450	20180202	12657
20180124	7호선	반포	6353	6303	20180127	12656
20180205	9호선2단계	종합운동장	6876	5779	20180208	12655
20180205	6호선	상월곡(한국과학기술연구원)	6657	5998	20180208	12655
20180208	8호선	송파	6279	6375	20180211	12654
20180118	9호선	개화	7513	5140	20180121	12653
20180114	장항선	온양온천	6345	6306	20180117	12651
20180203	5호선	길동	6194	6451	20180206	12645
20180203	경부선	의왕	6475	6167	20180206	12642
20180124	7호선	용마산	6512	6129	20180127	12641
20180206	9호선2단계	삼성중앙	6132	6508	20180209	12640
20180112	5호선	마장	6507	6132	20180115	12639
20180204	7호선	중화	6482	6156	20180207	12638
20180119	6호선	태릉입구	5932	6706	20180122	12638
20180127	일산선	마두	6284	6352	20180130	12636
20180211	5호선	둔촌동	6238	6391	20180214	12629
20180114	7호선	먹골	6403	6225	20180117	12628
20180114	경부선	남영	6172	6451	20180117	12623
20180113	7호선	천왕	6612	6011	20180116	12623
20180118	9호선2단계	삼성중앙	6154	6466	20180121	12620
20180208	9호선	샛강	6099	6520	20180211	12619
20180129	공항철도 1호선	인천공항2터미널	6871	5741	20180201	12612
20180117	9호선	개화	7492	5120	20180120	12612
20180128	7호선	장승배기	6272	6339	20180131	12611
20180118	중앙선	상봉(시외버스터미널)	6354	6257	20180121	12611
20180211	6호선	디지털미디어시티	5990	6618	20180214	12608
20180129	3호선	잠원	6423	6181	20180201	12604
20180201	9호선	샛강	6038	6562	20180204	12600
20180126	9호선2단계	종합운동장	6869	5729	20180129	12598
20180112	7호선	용마산	6667	5931	20180115	12598
20180206	중앙선	덕소	6230	6364	20180209	12594
20180206	5호선	개화산	6456	6135	20180209	12591
20180115	6호선	상월곡(한국과학기술연구원)	6654	5937	20180118	12591
20180211	경원선	석계	6012	6578	20180214	12590
20180203	3호선	을지로3가	6130	6458	20180206	12588
20180208	9호선	개화	7556	5030	20180211	12586
20180119	3호선	학여울	6363	6222	20180122	12585
20180112	수인선	인천논현	6150	6430	20180115	12580
20180205	9호선2단계	삼성중앙	6065	6514	20180208	12579
20180207	5호선	을지로4가	5938	6640	20180210	12578
20180131	경원선	도봉산	8035	4541	20180203	12576
20180115	경원선	덕정	6330	6246	20180118	12576
20180114	5호선	김포공항	6698	5877	20180117	12575
20180113	6호선	대흥(서강대앞)	6226	6349	20180116	12575
20180126	경의선	백마	6489	6084	20180129	12573
20180120	경의선	문산	6832	5741	20180123	12573
20180203	6호선	대흥(서강대앞)	6160	6401	20180206	12561
20180204	8호선	단대오거리	6413	6146	20180207	12559
20180118	경강선	경기광주	6436	6121	20180121	12557
20180204	경부선	금천구청	6342	6211	20180207	12553
20180125	5호선	마장	6419	6134	20180128	12553
20180120	2호선	한양대	6080	6469	20180123	12549
20180112	경인선	온수(성공회대입구)	6235	6309	20180115	12544
20180113	5호선	길동	6157	6384	20180116	12541
20180115	중앙선	상봉(시외버스터미널)	6300	6240	20180118	12540
20180129	경인선	간석	6430	6108	20180201	12538
20180112	경원선	도봉	6330	6206	20180115	12536
20180129	9호선	샛강	5968	6565	20180201	12533
20180112	경부선	천안	6308	6224	20180115	12532
20180127	3호선	금호	6604	5926	20180130	12530
20180118	경원선	도봉산	7968	4557	20180121	12525
20180204	5호선	김포공항	6473	6051	20180207	12524
20180119	9호선2단계	삼성중앙	6191	6328	20180122	12519
20180211	6호선	월곡(동덕여대)	6361	6157	20180214	12518
20180117	중앙선	중랑	6326	6189	20180120	12515
20180123	경인선	온수(성공회대입구)	6241	6270	20180126	12511
20180206	6호선	상월곡(한국과학기술연구원)	6583	5927	20180209	12510
20180129	5호선	신금호	6134	6376	20180201	12510
20180125	경의선	백마	6441	6068	20180128	12509
20180120	6호선	고려대(종암)	6470	6037	20180123	12507
20180125	7호선	용마산	6488	6017	20180128	12505
20180117	5호선	왕십리(성동구청)	5880	6625	20180120	12505
20180131	공항철도 1호선	청라국제도시	6395	6109	20180203	12504
20180113	6호선	광흥창(서강)	6444	6060	20180116	12504
20180208	경강선	경기광주	6296	6206	20180211	12502
20180207	8호선	수진	6478	6024	20180210	12502
20180204	경원선	석계	6019	6482	20180207	12501
20180125	경원선	도봉	6352	6146	20180128	12498
20180212	6호선	녹사평(용산구청)	6232	6264	20180215	12496
20180207	경원선	덕정	6232	6262	20180210	12494
20180203	6호선	광흥창(서강)	6425	6069	20180206	12494
20180131	경원선	덕정	6262	6231	20180203	12493
20180123	6호선	상월곡(한국과학기술연구원)	6610	5882	20180126	12492
20180115	경원선	도봉산	7872	4620	20180118	12492
20180124	공항철도 1호선	인천공항2터미널	6684	5807	20180127	12491
20180121	5호선	굽은다리(강동구민회관앞)	6381	6106	20180124	12487
20180204	5호선	둔촌동	6120	6361	20180207	12481
20180124	경의선	백마	6415	6064	20180127	12479
20180128	과천선	정부과천청사	6422	6056	20180131	12478
20180205	5호선	개화산	6427	6050	20180208	12477
20180123	9호선2단계	종합운동장	6805	5672	20180126	12477
20180115	경부선	천안	6136	6339	20180118	12475
20180129	9호선2단계	종합운동장	6717	5757	20180201	12474
20180211	7호선	상도	6401	6064	20180214	12465
20180211	8호선	단대오거리	6365	6100	20180214	12465
20180207	9호선	개화	7437	5027	20180210	12464
20180211	경원선	방학	6367	6095	20180214	12462
20180118	공항철도 1호선	청라국제도시	6332	6129	20180121	12461
20180117	경원선	도봉산	7890	4568	20180120	12458
20180114	8호선	복정	6687	5771	20180117	12458
20180208	경원선	도봉산	7815	4639	20180211	12454
20180126	5호선	신금호	6260	6194	20180129	12454
20180128	경부선	금천구청	6409	6042	20180131	12451
20180208	4호선	삼각지	5815	6635	20180211	12450
20180201	8호선	송파	6201	6244	20180204	12445
20180130	중앙선	상봉(시외버스터미널)	6098	6347	20180202	12445
20180127	7호선	태릉입구	6636	5809	20180130	12445
20180113	3호선	을지로3가	6145	6299	20180116	12444
20180204	공항철도 1호선	인천공항2터미널	6599	5844	20180207	12443
20180123	중앙선	덕소	6207	6235	20180126	12442
20180131	분당선	이매	6308	6133	20180203	12441
20180129	6호선	상월곡(한국과학기술연구원)	6545	5896	20180201	12441
20180212	경원선	덕정	6290	6150	20180215	12440
20180115	6호선	삼각지	6655	5782	20180118	12437
20180204	6호선	디지털미디어시티	5938	6498	20180207	12436
20180127	3호선	대청	6530	5903	20180130	12433
20180117	6호선	태릉입구	5849	6584	20180120	12433
20180128	5호선	김포공항	6724	5708	20180131	12432
20180128	6호선	안암(고대병원앞)	5999	6431	20180131	12430
20180201	경원선	도봉산	8060	4369	20180204	12429
20180127	경부선	신길	6947	5482	20180130	12429
20180126	6호선	녹사평(용산구청)	5827	6596	20180129	12423
20180128	7호선	도봉산	5040	7381	20180131	12421
20180211	7호선	강남구청	5989	6431	20180214	12420
20180130	5호선	왕십리(성동구청)	5962	6458	20180202	12420
20180211	6호선	증산(명지대앞)	6285	6134	20180214	12419
20180112	5호선	신금호	6308	6111	20180115	12419
20180130	공항철도 1호선	인천공항2터미널	6784	5632	20180202	12416
20180131	경강선	경기광주	6291	6122	20180203	12413
20180123	5호선	개화산	6352	6056	20180126	12408
20180122	중앙선	중랑	6326	6079	20180125	12405
20180115	4호선	삼각지	5797	6608	20180118	12405
20180113	경원선	도봉산	7575	4829	20180116	12404
20180211	경부선	가산디지털단지	5143	7259	20180214	12402
20180117	9호선2단계	삼성중앙	5994	6408	20180120	12402
20180127	경원선	광운대	6335	6065	20180130	12400
20180120	3호선	을지로3가	6059	6335	20180123	12394
20180114	안산선	오이도	6179	6215	20180117	12394
20180117	공항철도 1호선	청라국제도시	6417	5975	20180120	12392
20180115	6호선	녹사평(용산구청)	6150	6240	20180118	12390
20180128	6호선	디지털미디어시티	5959	6428	20180131	12387
20180203	7호선	뚝섬유원지	6343	6040	20180206	12383
20180117	경강선	경기광주	6295	6088	20180120	12383
20180120	경원선	가능	6433	5949	20180123	12382
20180131	경춘선	평내호평	6358	6023	20180203	12381
20180115	경강선	경기광주	6245	6134	20180118	12379
20180128	6호선	동묘앞	6403	5970	20180131	12373
20180130	6호선	태릉입구	5741	6630	20180202	12371
20180128	6호선	증산(명지대앞)	6202	6169	20180131	12371
20180117	경춘선	평내호평	6218	6152	20180120	12370
20180212	경강선	경기광주	6228	6141	20180215	12369
20180128	7호선	먹골	6198	6170	20180131	12368
20180208	5호선	왕십리(성동구청)	5799	6567	20180211	12366
20180122	9호선2단계	삼성중앙	6009	6357	20180125	12366
20180130	경춘선	평내호평	6136	6229	20180202	12365
20180131	중앙선	상봉(시외버스터미널)	6185	6179	20180203	12364
20180118	분당선	이매	6049	6314	20180121	12363
20180211	6호선	안암(고대병원앞)	6065	6292	20180214	12357
20180125	5호선	신금호	6130	6226	20180128	12356
20180208	6호선	태릉입구	5784	6571	20180211	12355
20180121	공항철도 1호선	검암	5935	6418	20180124	12353
20180123	9호선2단계	삼성중앙	6027	6322	20180126	12349
20180205	중앙선	상봉(시외버스터미널)	6170	6178	20180208	12348
20180201	경강선	경기광주	6273	6075	20180204	12348
20180201	경원선	덕정	6287	6059	20180204	12346
20180114	경원선	망월사	6126	6220	20180117	12346
20180127	5호선	올림픽공원(한국체대)	6328	6017	20180130	12345
20180205	9호선	개화	7474	4868	20180208	12342
20180131	중앙선	중랑	6264	6078	20180203	12342
20180128	7호선	남성	6160	6182	20180131	12342
20180126	6호선	상월곡(한국과학기술연구원)	6600	5738	20180129	12338
20180114	9호선	여의도	6322	6013	20180117	12335
20180114	경인선	제물포	6311	6022	20180117	12333
20180117	중앙선	상봉(시외버스터미널)	6138	6194	20180120	12332
20180123	경인선	구일	6149	6179	20180126	12328
20180120	9호선	양천향교	6261	6067	20180123	12328
20180124	경원선	도봉	6243	6081	20180127	12324
20180211	7호선	도봉산	5001	7321	20180214	12322
20180125	공항철도 1호선	인천공항2터미널	6766	5556	20180128	12322
20180120	5호선	행당	6614	5699	20180123	12313
20180115	중앙선	중랑	6224	6087	20180118	12311
20180125	경의선	금촌	6200	6110	20180128	12310
20180124	9호선2단계	종합운동장	6771	5539	20180127	12310
20180205	5호선	을지로4가	5873	6432	20180208	12305
20180128	8호선	단대오거리	6185	6118	20180131	12303
20180128	3호선	녹번	6581	5716	20180131	12297
20180206	5호선	을지로4가	5826	6469	20180209	12295
20180208	경춘선	평내호평	6237	6057	20180211	12294
20180112	6호선	상월곡(한국과학기술연구원)	6529	5765	20180115	12294
20180211	6호선	동묘앞	6250	6043	20180214	12293
20180114	공항철도 1호선	계양	6180	6113	20180117	12293
20180201	9호선	개화	7444	4847	20180204	12291
20180128	공항철도 1호선	계양	6064	6227	20180131	12291
20180203	경원선	도봉산	7570	4707	20180206	12277
20180122	경원선	도봉산	7805	4466	20180125	12271
20180121	7호선	상도	6241	6030	20180124	12271
20180126	5호선	마장	6317	5950	20180129	12267
20180120	7호선	춘의	6366	5901	20180123	12267
20180131	8호선	송파	6162	6102	20180203	12264
20180115	공항철도 1호선	청라국제도시	6321	5941	20180118	12262
20180126	3호선	잠원	6253	6008	20180129	12261
20180125	경인선	온수(성공회대입구)	6149	6111	20180128	12260
20180203	공항철도 1호선	운서	6016	6241	20180206	12257
20180129	9호선	개화	7350	4903	20180201	12253
20180208	5호선	을지로4가	5869	6382	20180211	12251
20180121	7호선	마들	6386	5863	20180124	12249
20180120	장항선	온양온천	6120	6129	20180123	12249
20180121	2호선	아현	6119	6124	20180124	12243
20180127	5호선	명일	6100	6142	20180130	12242
20180121	8호선	복정	6433	5809	20180124	12242
20180203	5호선	행당	6545	5690	20180206	12235
20180118	6호선	태릉입구	5740	6488	20180121	12228
20180128	경부선	석수	6351	5874	20180131	12225
20180126	경원선	도봉	6228	5996	20180129	12224
20180122	공항철도 1호선	청라국제도시	6249	5973	20180125	12222
20180126	9호선2단계	삼성중앙	6056	6165	20180129	12221
20180121	경부선	남영	5926	6293	20180124	12219
20180130	공항철도 1호선	청라국제도시	6261	5956	20180202	12217
20180206	중앙선	상봉(시외버스터미널)	6078	6136	20180209	12214
20180130	8호선	송파	6089	6124	20180202	12213
20180121	5호선	서대문	6244	5969	20180124	12213
20180128	9호선	여의도	6433	5779	20180131	12212
20180118	경춘선	평내호평	6204	6007	20180121	12211
20180113	경의선	문산	6700	5510	20180116	12210
20180115	경춘선	평내호평	6174	6035	20180118	12209
20180128	5호선	둔촌동	5964	6241	20180131	12205
20180129	중앙선	덕소	6116	6088	20180201	12204
20180122	경의선	문산	6284	5917	20180125	12201
20180118	5호선	왕십리(성동구청)	5684	6516	20180121	12200
20180201	5호선	왕십리(성동구청)	5654	6545	20180204	12199
20180205	8호선	송파	6070	6126	20180208	12196
20180117	8호선	수진	6228	5968	20180120	12196
20180205	경원선	덕정	6117	6078	20180208	12195
20180201	4호선	삼각지	5609	6583	20180204	12192
20180117	분당선	이매	6031	6160	20180120	12191
20180129	경인선	구일	6057	6132	20180201	12189
20180125	9호선2단계	종합운동장	6645	5542	20180128	12187
20180130	중앙선	중랑	6131	6053	20180202	12184
20180113	경부선	두정	6076	6103	20180116	12179
20180121	경의선	금촌	5701	6474	20180124	12175
20180125	경인선	간석	6267	5906	20180128	12173
20180121	5호선	송정	5803	6370	20180124	12173
20180130	분당선	이매	5897	6275	20180202	12172
20180204	7호선	먹골	6093	6074	20180207	12167
20180119	8호선	모란	6924	5242	20180122	12166
20180121	경원선	양주	6367	5797	20180124	12164
20180121	3호선	옥수	5753	6410	20180124	12163
20180129	9호선2단계	삼성중앙	5894	6268	20180201	12162
20180207	경강선	경기광주	6136	6023	20180210	12159
20180129	수인선	인천논현	5917	6239	20180201	12156
20180125	경원선	지행	6141	6014	20180128	12155
20180118	중앙선	중랑	6206	5946	20180121	12152
20180124	6호선	상월곡(한국과학기술연구원)	6363	5787	20180127	12150
20180112	5호선	개화산	6342	5808	20180115	12150
20180112	9호선	샛강	5869	6280	20180115	12149
20180127	6호선	돌곶이	6333	5812	20180130	12145
20180115	9호선2단계	삼성중앙	5866	6278	20180118	12144
20180131	5호선	왕십리(성동구청)	5720	6423	20180203	12143
20180121	7호선	내방	5914	6229	20180124	12143
20180118	8호선	송파	6128	6014	20180121	12142
20180119	경부선	두정	6099	6038	20180122	12137
20180119	8호선	송파	6087	6049	20180122	12136
20180212	공항철도 1호선	청라국제도시	6184	5949	20180215	12133
20180121	2호선	신정네거리	6029	6104	20180124	12133
20180124	3호선	잠원	6173	5959	20180127	12132
20180128	경원선	방학	6249	5882	20180131	12131
20180122	경부선	천안	6013	6117	20180125	12130
20180124	5호선	마장	6197	5930	20180127	12127
20180201	중앙선	중랑	6175	5951	20180204	12126
20180208	공항철도 1호선	청라국제도시	6173	5952	20180211	12125
20180125	6호선	상월곡(한국과학기술연구원)	6356	5764	20180128	12120
20180207	5호선	왕십리(성동구청)	5698	6419	20180210	12117
20180113	5호선	행당	6524	5590	20180116	12114
20180131	6호선	태릉입구	5680	6433	20180203	12113
20180123	수인선	인천논현	5952	6161	20180126	12113
20180127	경의선	금촌	6284	5825	20180130	12109
20180125	9호선2단계	삼성중앙	5900	6209	20180128	12109
20180205	수인선	인천논현	5910	6198	20180208	12108
20180125	3호선	잠원	6091	6012	20180128	12103
20180203	7호선	춘의	6275	5821	20180206	12096
20180127	경원선	망월사	6141	5950	20180130	12091
20180113	7호선	뚝섬유원지	6146	5944	20180116	12090
20180127	6호선	봉화산(서울의료원)	6215	5874	20180130	12089
20180207	6호선	태릉입구	5684	6404	20180210	12088
20180206	경강선	경기광주	6073	6015	20180209	12088
20180211	7호선	먹골	6116	5968	20180214	12084
20180114	7호선	내방	5852	6230	20180117	12082
20180113	9호선	신방화	6258	5823	20180116	12081
20180201	경춘선	평내호평	6124	5954	20180204	12078
20180207	4호선	삼각지	5581	6496	20180210	12077
20180121	5호선	영등포시장	5801	6273	20180124	12074
20180131	8호선	수진	6288	5783	20180203	12071
20180211	경부선	석수	6136	5934	20180214	12070
20180112	경부선	두정	6042	6027	20180115	12069
20180201	분당선	이매	5990	6078	20180204	12068
20180126	9호선	샛강	5872	6196	20180129	12068
20180124	경인선	간석	6147	5921	20180127	12068
20180211	7호선	마들	6252	5814	20180214	12066
20180205	경강선	경기광주	6035	6028	20180208	12063
20180128	7호선	상도	6097	5966	20180131	12063
20180208	분당선	이매	5977	6080	20180211	12057
20180211	2호선	아현	6001	6054	20180214	12055
20180125	9호선	샛강	5776	6279	20180128	12055
20180201	6호선	태릉입구	5677	6376	20180204	12053
20180112	중앙선	덕소	6087	5957	20180115	12044
20180121	9호선	여의도	6217	5818	20180124	12035
20180114	2호선	아현	5995	6040	20180117	12035
20180117	8호선	송파	6075	5958	20180120	12033
20180124	9호선2단계	삼성중앙	5892	6137	20180127	12029
20180130	경원선	도봉산	7673	4354	20180202	12027
20180119	6호선	불광	6106	5917	20180122	12023
20180114	3호선	옥수	5704	6319	20180117	12023
20180112	공항철도 1호선	청라국제도시	6218	5805	20180115	12023
20180130	경원선	덕정	6007	6014	20180202	12021
20180130	우이신설선	북한산보국문	5750	6270	20180202	12020
20180120	경부선	두정	6046	5974	20180123	12020
20180206	8호선	송파	6004	6013	20180209	12017
20180127	6호선	광흥창(서강)	6144	5870	20180130	12014
20180123	4호선	삼각지	5589	6423	20180126	12012
20180206	9호선	개화	7149	4861	20180209	12010
20180206	수인선	인천논현	5905	6098	20180209	12003
20180206	6호선	녹사평(용산구청)	5937	6064	20180209	12001
20180211	경부선	천안	6180	5819	20180214	11999
20180124	경원선	지행	6051	5948	20180127	11999
20180117	경의선	문산	6070	5929	20180120	11999
20180212	4호선	삼각지	5680	6314	20180215	11994
20180127	5호선	길동	5768	6226	20180130	11994
20180125	5호선	개화산	6166	5828	20180128	11994
20180121	7호선	중곡	6119	5873	20180124	11992
20180115	6호선	태릉입구	5580	6412	20180118	11992
20180207	분당선	이매	5923	6065	20180210	11988
20180126	경인선	간석	6156	5832	20180129	11988
20180127	경부선	명학	6020	5967	20180130	11987
20180203	5호선	방이	6064	5922	20180206	11986
20180121	경인선	중동	6171	5815	20180124	11986
20180201	공항철도 1호선	청라국제도시	6151	5833	20180204	11984
20180126	5호선	개화산	6212	5772	20180129	11984
20180114	경인선	부개	6131	5853	20180117	11984
20180114	경원선	양주	6273	5706	20180117	11979
20180127	3호선	을지로3가	5856	6121	20180130	11977
20180207	공항철도 1호선	청라국제도시	6115	5860	20180210	11975
20180119	8호선	산성	6223	5750	20180122	11973
20180203	경원선	가능	6311	5660	20180206	11971
20180114	7호선	마들	6279	5692	20180117	11971
20180124	경의선	금촌	6024	5946	20180127	11970
20180211	5호선	김포공항	6365	5604	20180214	11969
20180120	경의선	탄현	6118	5847	20180123	11965
20180206	경원선	덕정	5987	5977	20180209	11964
20180121	경인선	부개	6136	5826	20180124	11962
20180128	안산선	정왕	5723	6236	20180131	11959
20180113	5호선	방이	6092	5865	20180116	11957
20180204	6호선	동묘앞	6111	5845	20180207	11956
20180127	6호선	고려대(종암)	6182	5772	20180130	11954
20180112	경강선	경기광주	6189	5765	20180115	11954
20180123	9호선	개화	7188	4764	20180126	11952
20180129	중앙선	상봉(시외버스터미널)	6077	5870	20180201	11947
20180121	경부선	관악	6177	5766	20180124	11943
20180208	8호선	산성	6054	5888	20180211	11942
20180127	3호선	독립문	5936	6005	20180130	11941
20180207	6호선	불광	5982	5957	20180210	11939
20180211	안산선	정왕	5715	6223	20180214	11938
20180205	공항철도 1호선	청라국제도시	6109	5828	20180208	11937
20180211	7호선	내방	5809	6125	20180214	11934
20180124	경인선	구일	5844	6090	20180127	11934
20180123	경강선	경기광주	6057	5875	20180126	11932
20180112	9호선2단계	삼성중앙	5910	6021	20180115	11931
20180124	9호선	샛강	5796	6133	20180127	11929
20180124	경인선	온수(성공회대입구)	5859	6053	20180127	11912
20180128	2호선	아현	5939	5970	20180131	11909
20180204	9호선	여의도	6179	5726	20180207	11905
20180123	공항철도 1호선	청라국제도시	6104	5801	20180126	11905
20180204	5호선	굽은다리(강동구민회관앞)	6145	5759	20180207	11904
20180122	중앙선	상봉(시외버스터미널)	6045	5859	20180125	11904
20180127	중앙선	도농	6210	5692	20180130	11902
20180204	7호선	도봉산	4986	6912	20180207	11898
20180212	5호선	왕십리(성동구청)	5643	6254	20180215	11897
20180114	분당선	영통	5890	6004	20180117	11894
20180127	9호선	신방화	6172	5719	20180130	11891
20180113	경의선	탄현	6024	5867	20180116	11891
20180127	경원선	지행	5933	5955	20180130	11888
20180126	4호선	삼각지	5530	6358	20180129	11888
20180123	경원선	덕정	5950	5936	20180126	11886
20180212	6호선	삼각지	6373	5512	20180215	11885
20180129	5호선	을지로4가	5635	6250	20180201	11885
20180203	9호선2단계	언주	6121	5761	20180206	11882
20180127	경의선	일산	5971	5911	20180130	11882
20180114	2호선	신정네거리	5897	5984	20180117	11881
20180115	8호선	송파	5954	5925	20180118	11879
20180115	경의선	문산	6038	5841	20180118	11879
20180206	4호선	삼각지	5557	6320	20180209	11877
20180206	공항철도 1호선	청라국제도시	6033	5844	20180209	11877
20180122	6호선	삼각지	6363	5512	20180125	11875
20180127	경부선	의왕	6096	5769	20180130	11865
20180203	3호선	일원	5732	6132	20180206	11864
20180204	경부선	가산디지털단지	4840	7019	20180207	11859
20180131	6호선	불광	6057	5801	20180203	11858
20180113	7호선	춘의	6172	5685	20180116	11857
20180203	6호선	구산	6635	5221	20180206	11856
20180114	공항철도 1호선	검암	5818	6038	20180117	11856
20180124	5호선	신금호	5923	5932	20180127	11855
20180204	7호선	마들	6092	5761	20180207	11853
20180212	경춘선	평내호평	5991	5860	20180215	11851
20180211	공항철도 1호선	계양	5900	5944	20180214	11844
20180113	수인선	인천논현	5973	5867	20180116	11840
20180127	경부선	관악	5936	5900	20180130	11836
20180112	5호선	왕십리(성동구청)	5416	6420	20180115	11836
20180127	공항철도 1호선	운서	5722	6113	20180130	11835
20180204	7호선	상도	6022	5791	20180207	11813
20180208	중앙선	중랑	6063	5746	20180211	11809
20180212	분당선	이매	5908	5900	20180215	11808
20180115	5호선	왕십리(성동구청)	5532	6276	20180118	11808
20180124	5호선	개화산	6108	5697	20180127	11805
20180120	경의선	행신	6042	5763	20180123	11805
20180120	과천선	선바위	6629	5176	20180123	11805
20180122	6호선	녹사평(용산구청)	5844	5960	20180125	11804
20180211	8호선	복정	6284	5519	20180214	11803
20180129	공항철도 1호선	청라국제도시	6028	5772	20180201	11800
20180114	5호선	송정	5762	6038	20180117	11800
20180113	경의선	행신	6007	5792	20180116	11799
20180125	4호선	삼각지	5540	6258	20180128	11798
20180118	경의선	문산	5944	5852	20180121	11796
20180129	경원선	덕정	5965	5821	20180201	11786
20180119	분당선	구성	5892	5883	20180122	11775
20180122	8호선	송파	5923	5850	20180125	11773
20180212	6호선	태릉입구	5541	6228	20180215	11769
20180115	분당선	이매	5858	5911	20180118	11769
20180126	수인선	인천논현	5767	5989	20180129	11756
20180117	6호선	불광	5957	5799	20180120	11756
20180206	5호선	왕십리(성동구청)	5563	6192	20180209	11755
20180112	9호선	개화	7028	4721	20180115	11749
20180119	6호선	월드컵경기장(성산)	5717	6030	20180122	11747
20180122	6호선	태릉입구	5534	6212	20180125	11746
20180125	중앙선	덕소	5837	5907	20180128	11744
20180207	경춘선	평내호평	5920	5821	20180210	11741
20180205	공항철도 1호선	인천공항2터미널	6398	5341	20180208	11739
20180203	분당선	서울숲	5821	5911	20180206	11732
20180112	4호선	삼각지	5463	6268	20180115	11731
20180205	6호선	녹사평(용산구청)	5778	5947	20180208	11725
20180204	2호선	아현	5872	5850	20180207	11722
20180127	경부선	화서	5947	5772	20180130	11719
20180206	6호선	태릉입구	5596	6119	20180209	11715
20180113	6호선	월드컵경기장(성산)	5654	6061	20180116	11715
20180131	8호선	산성	5902	5808	20180203	11710
20180120	5호선	방이	5984	5722	20180123	11706
20180128	7호선	중곡	6050	5655	20180131	11705
20180119	분당선	상갈	6211	5488	20180122	11699
20180114	5호선	서대문	5975	5721	20180117	11696
20180117	경부선	천안	5825	5870	20180120	11695
20180204	8호선	복정	6230	5463	20180207	11693
20180121	분당선	영통	5795	5896	20180124	11691
20180120	분당선	서울숲	5730	5960	20180123	11690
20180126	경강선	경기광주	6039	5650	20180129	11689
20180207	중앙선	중랑	5963	5723	20180210	11686
20180128	8호선	복정	6172	5510	20180131	11682
20180126	공항철도 1호선	청라국제도시	6019	5661	20180129	11680
20180205	6호선	태릉입구	5576	6101	20180208	11677
20180129	경강선	경기광주	5834	5843	20180201	11677
20180127	3호선	매봉	6016	5661	20180130	11677
20180205	6호선	삼각지	6277	5398	20180208	11675
20180127	분당선	기흥	5921	5752	20180130	11673
20180114	7호선	중곡	5967	5706	20180117	11673
20180122	분당선	이매	5804	5866	20180125	11670
20180113	장항선	온양온천	5772	5896	20180116	11668
20180204	경부선	석수	6006	5661	20180207	11667
20180127	2호선	한양대	5632	6035	20180130	11667
20180130	6호선	불광	5932	5734	20180202	11666
20180126	중앙선	덕소	5895	5766	20180129	11661
20180121	중앙선	망우	5806	5853	20180124	11659
20180112	중앙선	중랑	5949	5702	20180115	11651
20180127	7호선	천왕	6153	5496	20180130	11649
20180112	중앙선	상봉(시외버스터미널)	5851	5795	20180115	11646
20180128	7호선	마들	6006	5639	20180131	11645
20180118	경부선	천안	5855	5787	20180121	11642
20180114	5호선	굽은다리(강동구민회관앞)	6107	5533	20180117	11640
20180126	경인선	구일	5799	5837	20180129	11636
20180121	공항철도 1호선	운서	5414	6219	20180124	11633
20180203	과천선	선바위	6586	5046	20180206	11632
20180123	6호선	녹사평(용산구청)	5666	5966	20180126	11632
20180204	3호선	옥수	5434	6192	20180207	11626
20180127	8호선	가락시장	5454	6171	20180130	11625
20180113	9호선2단계	언주	5870	5752	20180116	11622
20180112	경원선	덕정	5949	5671	20180115	11620
20180121	6호선	녹사평(용산구청)	5789	5830	20180124	11619
20180211	9호선	여의도	6078	5537	20180214	11615
20180114	안산선	고잔	5761	5853	20180117	11614
20180211	2호선	신정네거리	5748	5863	20180214	11611
20180212	8호선	송파	5797	5811	20180215	11608
20180211	공항철도 1호선	인천공항2터미널	6357	5245	20180214	11602
20180205	경춘선	평내호평	5889	5712	20180208	11601
20180208	8호선	수진	6029	5571	20180211	11600
20180127	9호선	양천향교	5963	5637	20180130	11600
20180113	경원선	가능	6040	5559	20180116	11599
20180211	7호선	중곡	5919	5677	20180214	11596
20180208	6호선	불광	5810	5785	20180211	11595
20180131	우이신설선	북한산보국문	6036	5552	20180203	11588
20180123	5호선	을지로4가	5510	6069	20180126	11579
20180121	7호선	부평구청	6299	5280	20180124	11579
20180203	9호선	양천향교	5942	5628	20180206	11570
20180126	9호선	개화	6910	4656	20180129	11566
20180124	공항철도 1호선	청라국제도시	5848	5717	20180127	11565
20180203	8호선	몽촌토성(평화의문)	5722	5840	20180206	11562
20180129	분당선	이매	5892	5668	20180201	11560
20180122	8호선	산성	5820	5739	20180125	11559
20180203	경의선	문산	6169	5388	20180206	11557
20180204	7호선	내방	5651	5905	20180207	11556
20180128	7호선	내방	5653	5902	20180131	11555
20180125	공항철도 1호선	청라국제도시	5896	5659	20180128	11555
20180211	경인선	제물포	5880	5671	20180214	11551
20180122	5호선	왕십리(성동구청)	5493	6054	20180125	11547
20180119	8호선	수진	6034	5513	20180122	11547
20180112	분당선	이매	5735	5808	20180115	11543
20180212	중앙선	중랑	5915	5621	20180215	11536
20180212	8호선	수진	5961	5575	20180215	11536
20180131	경의선	문산	5754	5782	20180203	11536
20180130	우이신설선	솔샘	5594	5939	20180202	11533
20180113	과천선	선바위	6483	5049	20180116	11532
20180128	5호선	굽은다리(강동구민회관앞)	6008	5521	20180131	11529
20180125	수인선	인천논현	5705	5824	20180128	11529
20180120	경원선	덕정	6110	5418	20180123	11528
20180207	8호선	산성	5841	5686	20180210	11527
20180114	분당선	수원	7180	4345	20180117	11525
20180113	공항철도 1호선	운서	5720	5802	20180116	11522
20180123	5호선	왕십리(성동구청)	5464	6056	20180126	11520
20180123	중앙선	중랑	5802	5716	20180126	11518
20180120	중앙선	덕소	5893	5624	20180123	11517
20180211	경부선	남영	5623	5893	20180214	11516
20180118	8호선	산성	5829	5684	20180121	11513
20180114	경인선	중동	5994	5511	20180117	11505
20180205	5호선	왕십리(성동구청)	5491	6013	20180208	11504
20180118	분당선	상갈	5982	5522	20180121	11504
20180128	경원선	도봉산	6955	4548	20180131	11503
20180114	6호선	화랑대(서울여대입구)	6195	5307	20180117	11502
20180124	중앙선	덕소	5774	5727	20180127	11501
20180124	8호선	수진	5940	5561	20180127	11501
20180204	안산선	정왕	5464	6034	20180207	11498
20180211	안산선	오이도	5755	5739	20180214	11494
20180201	8호선	산성	5811	5683	20180204	11494
20180117	8호선	산성	5783	5711	20180120	11494
20180204	경부선	남영	5578	5905	20180207	11483
20180113	9호선	양천향교	5930	5548	20180116	11478
20180204	공항철도 1호선	계양	5754	5722	20180207	11476
20180123	6호선	태릉입구	5430	6042	20180126	11472
20180126	5호선	왕십리(성동구청)	5234	6237	20180129	11471
20180125	5호선	왕십리(성동구청)	5383	6079	20180128	11462
20180120	8호선	몽촌토성(평화의문)	5618	5842	20180123	11460
20180208	경의선	문산	5744	5712	20180211	11456
20180124	수인선	인천논현	5563	5892	20180127	11455
20180120	9호선	국회의사당	5716	5736	20180123	11452
20180204	7호선	중곡	5852	5599	20180207	11451
20180118	8호선	수진	5972	5479	20180121	11451
20180122	4호선	삼각지	5462	5988	20180125	11450
20180117	6호선	월드컵경기장(성산)	5548	5900	20180120	11448
20180121	경원선	신이문	6000	5445	20180124	11445
20180212	6호선	불광	5875	5567	20180215	11442
20180124	4호선	삼각지	5397	6039	20180127	11436
20180128	공항철도 1호선	검암	5617	5817	20180131	11434
20180120	경부선	송탄	5975	5454	20180123	11429
20180211	2호선	한양대	5636	5791	20180214	11427
20180203	6호선	보문	5940	5487	20180206	11427
20180121	6호선	화랑대(서울여대입구)	6157	5269	20180124	11426
20180129	6호선	삼각지	6086	5339	20180201	11425
20180129	중앙선	중랑	5852	5571	20180201	11423
20180118	6호선	불광	5778	5644	20180121	11422
20180125	9호선	개화	6851	4570	20180128	11421
20180207	경원선	도봉산	7286	4121	20180210	11407
20180206	분당선	이매	5693	5713	20180209	11406
20180119	경의선	운정	5965	5430	20180122	11395
20180120	5호선	방화	5985	5409	20180123	11394
20180129	경춘선	평내호평	5779	5613	20180201	11392
20180128	2호선	신정네거리	5633	5759	20180131	11392
20180112	6호선	태릉입구	5403	5986	20180115	11389
20180120	6호선	구산	6495	4893	20180123	11388
20180212	8호선	산성	5743	5637	20180215	11380
20180129	8호선	송파	5721	5659	20180201	11380
20180113	경원선	덕정	6080	5297	20180116	11377
20180205	중앙선	중랑	5850	5523	20180208	11373
20180129	4호선	삼각지	5338	6035	20180201	11373
20180128	경부선	남영	5424	5948	20180131	11372
20180114	일산선	주엽	5468	5903	20180117	11371
20180126	분당선	이매	5794	5575	20180129	11369
20180129	8호선	수진	5854	5513	20180201	11367
20180118	분당선	구성	5692	5673	20180121	11365
20180205	8호선	수진	5846	5516	20180208	11362
20180203	경의선	탄현	5793	5567	20180206	11360
20180123	8호선	송파	5680	5678	20180126	11358
20180117	분당선	구성	5675	5680	20180120	11355
20180212	경의선	문산	5830	5520	20180215	11350
20180205	경의선	문산	5836	5513	20180208	11349
20180128	경인선	제물포	5801	5548	20180131	11349
20180125	경강선	경기광주	5702	5645	20180128	11347
20180127	6호선	대흥(서강대앞)	5665	5681	20180130	11346
20180131	우이신설선	솔샘	5850	5493	20180203	11343
20180121	경인선	백운	5701	5640	20180124	11341
20180129	6호선	태릉입구	5347	5993	20180201	11340
20180128	5호선	송정	5429	5907	20180131	11336
20180119	8호선	신흥	5416	5918	20180122	11334
20180204	분당선	영통	5579	5753	20180207	11332
20180128	안산선	오이도	5665	5665	20180131	11330
20180126	6호선	태릉입구	5485	5842	20180129	11327
20180130	8호선	산성	5642	5683	20180202	11325
20180201	경의선	문산	5807	5517	20180204	11324
20180211	9호선	국회의사당	6006	5316	20180214	11322
20180117	5호선	충정로(경기대입구)	5625	5697	20180120	11322
20180207	5호선	충정로(경기대입구)	5669	5648	20180210	11317
20180128	경인선	부개	5741	5575	20180131	11316
20180122	경의선	운정	5802	5514	20180125	11316
20180112	5호선	을지로4가	5294	6022	20180115	11316
20180211	6호선	녹사평(용산구청)	5598	5715	20180214	11313
20180204	경인선	제물포	5785	5528	20180207	11313
20180129	5호선	왕십리(성동구청)	5318	5995	20180201	11313
20180115	6호선	불광	5640	5672	20180118	11312
20180206	중앙선	중랑	5699	5608	20180209	11307
20180201	6호선	불광	5633	5674	20180204	11307
20180120	수인선	인천논현	5647	5657	20180123	11304
20180205	4호선	삼각지	5354	5947	20180208	11301
20180114	경인선	백운	5715	5586	20180117	11301
20180112	경의선	문산	5736	5565	20180115	11301
20180201	8호선	수진	5832	5461	20180204	11293
20180125	5호선	을지로4가	5383	5910	20180128	11293
20180205	분당선	이매	5652	5639	20180208	11291
20180211	5호선	서대문	5722	5568	20180214	11290
20180123	경춘선	평내호평	5737	5553	20180126	11290
20180124	9호선	개화	6639	4650	20180127	11289
20180121	8호선	강동구청	5569	5720	20180124	11289
20180113	6호선	보문	6007	5282	20180116	11289
20180203	경의선	행신	5767	5516	20180206	11283
20180204	5호선	송정	5495	5786	20180207	11281
20180122	분당선	구성	5527	5754	20180125	11281
20180118	3호선	학여울	5737	5542	20180121	11279
20180121	안산선	고잔	5591	5686	20180124	11277
20180127	9호선2단계	언주	5742	5533	20180130	11275
20180114	7호선	굴포천	5583	5689	20180117	11272
20180127	9호선	국회의사당	5627	5643	20180130	11270
20180203	5호선	방화	5800	5467	20180206	11267
20180114	7호선	부평구청	6108	5156	20180117	11264
20180212	경원선	도봉산	7251	4012	20180215	11263
20180131	분당선	구성	5601	5659	20180203	11260
20180119	수인선	연수	5610	5648	20180122	11258
20180130	5호선	충정로(경기대입구)	5612	5639	20180202	11251
20180211	6호선	화랑대(서울여대입구)	5938	5311	20180214	11249
20180126	경원선	덕정	5676	5572	20180129	11248
20180120	3호선	일원	5585	5663	20180123	11248
20180201	분당선	상갈	5840	5407	20180204	11247
20180206	6호선	불광	5661	5584	20180209	11245
20180127	6호선	삼각지	6432	4813	20180130	11245
20180121	9호선	국회의사당	5993	5250	20180124	11243
20180114	9호선	국회의사당	5931	5306	20180117	11237
20180126	경부선	천안	5626	5608	20180129	11234
20180211	분당선	수원	6859	4372	20180214	11231
20180211	분당선	영통	5686	5543	20180214	11229
20180131	5호선	충정로(경기대입구)	5526	5702	20180203	11228
20180127	7호선	뚝섬유원지	5687	5541	20180130	11228
20180204	경인선	부개	5714	5511	20180207	11225
20180121	분당선	수원	7021	4203	20180124	11224
20180120	6호선	보문	5956	5265	20180123	11221
20180114	경원선	신이문	5901	5317	20180117	11218
20180131	경부선	천안	5673	5543	20180203	11216
20180211	3호선	옥수	5334	5881	20180214	11215
20180124	5호선	왕십리(성동구청)	5334	5879	20180127	11213
20180117	수인선	인하대	5825	5387	20180120	11212
20180208	분당선	구성	5572	5639	20180211	11211
20180206	경춘선	평내호평	5688	5523	20180209	11211
20180204	경원선	양주	5748	5462	20180207	11210
20180131	분당선	상갈	5838	5371	20180203	11209
20180212	분당선	구성	5515	5689	20180215	11204
20180207	공항철도 1호선	인천공항2터미널	6136	5064	20180210	11200
20180126	중앙선	상봉(시외버스터미널)	5577	5618	20180129	11195
20180121	5호선	상일동	5653	5541	20180124	11194
20180208	경부선	천안	5628	5560	20180211	11188
20180115	분당선	구성	5516	5672	20180118	11188
20180121	7호선	굴포천	5493	5691	20180124	11184
20180128	3호선	옥수	5308	5873	20180131	11181
20180123	중앙선	상봉(시외버스터미널)	5621	5552	20180126	11173
20180114	5호선	상일동	5700	5473	20180117	11173
20180212	경부선	천안	5600	5568	20180215	11168
20180204	5호선	상일동	5682	5486	20180207	11168
20180115	8호선	산성	5643	5525	20180118	11168
20180114	8호선	강동구청	5479	5689	20180117	11168
20180113	6호선	구산	6255	4912	20180116	11167
20180205	6호선	불광	5641	5520	20180208	11161
20180211	경원선	양주	5732	5428	20180214	11160
20180203	4호선	삼각지	4895	6264	20180206	11159
20180123	분당선	이매	5587	5566	20180126	11153
20180118	경의선	운정	5820	5330	20180121	11150
20180117	분당선	상갈	5767	5381	20180120	11148
20180124	8호선	산성	5623	5524	20180127	11147
20180114	5호선	영등포시장	5352	5794	20180117	11146
20180121	3호선	독립문	5368	5776	20180124	11144
20180120	경부선	군포	5875	5268	20180123	11143
20180124	경강선	경기광주	5588	5553	20180127	11141
20180208	우이신설선	북한산보국문	5686	5453	20180211	11139
20180204	5호선	서대문	5683	5456	20180207	11139
20180204	9호선	국회의사당	5884	5248	20180207	11132
20180120	분당선	가천대	5271	5861	20180123	11132
20180131	6호선	월드컵경기장(성산)	5352	5778	20180203	11130
20180203	분당선	가천대	5226	5903	20180206	11129
20180208	공항철도 1호선	인천공항2터미널	5935	5190	20180211	11125
20180122	8호선	수진	5762	5363	20180125	11125
20180129	경의선	문산	5623	5497	20180201	11120
20180114	6호선	녹사평(용산구청)	5638	5481	20180117	11119
20180113	분당선	서울숲	5600	5519	20180116	11119
20180211	5호선	굽은다리(강동구민회관앞)	5788	5330	20180214	11118
20180207	경의선	문산	5528	5590	20180210	11118
20180201	우이신설선	북한산보국문	5760	5358	20180204	11118
20180204	2호선	신정네거리	5499	5617	20180207	11116
20180129	8호선	산성	5625	5489	20180201	11114
20180129	6호선	녹사평(용산구청)	5486	5628	20180201	11114
20180128	분당선	영통	5485	5626	20180131	11111
20180114	경부선	관악	5736	5372	20180117	11108
20180212	분당선	상갈	5713	5393	20180215	11106
20180114	경의선	금촌	5210	5889	20180117	11099
20180205	8호선	산성	5584	5511	20180208	11095
20180128	5호선	서대문	5726	5367	20180131	11093
20180120	중앙선	상봉(시외버스터미널)	5612	5481	20180123	11093
20180113	8호선	몽촌토성(평화의문)	5323	5766	20180116	11089
20180128	5호선	영등포시장	5351	5737	20180131	11088
20180119	5호선	마천	5594	5492	20180122	11086
20180126	중앙선	중랑	5598	5486	20180129	11084
20180113	2호선	한양대	5425	5656	20180116	11081
20180211	경인선	부개	5659	5421	20180214	11080
20180211	5호선	송정	5313	5758	20180214	11071
20180201	경부선	천안	5585	5486	20180204	11071
20180117	우이신설선	솔샘	5643	5428	20180120	11071
20180119	분당선	신갈	5713	5356	20180122	11069
20180114	경부선	신길	6033	5035	20180117	11068
20180128	경원선	양주	5689	5377	20180131	11066
20180211	5호선	상일동	5651	5412	20180214	11063
20180211	경원선	도봉산	6696	4365	20180214	11061
20180119	우이신설선	북한산보국문	5793	5259	20180122	11052
20180122	6호선	불광	5643	5407	20180125	11050
20180124	6호선	불광	5664	5380	20180127	11044
20180128	6호선	화랑대(서울여대입구)	5873	5168	20180131	11041
20180212	경의선	운정	5779	5261	20180215	11040
20180118	6호선	월드컵경기장(성산)	5364	5676	20180121	11040
20180128	6호선	신당	5313	5723	20180131	11036
20180130	경의선	문산	5524	5509	20180202	11033
20180130	분당선	구성	5333	5697	20180202	11030
20180203	일산선	원흥	5912	5112	20180206	11024
20180127	7호선	춘의	5749	5273	20180130	11022
20180208	분당선	상갈	5673	5347	20180211	11020
20180204	7호선	굴포천	5383	5635	20180207	11018
20180120	경인선	온수(성공회대입구)	5714	5294	20180123	11008
20180125	6호선	태릉입구	5303	5700	20180128	11003
20180201	분당선	구성	5425	5576	20180204	11001
20180129	경부선	천안	5512	5487	20180201	10999
20180125	중앙선	중랑	5630	5365	20180128	10995
20180127	경의선	문산	5836	5158	20180130	10994
20180211	경의선	금촌	5192	5799	20180214	10991
20180131	5호선	마천	5483	5508	20180203	10991
20180208	경의선	운정	5720	5270	20180211	10990
20180121	안산선	한대앞	5603	5381	20180124	10984
20180119	우이신설선	솔샘	5789	5190	20180122	10979
20180120	경인선	간석	5681	5294	20180123	10975
20180121	경원선	망월사	5508	5466	20180124	10974
20180120	7호선	까치울	5691	5280	20180123	10971
20180129	6호선	불광	5564	5406	20180201	10970
20180113	5호선	방화	5646	5323	20180116	10969
20180112	8호선	송파	5573	5393	20180115	10966
20180212	5호선	충정로(경기대입구)	5405	5556	20180215	10961
20180208	우이신설선	솔샘	5639	5321	20180211	10960
20180114	중앙선	망우	5498	5462	20180117	10960
20180207	7호선	삼산체육관	5732	5220	20180210	10952
20180206	8호선	산성	5506	5446	20180209	10952
20180112	6호선	불광	5630	5322	20180115	10952
20180203	장항선	온양온천	5493	5456	20180206	10949
20180207	우이신설선	솔샘	5589	5359	20180210	10948
20180122	분당선	상갈	5677	5267	20180125	10944
20180119	수인선	인하대	5709	5230	20180122	10939
20180201	5호선	마천	5463	5475	20180204	10938
20180113	3호선	일원	5466	5472	20180116	10938
20180204	분당선	수원	6769	4164	20180207	10933
20180117	5호선	마천	5438	5493	20180120	10931
20180124	6호선	녹사평(용산구청)	5378	5551	20180127	10929
20180208	8호선	신흥	5330	5597	20180211	10927
20180206	경의선	운정	5633	5293	20180209	10926
20180206	5호선	충정로(경기대입구)	5395	5531	20180209	10926
20180118	수인선	인하대	5629	5291	20180121	10920
20180211	경인선	중동	5615	5303	20180214	10918
20180128	경인선	중동	5627	5291	20180131	10918
20180115	분당선	상갈	5687	5229	20180118	10916
20180120	일산선	원흥	6016	4897	20180123	10913
20180124	분당선	이매	5418	5492	20180127	10910
20180123	경의선	문산	5454	5456	20180126	10910
20180122	우이신설선	솔샘	5462	5448	20180125	10910
20180121	경부선	신길	5979	4931	20180124	10910
20180211	5호선	마포	5376	5533	20180214	10909
20180201	우이신설선	솔샘	5600	5308	20180204	10908
20180117	경의선	운정	5707	5201	20180120	10908
20180127	분당선	서울숲	5359	5548	20180130	10907
20180204	경부선	관악	5544	5361	20180207	10905
20180124	중앙선	중랑	5530	5375	20180127	10905
20180127	5호선	행당	5883	5019	20180130	10902
20180125	6호선	녹사평(용산구청)	5391	5511	20180128	10902
20180128	경의선	일산	5522	5378	20180131	10900
20180121	일산선	주엽	5286	5612	20180124	10898
20180203	6호선	월드컵경기장(성산)	5232	5656	20180206	10888
20180128	분당선	수원	6821	4065	20180131	10886
20180125	경원선	덕정	5486	5399	20180128	10885
20180207	우이신설선	북한산보국문	5611	5271	20180210	10882
20180204	경인선	중동	5551	5326	20180207	10877
20180125	분당선	이매	5447	5430	20180128	10877
20180124	5호선	을지로4가	5209	5667	20180127	10876
20180123	8호선	산성	5472	5404	20180126	10876
20180204	6호선	화랑대(서울여대입구)	5855	5018	20180207	10873
20180211	공항철도 1호선	검암	5288	5577	20180214	10865
20180118	5호선	충정로(경기대입구)	5401	5460	20180121	10861
20180122	분당선	신갈	5485	5375	20180125	10860
20180124	6호선	태릉입구	5133	5722	20180127	10855
20180131	7호선	삼산체육관	5769	5084	20180203	10853
20180211	5호선	영등포시장	5240	5611	20180214	10851
20180211	경원선	신이문	5709	5138	20180214	10847
20180119	7호선	부천종합운동장	5829	5015	20180122	10844
20180211	9호선	등촌	5349	5494	20180214	10843
20180205	우이신설선	솔샘	5502	5340	20180208	10842
20180130	분당선	상갈	5551	5290	20180202	10841
20180112	경춘선	평내호평	5483	5355	20180115	10838
20180126	5호선	을지로4가	5078	5759	20180129	10837
20180113	분당선	가천대	5079	5753	20180116	10832
20180211	경인선	백운	5453	5376	20180214	10829
20180124	8호선	송파	5424	5405	20180127	10829
20180124	경원선	덕정	5447	5380	20180127	10827
20180117	우이신설선	북한산보국문	5566	5260	20180120	10826
20180201	5호선	충정로(경기대입구)	5334	5489	20180204	10823
20180121	3호선	학여울	5506	5312	20180124	10818
20180121	6호선	신당	5207	5609	20180124	10816
20180113	경인선	온수(성공회대입구)	5592	5223	20180116	10815
20180204	7호선	부평구청	5855	4952	20180207	10807
20180115	6호선	월드컵경기장(성산)	5325	5480	20180118	10805
20180203	경인선	온수(성공회대입구)	5463	5340	20180206	10803
20180131	경의선	운정	5658	5145	20180203	10803
20180114	안산선	한대앞	5476	5316	20180117	10792
20180204	안산선	오이도	5413	5378	20180207	10791
20180123	5호선	충정로(경기대입구)	5295	5492	20180126	10787
20180130	경의선	운정	5388	5398	20180202	10786
20180206	우이신설선	북한산보국문	5552	5232	20180209	10784
20180207	분당선	상갈	5605	5178	20180210	10783
20180204	중앙선	망우	5336	5447	20180207	10783
20180118	우이신설선	솔샘	5525	5257	20180121	10782
20180129	경원선	도봉산	6912	3869	20180201	10781
20180125	5호선	충정로(경기대입구)	5339	5438	20180128	10777
20180115	5호선	충정로(경기대입구)	5388	5388	20180118	10776
20180128	공항철도 1호선	운서	5021	5748	20180131	10769
20180122	5호선	충정로(경기대입구)	5369	5400	20180125	10769
20180126	경의선	문산	5486	5282	20180129	10768
20180203	수인선	인천논현	5395	5368	20180206	10763
20180131	5호선	올림픽공원(한국체대)	5597	5164	20180203	10761
20180208	경원선	월계	5611	5149	20180211	10760
20180207	5호선	마천	5391	5368	20180210	10759
20180122	우이신설선	북한산보국문	5442	5317	20180125	10759
20180130	8호선	수진	5613	5144	20180202	10757
20180129	5호선	충정로(경기대입구)	5299	5458	20180201	10757
20180126	8호선	송파	5452	5304	20180129	10756
20180126	6호선	불광	5371	5384	20180129	10755
20180203	경원선	덕정	5641	5113	20180206	10754
20180112	8호선	산성	5546	5207	20180115	10753
20180208	5호선	마천	5418	5333	20180211	10751
20180201	6호선	월드컵경기장(성산)	5253	5497	20180204	10750
20180117	분당선	신갈	5417	5324	20180120	10741
20180128	7호선	굴포천	5255	5484	20180131	10739
20180125	중앙선	상봉(시외버스터미널)	5399	5339	20180128	10738
20180205	5호선	충정로(경기대입구)	5285	5452	20180208	10737
20180125	8호선	산성	5424	5313	20180128	10737
20180123	6호선	불광	5485	5251	20180126	10736
20180204	6호선	신당	5156	5579	20180207	10735
20180203	분당선	도곡	5455	5278	20180206	10733
20180205	경원선	도봉산	6956	3776	20180208	10732
20180204	공항철도 1호선	검암	5236	5494	20180207	10730
20180120	경부선	당정	5592	5138	20180123	10730
20180126	8호선	수진	5561	5163	20180129	10724
20180115	8호선	수진	5595	5129	20180118	10724
20180206	8호선	수진	5576	5144	20180209	10720
20180113	경부선	송탄	5577	5142	20180116	10719
20180204	경원선	도봉산	6424	4292	20180207	10716
20180127	경원선	가능	5579	5135	20180130	10714
20180117	수인선	연수	5333	5380	20180120	10713
20180124	중앙선	상봉(시외버스터미널)	5413	5298	20180127	10711
20180204	경인선	백운	5403	5307	20180207	10710
20180113	중앙선	상봉(시외버스터미널)	5274	5436	20180116	10710
20180212	공항철도 1호선	인천공항2터미널	5876	4833	20180215	10709
20180122	5호선	마천	5343	5365	20180125	10708
20180201	경의선	운정	5554	5151	20180204	10705
20180115	우이신설선	북한산보국문	5416	5288	20180118	10704
20180206	경원선	도봉산	6930	3773	20180209	10703
20180204	5호선	영등포시장	5275	5426	20180207	10701
20180115	경의선	운정	5567	5132	20180118	10699
20180120	5호선	올림픽공원(한국체대)	5493	5205	20180123	10698
20180212	우이신설선	솔샘	5500	5197	20180215	10697
20180203	중앙선	덕소	5320	5377	20180206	10697
20180128	경원선	신이문	5541	5154	20180131	10695
20180128	경인선	백운	5329	5363	20180131	10692
20180118	우이신설선	북한산보국문	5544	5148	20180121	10692
20180207	분당선	구성	5210	5481	20180210	10691
20180112	8호선	수진	5560	5129	20180115	10689
20180129	분당선	구성	5319	5369	20180201	10688
20180115	수인선	인하대	5519	5169	20180118	10688
20180131	7호선	부천종합운동장	5746	4941	20180203	10687
20180121	9호선	등촌	5179	5506	20180124	10685
20180130	5호선	마천	5257	5426	20180202	10683
20180127	6호선	보문	5653	5029	20180130	10682
20180206	공항철도 1호선	인천공항2터미널	5887	4791	20180209	10678
20180212	5호선	마천	5364	5310	20180215	10674
20180212	우이신설선	북한산보국문	5454	5219	20180215	10673
20180120	2호선	양천구청	5299	5372	20180123	10671
20180208	6호선	월드컵경기장(성산)	5151	5518	20180211	10669
20180211	7호선	굴포천	5247	5420	20180214	10667
20180204	일산선	주엽	5180	5484	20180207	10664
20180126	8호선	산성	5479	5184	20180129	10663
20180204	6호선	녹사평(용산구청)	5227	5435	20180207	10662
20180115	우이신설선	솔샘	5485	5175	20180118	10660
20180211	8호선	강동구청	5250	5409	20180214	10659
20180203	7호선	까치울	5518	5139	20180206	10657
20180212	6호선	월드컵경기장(성산)	5141	5515	20180215	10656
20180207	7호선	부천종합운동장	5630	5021	20180210	10651
20180127	과천선	선바위	5988	4661	20180130	10649
20180123	분당선	상갈	5502	5146	20180126	10648
20180121	경원선	광운대	5294	5354	20180124	10648
20180115	5호선	마천	5307	5341	20180118	10648
20180205	우이신설선	북한산보국문	5407	5237	20180208	10644
20180125	8호선	송파	5326	5317	20180128	10643
20180128	안산선	고잔	5365	5268	20180131	10633
20180131	분당선	신갈	5464	5167	20180203	10631
20180118	분당선	신갈	5380	5251	20180121	10631
20180117	7호선	부천종합운동장	5717	4914	20180120	10631
20180211	7호선	부평구청	5678	4951	20180214	10629
20180113	7호선	까치울	5524	5105	20180116	10629
20180118	8호선	신흥	5143	5485	20180121	10628
20180113	중앙선	덕소	5320	5308	20180116	10628
20180131	8호선	신흥	5131	5494	20180203	10625
20180131	수인선	연수	5297	5328	20180203	10625
20180123	분당선	구성	5295	5328	20180126	10623
20180203	경부선	두정	5316	5306	20180206	10622
20180205	분당선	구성	5233	5387	20180208	10620
20180121	경원선	지행	5348	5266	20180124	10614
20180125	6호선	불광	5441	5172	20180128	10613
20180211	3호선	독립문	5227	5384	20180214	10611
20180208	5호선	충정로(경기대입구)	5215	5396	20180211	10611
20180119	경의선	금릉	5348	5263	20180122	10611
20180127	5호선	방이	5464	5144	20180130	10608
20180119	경의선	가좌	5499	5106	20180122	10605
20180121	3호선	가락시장	5217	5385	20180124	10602
20180203	경부선	군포	5550	5050	20180206	10600
20180113	일산선	원흥	5860	4737	20180116	10597
20180204	8호선	강동구청	5127	5467	20180207	10594
20180206	우이신설선	솔샘	5391	5201	20180209	10592
20180201	8호선	신흥	5153	5439	20180204	10592
20180120	경원선	도봉	5444	5146	20180123	10590
20180127	6호선	구산	5996	4592	20180130	10588
20180112	분당선	상갈	5570	5018	20180115	10588
20180212	분당선	신갈	5391	5194	20180215	10585
20180206	분당선	상갈	5540	5044	20180209	10584
20180113	경인선	간석	5474	5109	20180116	10583
20180114	5호선	마포	5287	5294	20180117	10581
20180123	우이신설선	솔샘	5426	5150	20180126	10576
20180124	5호선	충정로(경기대입구)	5217	5356	20180127	10573
20180126	경춘선	평내호평	5309	5258	20180129	10567
20180128	경부선	신길	5794	4770	20180131	10564
20180113	경부선	군포	5588	4971	20180116	10559
20180127	3호선	일원	5213	5345	20180130	10558
20180204	5호선	마포	5218	5339	20180207	10557
20180204	9호선	등촌	5244	5312	20180207	10556
20180114	3호선	독립문	5130	5422	20180117	10552
20180206	경의선	문산	5315	5236	20180209	10551
20180123	경원선	도봉산	6831	3720	20180126	10551
20180118	7호선	삼산체육관	5661	4890	20180121	10551
20180114	경원선	지행	5290	5258	20180117	10548
20180121	9호선	흑석(중앙대입구)	5135	5412	20180124	10547
20180125	경춘선	평내호평	5350	5196	20180128	10546
20180130	경부선	천안	5262	5282	20180202	10544
20180128	5호선	상일동	5293	5251	20180131	10544
20180128	9호선	국회의사당	5672	4871	20180131	10543
20180122	8호선	신흥	5061	5482	20180125	10543
20180119	5호선	올림픽공원(한국체대)	5480	5061	20180122	10541
20180114	5호선	명일	5284	5257	20180117	10541
20180121	장항선	온양온천	5224	5312	20180124	10536
20180128	경의선	금촌	5021	5513	20180131	10534
20180212	8호선	신흥	5027	5504	20180215	10531
20180123	경부선	천안	5280	5251	20180126	10531
20180208	7호선	삼산체육관	5546	4981	20180211	10527
20180211	일산선	주엽	5281	5244	20180214	10525
20180207	경의선	운정	5486	5034	20180210	10520
20180203	2호선	양천구청	5211	5306	20180206	10517
20180121	5호선	마포	5201	5314	20180124	10515
20180206	분당선	구성	5150	5363	20180209	10513
20180128	8호선	강동구청	5203	5309	20180131	10512
20180127	경부선	두정	5197	5308	20180130	10505
20180204	공항철도 1호선	운서	5002	5499	20180207	10501
20180127	6호선	월드컵경기장(성산)	5081	5417	20180130	10498
20180205	경부선	천안	5178	5319	20180208	10497
20180113	7호선	반포	5435	5062	20180116	10497
20180208	경원선	녹양	5424	5070	20180211	10494
20180208	수인선	인하대	5504	4989	20180211	10493
20180118	5호선	마천	5189	5300	20180121	10489
20180126	경부선	두정	5321	5162	20180129	10483
20180204	경원선	신이문	5442	5039	20180207	10481
20180121	8호선	석촌	5088	5393	20180124	10481
20180120	5호선	거여	5435	5043	20180123	10478
20180113	경부선	당정	5432	5045	20180116	10477
20180204	경부선	신길	5738	4733	20180207	10471
20180117	7호선	삼산체육관	5606	4864	20180120	10470
20180204	장항선	온양온천	5249	5218	20180207	10467
20180203	경부선	송탄	5411	5056	20180206	10467
20180129	우이신설선	북한산보국문	5274	5193	20180201	10467
20180119	경원선	월계	5523	4943	20180122	10466
20180208	경부선	두정	5114	5349	20180211	10463
20180130	6호선	월드컵경기장(성산)	5148	5312	20180202	10460
20180123	8호선	수진	5411	5049	20180126	10460
20180120	7호선	반포	5395	5065	20180123	10460
20180122	경의선	가좌	5425	5029	20180125	10454
20180203	7호선	반포	5416	5037	20180206	10453
20180129	분당선	상갈	5421	5032	20180201	10453
20180130	분당선	신갈	5279	5169	20180202	10448
20180131	수인선	인하대	5413	5030	20180203	10443
20180114	9호선	등촌	5070	5373	20180117	10443
20180120	3호선	도곡	5192	5250	20180123	10442
20180119	7호선	삼산체육관	5558	4884	20180122	10442
20180130	5호선	올림픽공원(한국체대)	5362	5076	20180202	10438
20180127	경원선	도봉산	6458	3980	20180130	10438
20180127	경의선	탄현	5255	5180	20180130	10435
20180207	경부선	천안	5205	5229	20180210	10434
20180128	7호선	부평구청	5642	4788	20180131	10430
20180121	3호선	종로3가	3818	6605	20180124	10423
20180128	중앙선	망우	5275	5146	20180131	10421
20180124	경춘선	평내호평	5291	5129	20180127	10420
20180114	3호선	종로3가	3816	6602	20180117	10418
20180113	6호선	불광	5497	4919	20180116	10416
20180113	2호선	양천구청	5187	5227	20180116	10414
20180118	수인선	연수	5161	5252	20180121	10413
20180207	8호선	신흥	5020	5391	20180210	10411
20180211	안산선	고잔	5221	5189	20180214	10410
20180120	7호선	삼산체육관	5347	5063	20180123	10410
20180119	경부선	송탄	5354	5056	20180122	10410
20180114	8호선	석촌	5146	5261	20180117	10407
20180127	경인선	온수(성공회대입구)	5345	5058	20180130	10403
20180201	분당선	신갈	5331	5071	20180204	10402
20180117	5호선	올림픽공원(한국체대)	5386	5013	20180120	10399
20180128	5호선	마포	5172	5220	20180131	10392
20180117	8호선	신흥	5038	5353	20180120	10391
20180115	경부선	두정	5057	5334	20180118	10391
20180208	7호선	부천종합운동장	5594	4796	20180211	10390
20180115	분당선	신갈	5312	5078	20180118	10390
20180112	우이신설선	북한산보국문	5297	5093	20180115	10390
20180128	6호선	녹사평(용산구청)	5057	5332	20180131	10389
20180211	안산선	한대앞	5305	5083	20180214	10388
20180122	7호선	부천종합운동장	5546	4842	20180125	10388
20180128	일산선	주엽	5052	5334	20180131	10386
20180130	7호선	부천종합운동장	5472	4912	20180202	10384
20180121	경부선	두정	4797	5585	20180124	10382
20180120	중앙선	중랑	5175	5204	20180123	10379
20180115	8호선	신흥	5050	5325	20180118	10375
20180115	수인선	연수	5186	5186	20180118	10372
20180201	수인선	인하대	5355	5013	20180204	10368
20180128	9호선	등촌	5167	5200	20180131	10367
20180212	수인선	인하대	5431	4928	20180215	10359
20180121	5호선	명일	5208	5149	20180124	10357
20180204	3호선	독립문	4985	5367	20180207	10352
20180129	8호선	신흥	5039	5313	20180201	10352
20180114	6호선	한강진	4821	5531	20180117	10352
20180119	5호선	충정로(경기대입구)	5144	5205	20180122	10349
20180120	과천선	대공원	5093	5254	20180123	10347
20180205	경의선	운정	5482	4862	20180208	10344
20180127	중앙선	상봉(시외버스터미널)	5242	5102	20180130	10344
20180114	경의선	문산	4625	5719	20180117	10344
20180129	우이신설선	솔샘	5269	5072	20180201	10341
20180205	분당선	상갈	5310	5030	20180208	10340
20180114	7호선	뚝섬유원지	5243	5096	20180117	10339
20180118	7호선	부천종합운동장	5500	4832	20180121	10332
20180122	수인선	인하대	5357	4973	20180125	10330
20180211	경부선	신길	5649	4680	20180214	10329
20180119	수인선	원인재	5152	5177	20180122	10329
20180114	경원선	광운대	5203	5126	20180117	10329
20180208	분당선	신갈	5279	5047	20180211	10326
20180120	분당선	도곡	5397	4921	20180123	10318
20180126	5호선	충정로(경기대입구)	5142	5175	20180129	10317
20180115	7호선	부천종합운동장	5534	4783	20180118	10317
20180112	8호선	신흥	4927	5390	20180115	10317
20180205	5호선	마천	5187	5123	20180208	10310
20180120	5호선	여의나루	5084	5220	20180123	10304
20180130	8호선	신흥	4901	5401	20180202	10302
20180207	수인선	연수	5157	5140	20180210	10297
20180130	수인선	인하대	5330	4967	20180202	10297
20180207	6호선	월드컵경기장(성산)	4947	5349	20180210	10296
20180119	2호선	신설동	5149	5146	20180122	10295
20180125	8호선	수진	5403	4891	20180128	10294
20180128	경부선	관악	5282	5011	20180131	10293
20180126	8호선	신흥	4887	5400	20180129	10287
20180112	수인선	연수	5092	5195	20180115	10287
20180204	경의선	금촌	4821	5465	20180207	10286
20180205	7호선	삼산체육관	5439	4839	20180208	10278
20180128	경원선	망월사	5066	5211	20180131	10277
20180211	3호선	종로3가	3863	6412	20180214	10275
20180127	5호선	방화	5251	5024	20180130	10275
20180122	5호선	올림픽공원(한국체대)	5290	4981	20180125	10271
20180203	6호선	불광	5539	4731	20180206	10270
20180115	7호선	삼산체육관	5515	4755	20180118	10270
20180201	7호선	부천종합운동장	5501	4765	20180204	10266
20180127	8호선	몽촌토성(평화의문)	5087	5172	20180130	10259
20180121	7호선	태릉입구	5473	4786	20180124	10259
20180203	3호선	도곡	5126	5132	20180206	10258
20180131	경원선	녹천	5625	4632	20180203	10257
20180119	경부선	서정리	5267	4990	20180122	10257
20180115	경의선	가좌	5351	4903	20180118	10254
20180203	5호선	마장	5253	4999	20180206	10252
20180127	경의선	행신	5177	5068	20180130	10245
20180208	경의선	가좌	5383	4859	20180211	10242
20180207	수인선	인하대	5320	4922	20180210	10242
20180207	경원선	월계	5309	4932	20180210	10241
20180123	경의선	운정	5313	4927	20180126	10240
20180123	우이신설선	북한산보국문	5200	5038	20180126	10238
20180112	경원선	도봉산	6642	3596	20180115	10238
20180212	7호선	부천종합운동장	5472	4763	20180215	10235
20180211	경원선	망월사	5069	5165	20180214	10234
20180204	5호선	올림픽공원(한국체대)	4982	5247	20180207	10229
20180121	5호선	공덕	5056	5171	20180124	10227
20180122	6호선	월드컵경기장(성산)	4995	5230	20180125	10225
20180112	5호선	충정로(경기대입구)	5052	5171	20180115	10223
20180206	5호선	마천	5114	5107	20180209	10221
20180201	수인선	연수	5121	5100	20180204	10221
20180114	7호선	태릉입구	5382	4839	20180117	10221
20180208	경원선	녹천	5640	4579	20180211	10219
20180203	경인선	간석	5242	4973	20180206	10215
20180122	7호선	삼산체육관	5433	4782	20180125	10215
20180211	공항철도 1호선	운서	4859	5354	20180214	10213
20180121	2호선	충정로(경기대입구)	5082	5129	20180124	10211
20180121	7호선	뚝섬유원지	5113	5097	20180124	10210
20180205	8호선	신흥	4931	5278	20180208	10209
20180112	분당선	구성	5099	5109	20180115	10208
20180123	5호선	마천	5084	5122	20180126	10206
20180127	분당선	가천대	4770	5427	20180130	10197
20180203	5호선	거여	5279	4914	20180206	10193
20180120	6호선	불광	5396	4797	20180123	10193
20180131	경의선	가좌	5342	4850	20180203	10192
20180120	5호선	왕십리(성동구청)	4450	5737	20180123	10187
20180114	공항철도 1호선	운서	4723	5464	20180117	10187
20180128	7호선	보라매	5232	4954	20180131	10186
20180203	7호선	용마산	5285	4899	20180206	10184
20180128	5호선	명일	5033	5151	20180131	10184
20180211	경원선	광운대	5130	5052	20180214	10182
20180211	경부선	관악	5246	4935	20180214	10181
20180128	안산선	한대앞	5276	4893	20180131	10169
20180203	5호선	왕십리(성동구청)	4506	5659	20180206	10165
20180121	3호선	금호	5168	4997	20180124	10165
20180115	경원선	녹천	5557	4608	20180118	10165
20180118	경부선	두정	5018	5142	20180121	10160
20180113	수인선	연수	5076	5082	20180116	10158
20180129	5호선	마천	5064	5078	20180201	10142
20180204	9호선	흑석(중앙대입구)	4937	5204	20180207	10141
20180126	분당선	구성	5016	5124	20180129	10140
20180212	7호선	삼산체육관	5501	4637	20180215	10138
20180203	경원선	도봉	5223	4915	20180206	10138
20180123	8호선	신흥	4884	5253	20180126	10137
20180114	2호선	충정로(경기대입구)	5038	5099	20180117	10137
20180212	경부선	두정	5062	5074	20180215	10136
20180205	5호선	올림픽공원(한국체대)	5196	4940	20180208	10136
20180207	분당선	신갈	5190	4941	20180210	10131
20180204	경원선	망월사	4990	5141	20180207	10131
20180117	수인선	원인재	5010	5120	20180120	10130
20180203	3호선	오금	5305	4819	20180206	10124
20180122	경원선	녹양	5278	4840	20180125	10118
20180119	경원선	녹양	5243	4875	20180122	10118
20180211	중앙선	망우	5108	5009	20180214	10117
20180114	6호선	돌곶이	5203	4912	20180117	10115
20180113	경원선	도봉	5233	4880	20180116	10113
20180113	분당선	도곡	5279	4832	20180116	10111
20180201	7호선	삼산체육관	5333	4773	20180204	10106
20180127	수인선	인천논현	4979	5127	20180130	10106
20180113	5호선	왕십리(성동구청)	4477	5629	20180116	10106
20180121	중앙선	도농	5243	4862	20180124	10105
20180113	5호선	개롱	5038	5067	20180116	10105
20180201	5호선	올림픽공원(한국체대)	5143	4961	20180204	10104
20180130	7호선	삼산체육관	5309	4795	20180202	10104
20180117	경부선	두정	5038	5064	20180120	10102
20180211	6호선	광흥창(서강)	5152	4949	20180214	10101
20180129	경의선	운정	5200	4897	20180201	10097
20180120	3호선	오금	5304	4792	20180123	10096
20180126	분당선	상갈	5276	4815	20180129	10091
20180120	6호선	효창공원앞	5380	4709	20180123	10089
20180122	경원선	녹천	5444	4642	20180125	10086
20180119	경의선	풍산	5201	4879	20180122	10080
20180120	5호선	개롱	5045	5033	20180123	10078
20180118	경원선	녹천	5522	4556	20180121	10078
20180206	7호선	삼산체육관	5356	4715	20180209	10071
20180204	안산선	한대앞	5106	4964	20180207	10070
20180122	수인선	연수	5031	5038	20180125	10069
20180206	경부선	천안	5041	5024	20180209	10065
20180203	경부선	당정	5231	4834	20180206	10065
20180120	경강선	경기광주	5185	4870	20180123	10055
20180206	8호선	신흥	4859	5195	20180209	10054
20180204	3호선	가락시장	4928	5125	20180207	10053
20180120	3호선	경찰병원	5135	4918	20180123	10053
20180119	경원선	녹천	5628	4425	20180122	10053
20180205	7호선	부천종합운동장	5371	4681	20180208	10052
20180126	우이신설선	솔샘	5242	4810	20180129	10052
20180121	경의선	일산	5191	4861	20180124	10052
20180125	분당선	상갈	5179	4871	20180128	10050
20180118	경의선	가좌	5232	4816	20180121	10048
20180117	경원선	녹천	5487	4561	20180120	10048
20180130	경원선	월계	5178	4867	20180202	10045
20180201	경의선	가좌	5265	4777	20180204	10042
20180117	경원선	녹양	5202	4838	20180120	10040
20180124	우이신설선	솔샘	5111	4926	20180127	10037
20180118	경의선	풍산	5194	4843	20180121	10037
20180114	경부선	두정	4738	5294	20180117	10032
20180113	9호선	국회의사당	5023	5009	20180116	10032
20180124	7호선	부천종합운동장	5392	4639	20180127	10031
20180124	우이신설선	북한산보국문	5088	4943	20180127	10031
20180127	경원선	덕정	5235	4780	20180130	10015
20180128	3호선	독립문	4948	5065	20180131	10013
20180113	경강선	경기광주	5179	4834	20180116	10013
20180211	중앙선	상봉(시외버스터미널)	5153	4858	20180214	10011
20180208	5호선	올림픽공원(한국체대)	5088	4923	20180211	10011
20180122	경의선	금릉	4984	5026	20180125	10010
20180131	9호선	노들	5319	4689	20180203	10008
20180125	분당선	구성	4970	5037	20180128	10007
20180129	분당선	신갈	5099	4906	20180201	10005
20180122	경부선	두정	4936	5066	20180125	10002
20180208	경의선	풍산	5175	4825	20180211	10000
20180126	7호선	삼산체육관	5300	4700	20180129	10000
20180121	경부선	화서	5016	4982	20180124	9998
20180112	우이신설선	솔샘	5155	4843	20180115	9998
20180115	장항선	온양온천	4950	5047	20180118	9997
20180204	5호선	명일	5009	4983	20180207	9992
20180119	안산선	반월	5253	4739	20180122	9992
20180127	일산선	원흥	5297	4693	20180130	9990
20180115	5호선	올림픽공원(한국체대)	5167	4821	20180118	9988
20180130	경의선	가좌	5109	4877	20180202	9986
20180115	경원선	녹양	5229	4755	20180118	9984
20180112	7호선	부천종합운동장	5317	4665	20180115	9982
20180207	경부선	서정리	4900	5080	20180210	9980
20180125	우이신설선	솔샘	5108	4871	20180128	9979
20180121	7호선	온수(성공회대입구)	4878	5096	20180124	9974
20180123	분당선	신갈	5084	4889	20180126	9973
20180206	7호선	부천종합운동장	5304	4668	20180209	9972
20180131	경원선	월계	5231	4741	20180203	9972
20180117	경원선	월계	5165	4806	20180120	9971
20180208	수인선	연수	4977	4992	20180211	9969
20180114	3호선	금호	5159	4810	20180117	9969
20180212	경의선	가좌	5169	4796	20180215	9965
20180204	경원선	광운대	5016	4949	20180207	9965
20180130	경원선	한남	5109	4856	20180202	9965
20180128	5호선	공덕	5010	4955	20180131	9965
20180126	2호선	신설동	4918	5045	20180129	9963
20180201	경원선	녹천	5375	4586	20180204	9961
20180118	5호선	올림픽공원(한국체대)	5194	4766	20180121	9960
20180205	경원선	녹천	5431	4527	20180208	9958
20180112	6호선	월드컵경기장(성산)	4801	5157	20180115	9958
20180120	수인선	연수	5010	4947	20180123	9957
20180112	5호선	마천	4985	4972	20180115	9957
20180115	경원선	월계	5184	4768	20180118	9952
20180211	9호선	흑석(중앙대입구)	4798	5151	20180214	9949
20180130	수인선	연수	5004	4945	20180202	9949
20180129	장항선	온양온천	4917	5032	20180201	9949
20180129	8호선	모란	5624	4324	20180201	9948
20180125	우이신설선	북한산보국문	5057	4889	20180128	9946
20180121	6호선	광흥창(서강)	5059	4886	20180124	9945
20180205	경원선	월계	5196	4745	20180208	9941
20180211	5호선	공덕	4996	4942	20180214	9938
20180204	8호선	석촌	4843	5095	20180207	9938
20180112	분당선	신갈	5119	4819	20180115	9938
20180207	5호선	올림픽공원(한국체대)	5066	4871	20180210	9937
20180121	경부선	의왕	4977	4959	20180124	9936
20180211	3호선	가락시장	4829	5104	20180214	9933
20180211	6호선	돌곶이	5079	4854	20180214	9933
20180114	중앙선	도농	5096	4837	20180117	9933
20180128	경원선	광운대	4930	5001	20180131	9931
20180206	경원선	월계	5169	4761	20180209	9930
20180208	경의선	금릉	5013	4915	20180211	9928
20180113	5호선	거여	5127	4800	20180116	9927
20180201	경원선	월계	5140	4784	20180204	9924
20180205	분당선	신갈	5057	4866	20180208	9923
20180113	7호선	용마산	5262	4659	20180116	9921
20180118	경원선	녹양	5250	4670	20180121	9920
20180125	경의선	문산	5035	4882	20180128	9917
20180204	6호선	광흥창(서강)	5041	4874	20180207	9915
20180203	5호선	개롱	4898	5015	20180206	9913
20180126	7호선	부천종합운동장	5333	4574	20180129	9907
20180124	분당선	구성	4820	5087	20180127	9907
20180130	9호선	노들	5105	4798	20180202	9903
20180211	5호선	명일	4943	4959	20180214	9902
20180203	6호선	효창공원앞	5217	4682	20180206	9899
20180114	경부선	화서	4949	4948	20180117	9897
20180124	분당선	상갈	5045	4851	20180127	9896
20180204	3호선	종로3가	3896	5999	20180207	9895
20180126	우이신설선	북한산보국문	5125	4768	20180129	9893
20180114	분당선	이매	4879	5012	20180117	9891
20180204	2호선	충정로(경기대입구)	4898	4990	20180207	9888
20180121	6호선	봉화산(서울의료원)	4970	4916	20180124	9886
20180212	수인선	연수	4964	4919	20180215	9883
20180117	경의선	가좌	5129	4753	20180120	9882
20180207	경원선	녹천	5404	4473	20180210	9877
20180131	경의선	풍산	5127	4748	20180203	9875
20180119	경원선	한남	5034	4840	20180122	9874
20180131	경원선	녹양	5190	4683	20180203	9873
20180128	8호선	석촌	4781	5090	20180131	9871
20180117	경의선	풍산	5080	4791	20180120	9871
20180211	3호선	금호	5034	4832	20180214	9866
20180130	경원선	녹천	5244	4620	20180202	9864
20180205	수인선	인하대	5175	4686	20180208	9861
20180118	수인선	원인재	4886	4974	20180121	9860
20180123	7호선	부천종합운동장	5266	4593	20180126	9859
20180119	분당선	매탄권선	5238	4621	20180122	9859
20180114	6호선	광흥창(서강)	5046	4811	20180117	9857
20180130	2호선	신설동	5130	4721	20180202	9851
20180212	5호선	올림픽공원(한국체대)	5011	4837	20180215	9848
20180206	분당선	신갈	4973	4875	20180209	9848
20180117	안산선	반월	4975	4868	20180120	9843
20180114	7호선	보라매	4925	4918	20180117	9843
20180113	3호선	경찰병원	5029	4813	20180116	9842
20180118	경의선	금릉	5022	4815	20180121	9837
20180204	5호선	공덕	4863	4973	20180207	9836
20180112	경의선	운정	5149	4687	20180115	9836
20180127	장항선	온양온천	4900	4934	20180130	9834
20180122	경원선	월계	5139	4693	20180125	9832
20180112	7호선	삼산체육관	5221	4610	20180115	9831
20180124	경원선	도봉산	6363	3467	20180127	9830
20180129	7호선	부천종합운동장	5264	4565	20180201	9829
20180204	7호선	태릉입구	5155	4672	20180207	9827
20180113	3호선	오금	5177	4649	20180116	9826
20180112	2호선	신설동	4820	5003	20180115	9823
20180127	7호선	반포	5104	4715	20180130	9819
20180126	경의선	운정	5146	4669	20180129	9815
20180114	7호선	온수(성공회대입구)	4807	4999	20180117	9806
20180208	경원선	한남	5017	4785	20180211	9802
20180124	경의선	문산	4985	4813	20180127	9798
20180212	경원선	월계	5095	4695	20180215	9790
20180208	9호선	노들	5200	4588	20180211	9788
20180123	수인선	인하대	5112	4675	20180126	9787
20180128	6호선	광흥창(서강)	4985	4801	20180131	9786
20180114	경의선	일산	5059	4726	20180117	9785
20180129	6호선	월드컵경기장(성산)	4774	5008	20180201	9782
20180126	경원선	도봉산	6383	3398	20180129	9781
20180121	6호선	돌곶이	5033	4748	20180124	9781
20180207	경의선	가좌	5037	4742	20180210	9779
20180121	경의선	문산	4497	5280	20180124	9777
20180203	5호선	여의나루	4792	4983	20180206	9775
20180125	5호선	마천	4858	4911	20180128	9769
20180125	7호선	부천종합운동장	5222	4538	20180128	9760
20180126	5호선	마천	4940	4818	20180129	9758
20180117	경의선	금릉	4885	4871	20180120	9756
20180120	경부선	서정리	5278	4477	20180123	9755
20180114	5호선	공덕	4921	4832	20180117	9753
20180125	8호선	신흥	4639	5112	20180128	9751
20180114	6호선	고려대(종암)	5069	4680	20180117	9749
20180204	안산선	고잔	4889	4856	20180207	9745
20180122	수인선	원인재	4787	4956	20180125	9743
20180113	경부선	서정리	5289	4454	20180116	9743
20180128	장항선	온양온천	4838	4904	20180131	9742
20180117	9호선	노들	5227	4515	20180120	9742
20180211	7호선	온수(성공회대입구)	4734	5007	20180214	9741
20180120	9호선	마곡나루	5011	4726	20180123	9737
20180114	5호선	행당	5053	4684	20180117	9737
20180203	3호선	경찰병원	4976	4756	20180206	9732
20180120	경의선	백마	5096	4633	20180123	9729
20180120	분당선	이매	4776	4953	20180123	9729
20180211	7호선	태릉입구	5195	4533	20180214	9728
20180118	경원선	월계	5084	4641	20180121	9725
20180118	9호선	노들	5264	4458	20180121	9722
20180123	7호선	삼산체육관	5175	4543	20180126	9718
20180115	경원선	한남	4907	4811	20180118	9718
20180201	경원선	녹양	5078	4639	20180204	9717
20180131	수인선	원인재	4798	4914	20180203	9712
20180207	경원선	녹양	5080	4630	20180210	9710
20180115	수인선	원인재	4824	4886	20180118	9710
20180122	경의선	풍산	4991	4715	20180125	9706
20180128	7호선	뚝섬유원지	4891	4814	20180131	9705
20180124	8호선	신흥	4688	5017	20180127	9705
20180120	6호선	태릉입구	4557	5148	20180123	9705
20180204	분당선	이매	4802	4902	20180207	9704
20180114	6호선	신당	4565	5139	20180117	9704
20180123	5호선	올림픽공원(한국체대)	5023	4680	20180126	9703
20180120	5호선	신금호	4825	4878	20180123	9703
20180127	중앙선	덕소	4884	4818	20180130	9702
20180203	분당선	이매	4721	4973	20180206	9694
20180115	경의선	풍산	5091	4600	20180118	9691
20180128	6호선	돌곶이	4966	4720	20180131	9686
20180125	경원선	도봉산	6295	3389	20180128	9684
20180120	수인선	소래포구	4796	4884	20180123	9680
20180118	안산선	반월	5006	4669	20180121	9675
20180211	경원선	지행	4911	4763	20180214	9674
20180120	7호선	용마산	4979	4695	20180123	9674
20180130	경의선	풍산	4828	4844	20180202	9672
20180206	6호선	월드컵경기장(성산)	4672	4999	20180209	9671
20180128	7호선	온수(성공회대입구)	4736	4935	20180131	9671
20180112	경부선	송탄	5123	4548	20180115	9671
20180131	경의선	금릉	4876	4794	20180203	9670
20180115	경부선	송탄	4841	4829	20180118	9670
20180114	경부선	의왕	4788	4882	20180117	9670
20180124	5호선	마천	4783	4885	20180127	9668
20180113	6호선	효창공원앞	5135	4532	20180116	9667
20180201	경의선	풍산	4957	4708	20180204	9665
20180203	8호선	수진	5093	4570	20180206	9663
20180212	경원선	녹천	5248	4414	20180215	9662
20180203	중앙선	중랑	4824	4837	20180206	9661
20180115	안산선	반월	4903	4757	20180118	9660
20180129	5호선	올림픽공원(한국체대)	4982	4676	20180201	9658
20180204	3호선	금호	4960	4695	20180207	9655
20180203	5호선	애오개	4843	4811	20180206	9654
20180206	5호선	올림픽공원(한국체대)	4958	4694	20180209	9652
20180207	9호선	노들	5104	4547	20180210	9651
20180206	수인선	인하대	5054	4592	20180209	9646
20180131	안산선	반월	4942	4704	20180203	9646
20180131	경부선	두정	4665	4979	20180203	9644
20180203	9호선	증미	4767	4873	20180206	9640
20180128	7호선	태릉입구	5069	4571	20180131	9640
20180118	경원선	한남	4869	4771	20180121	9640
20180205	6호선	월드컵경기장(성산)	4642	4996	20180208	9638
20180117	3호선	무악재	4830	4808	20180120	9638
20180129	7호선	삼산체육관	5122	4511	20180201	9633
20180206	경원선	녹천	5270	4361	20180209	9631
20180208	수인선	원인재	4806	4824	20180211	9630
20180211	8호선	석촌	4712	4917	20180214	9629
20180211	6호선	신당	4661	4967	20180214	9628
20180113	경의선	백마	5072	4554	20180116	9626
20180212	수인선	원인재	4825	4798	20180215	9623
20180203	9호선2단계	종합운동장	5587	4035	20180206	9622
20180112	수인선	인하대	4999	4622	20180115	9621
20180127	7호선	까치울	4944	4675	20180130	9619
20180122	경부선	서정리	4674	4945	20180125	9619
20180130	6호선	역촌	4403	5214	20180202	9617
20180204	7호선	온수(성공회대입구)	4756	4857	20180207	9613
20180115	경의선	금릉	4866	4747	20180118	9613
20180204	경원선	지행	4819	4791	20180207	9610
20180126	수인선	연수	4715	4894	20180129	9609
20180119	9호선	노들	5168	4437	20180122	9605
20180204	6호선	봉화산(서울의료원)	4830	4774	20180207	9604
20180121	5호선	고덕	4815	4786	20180124	9601
20180125	경부선	천안	4826	4773	20180128	9599
20180121	분당선	기흥	4783	4812	20180124	9595
20180204	5호선	고덕	4759	4831	20180207	9590
20180201	경의선	금릉	4850	4740	20180204	9590
20180121	분당선	이매	4667	4922	20180124	9589
20180201	9호선	노들	5083	4505	20180204	9588
20180119	과천선	과천	5319	4267	20180122	9586
20180120	8호선	수진	4958	4626	20180123	9584
20180117	경원선	한남	4855	4728	20180120	9583
20180207	경부선	두정	4791	4784	20180210	9575
20180113	중앙선	중랑	4873	4702	20180116	9575
20180127	분당선	도곡	4945	4628	20180130	9573
20180122	경원선	한남	4856	4715	20180125	9571
20180113	분당선	이매	4722	4849	20180116	9571
20180201	수인선	원인재	4753	4814	20180204	9567
20180122	안산선	반월	4895	4672	20180125	9567
20180129	수인선	연수	4807	4757	20180201	9564
20180124	경부선	천안	4849	4715	20180127	9564
20180128	9호선	흑석(중앙대입구)	4680	4879	20180131	9559
20180212	경의선	풍산	5031	4527	20180215	9558
20180208	안산선	반월	4902	4656	20180211	9558
20180212	경의선	금릉	4855	4702	20180215	9557
20180131	경원선	한남	4814	4741	20180203	9555
20180117	경부선	서정리	4777	4775	20180120	9552
20180205	경의선	가좌	5070	4480	20180208	9550
20180128	3호선	금호	4832	4716	20180131	9548
20180113	3호선	도곡	4825	4723	20180116	9548
20180121	7호선	천왕	4860	4673	20180124	9533
20180127	경부선	당정	4901	4625	20180130	9526
20180121	9호선	신방화	4772	4752	20180124	9524
20180201	안산선	반월	4901	4621	20180204	9522
20180128	경원선	지행	4776	4743	20180131	9519
20180127	경부선	군포	5059	4456	20180130	9515
20180121	일산선	마두	4745	4767	20180124	9512
20180125	경의선	운정	4950	4561	20180128	9511
20180204	6호선	돌곶이	4854	4656	20180207	9510
20180119	6호선	역촌	4370	5139	20180122	9509
20180113	8호선	신흥	4561	4948	20180116	9509
20180207	경의선	풍산	4838	4669	20180210	9507
20180129	경원선	녹천	5228	4279	20180201	9507
20180126	분당선	신갈	4830	4677	20180129	9507
20180207	수인선	원인재	4711	4795	20180210	9506
20180130	경원선	녹양	4940	4564	20180202	9504
20180126	5호선	올림픽공원(한국체대)	4982	4522	20180129	9504
20180203	8호선	신흥	4530	4971	20180206	9501
20180201	경원선	한남	4880	4619	20180204	9499
20180203	5호선	신금호	4733	4764	20180206	9497
20180211	분당선	이매	4672	4824	20180214	9496
20180122	6호선	역촌	4352	5144	20180125	9496
20180211	경의선	일산	4840	4655	20180214	9495
20180130	5호선	청구	4972	4518	20180202	9490
20180124	7호선	삼산체육관	5038	4451	20180127	9489
20180114	9호선	신방화	4740	4747	20180117	9487
20180113	5호선	신금호	4715	4772	20180116	9487
20180212	안산선	반월	4843	4635	20180215	9478
20180130	수인선	원인재	4664	4814	20180202	9478
20180212	경원선	녹양	4979	4498	20180215	9477
20180129	수인선	인하대	4983	4493	20180201	9476
20180114	분당선	기흥	4694	4780	20180117	9474
20180117	6호선	역촌	4361	5110	20180120	9471
20180127	6호선	불광	5132	4338	20180130	9470
20180130	경의선	금릉	4750	4719	20180202	9469
20180121	6호선	월드컵경기장(성산)	4624	4844	20180124	9468
20180128	경부선	두정	4436	5029	20180131	9465
20180115	경부선	서정리	4621	4844	20180118	9465
20180127	2호선	양천구청	4665	4799	20180130	9464
20180128	3호선	가락시장	4680	4783	20180131	9463
20180112	경의선	가좌	4997	4463	20180115	9460
20180128	3호선	종로3가	3612	5844	20180131	9456
20180114	3호선	가락시장	4594	4862	20180117	9456
20180206	9호선	노들	4996	4458	20180209	9454
20180130	3호선	무악재	4576	4876	20180202	9452
20180212	9호선	노들	5068	4379	20180215	9447
20180127	경인선	간석	4823	4624	20180130	9447
20180122	9호선	노들	4950	4493	20180125	9443
20180119	3호선	무악재	4761	4679	20180122	9440
20180120	경춘선	평내호평	4862	4577	20180123	9439
20180127	5호선	개롱	4613	4824	20180130	9437
20180123	경의선	금릉	4750	4686	20180126	9436
20180206	경의선	가좌	4917	4518	20180209	9435
20180123	경부선	두정	4724	4710	20180126	9434
20180129	경부선	두정	4618	4814	20180201	9432
20180201	분당선	매탄권선	4828	4602	20180204	9430
20180205	수인선	연수	4727	4702	20180208	9429
20180203	경의선	백마	4893	4536	20180206	9429
20180122	경부선	송탄	4762	4665	20180125	9427
20180123	6호선	월드컵경기장(성산)	4599	4819	20180126	9418
20180203	경강선	경기광주	4812	4601	20180206	9413
20180211	분당선	기흥	4700	4710	20180214	9410
20180211	5호선	행당	4810	4600	20180214	9410
20180127	5호선	거여	4808	4602	20180130	9410
20180114	6호선	봉화산(서울의료원)	4794	4605	20180117	9399
20180206	수인선	연수	4733	4665	20180209	9398
20180203	6호선	태릉입구	4393	5005	20180206	9398
20180113	8호선	산성	4791	4607	20180116	9398
20180120	9호선	증미	4702	4695	20180123	9397
20180211	2호선	충정로(경기대입구)	4650	4746	20180214	9396
20180128	분당선	이매	4503	4893	20180131	9396
20180120	8호선	신흥	4513	4883	20180123	9396
20180114	5호선	고덕	4746	4650	20180117	9396
20180128	5호선	행당	4891	4499	20180131	9390
20180124	5호선	올림픽공원(한국체대)	4869	4520	20180127	9389
20180120	8호선	산성	4763	4626	20180123	9389
20180207	안산선	반월	4838	4547	20180210	9385
20180120	5호선	마장	4769	4613	20180123	9382
20180118	3호선	무악재	4674	4707	20180121	9381
20180208	6호선	역촌	4368	5010	20180211	9378
20180125	7호선	삼산체육관	4966	4412	20180128	9378
20180124	분당선	신갈	4794	4579	20180127	9373
20180121	6호선	고려대(종암)	4812	4561	20180124	9373
20180122	장항선	온양온천	4708	4660	20180125	9368
20180118	장항선	온양온천	4729	4635	20180121	9364
20180121	경원선	가능	4916	4445	20180124	9361
20180117	5호선	청구	4919	4439	20180120	9358
20180204	경의선	문산	4362	4995	20180207	9357
20180205	6호선	역촌	4357	4998	20180208	9355
20180207	경의선	금릉	4711	4643	20180210	9354
20180208	3호선	무악재	4631	4722	20180211	9353
20180121	5호선	길동	4660	4693	20180124	9353
20180115	9호선	노들	5035	4318	20180118	9353
20180117	경부선	송탄	4744	4606	20180120	9350
20180120	5호선	애오개	4704	4645	20180123	9349
20180206	경원선	녹양	4828	4518	20180209	9346
20180113	8호선	수진	4859	4486	20180116	9345
20180131	3호선	무악재	4681	4663	20180203	9344
20180201	경부선	두정	4683	4660	20180204	9343
20180204	중앙선	도농	4810	4532	20180207	9342
20180126	수인선	인하대	4929	4411	20180129	9340
20180205	경원선	녹양	4883	4455	20180208	9338
20180124	경의선	운정	4794	4544	20180127	9338
20180128	중앙선	도농	4823	4513	20180131	9336
20180112	경부선	서정리	4828	4506	20180115	9334
20180113	9호선	증미	4683	4649	20180116	9332
20180127	5호선	신금호	4652	4679	20180130	9331
20180128	9호선	신방화	4635	4691	20180131	9326
20180123	경원선	녹양	4891	4434	20180126	9325
20180211	6호선	봉화산(서울의료원)	4670	4652	20180214	9322
20180208	5호선	청구	4919	4402	20180211	9321
20180121	6호선	삼각지	5268	4053	20180124	9321
20180208	6호선	청구	4414	4906	20180211	9320
20180117	6호선	청구	4410	4907	20180120	9317
20180114	경원선	가능	4931	4384	20180117	9315
20180127	5호선	왕십리(성동구청)	4161	5150	20180130	9311
20180124	수인선	인하대	4851	4455	20180127	9306
20180128	2호선	충정로(경기대입구)	4612	4692	20180131	9304
20180123	수인선	연수	4675	4628	20180126	9303
20180115	6호선	역촌	4335	4965	20180118	9300
20180204	7호선	보라매	4712	4583	20180207	9295
20180112	분당선	매탄권선	4840	4455	20180115	9295
20180122	3호선	무악재	4549	4745	20180125	9294
20180114	6호선	삼각지	5263	4028	20180117	9291
20180119	경부선	서울역	7984	1301	20180122	9285
20180123	9호선	노들	4911	4373	20180126	9284
20180114	5호선	길동	4535	4749	20180117	9284
20180128	6호선	봉화산(서울의료원)	4692	4591	20180131	9283
20180118	6호선	역촌	4280	4999	20180121	9279
20180129	2호선	신설동	4634	4643	20180201	9277
20180114	7호선	천왕	4709	4568	20180117	9277
20180212	경원선	한남	4666	4610	20180215	9276
20180203	8호선	산성	4727	4548	20180206	9275
20180128	경부선	의왕	4553	4717	20180131	9270
20180203	경인선	구일	4796	4471	20180206	9267
20180114	분당선	가천대	4188	5076	20180117	9264
20180113	5호선	마장	4832	4432	20180116	9264
20180203	2호선	신설동	4872	4388	20180206	9260
20180130	6호선	청구	4374	4884	20180202	9258
20180121	경부선	송탄	4366	4892	20180124	9258
20180211	경부선	두정	4498	4759	20180214	9257
20180211	중앙선	도농	4763	4494	20180214	9257
20180212	6호선	역촌	4283	4972	20180215	9255
20180127	경원선	도봉	4830	4421	20180130	9251
20180203	수인선	연수	4605	4644	20180206	9249
20180123	경의선	가좌	4779	4469	20180126	9248
20180207	경원선	한남	4693	4552	20180210	9245
20180121	3호선	대청	4734	4508	20180124	9242
20180212	3호선	무악재	4538	4703	20180215	9241
20180206	경부선	두정	4623	4617	20180209	9240
20180113	4호선	삼각지	3726	5514	20180116	9240
20180125	경부선	두정	4651	4584	20180128	9235
20180113	5호선	애오개	4709	4525	20180116	9234
20180112	장항선	온양온천	4640	4593	20180115	9233
20180129	경의선	가좌	4821	4411	20180201	9232
20180205	경부선	두정	4500	4731	20180208	9231
20180117	분당선	매탄권선	4702	4529	20180120	9231
20180204	3호선	대청	4724	4505	20180207	9229
20180123	경원선	녹천	5025	4204	20180126	9229
20180204	분당선	기흥	4546	4682	20180207	9228
20180211	6호선	고려대(종암)	4774	4451	20180214	9225
20180208	과천선	과천	4965	4255	20180211	9220
20180112	경원선	녹천	5112	4106	20180115	9218
20180207	6호선	청구	4353	4864	20180210	9217
20180207	6호선	역촌	4217	5000	20180210	9217
20180128	경부선	화서	4644	4572	20180131	9216
20180211	경부선	의왕	4611	4603	20180214	9214
20180131	분당선	매탄권선	4702	4512	20180203	9214
20180113	9호선	마곡나루	4720	4492	20180116	9212
20180130	안산선	반월	4728	4482	20180202	9210
20180203	9호선	마곡나루	4686	4519	20180206	9205
20180203	분당선	선정릉	4411	4793	20180206	9204
20180207	3호선	무악재	4567	4636	20180210	9203
20180127	3호선	도곡	4644	4557	20180130	9201
20180128	분당선	기흥	4510	4690	20180131	9200
20180114	경부선	송탄	4359	4840	20180117	9199
20180119	경의선	야당	4777	4419	20180122	9196
20180211	7호선	천왕	4706	4488	20180214	9194
20180131	6호선	역촌	4316	4875	20180203	9191
20180211	5호선	길동	4527	4663	20180214	9190
20180205	9호선	노들	4857	4332	20180208	9189
20180112	수인선	원인재	4549	4638	20180115	9187
20180201	6호선	역촌	4207	4979	20180204	9186
20180127	경부선	송탄	4764	4422	20180130	9186
20180115	3호선	무악재	4549	4635	20180118	9184
20180204	경부선	두정	4342	4841	20180207	9183
20180203	3호선	잠원	4650	4531	20180206	9181
20180120	4호선	삼각지	3760	5419	20180123	9179
20180211	7호선	뚝섬유원지	4677	4500	20180214	9177
20180203	9호선2단계	선정릉	4527	4650	20180206	9177
20180113	수인선	인하대	4829	4343	20180116	9172
20180118	경부선	송탄	4623	4547	20180121	9170
20180121	5호선	올림픽공원(한국체대)	4724	4444	20180124	9168
20180121	경의선	행신	4719	4446	20180124	9165
20180128	5호선	길동	4548	4616	20180131	9164
20180201	3호선	무악재	4552	4607	20180204	9159
20180125	5호선	올림픽공원(한국체대)	4712	4447	20180128	9159
20180117	과천선	과천	5049	4110	20180120	9159
20180208	5호선	영등포구청	4553	4605	20180211	9158
20180112	경원선	녹양	4742	4415	20180115	9157
20180118	분당선	매탄권선	4665	4489	20180121	9154
20180205	안산선	반월	4685	4467	20180208	9152
20180119	분당선	청명	4831	4318	20180122	9149
20180112	경의선	금릉	4525	4624	20180115	9149
20180125	수인선	인하대	4740	4407	20180128	9147
20180123	경원선	월계	4789	4357	20180126	9146
20180212	분당선	매탄권선	4657	4487	20180215	9144
20180121	경원선	덕정	4381	4763	20180124	9144
20180131	5호선	청구	4767	4375	20180203	9142
20180126	6호선	월드컵경기장(성산)	4427	4709	20180129	9136
20180125	6호선	월드컵경기장(성산)	4379	4756	20180128	9135
20180114	8호선	몽촌토성(평화의문)	4646	4489	20180117	9135
20180112	9호선	노들	4964	4170	20180115	9134
20180125	분당선	신갈	4715	4418	20180128	9133
20180119	6호선	청구	4333	4799	20180122	9132
20180208	장항선	온양온천	4545	4585	20180211	9130
20180131	장항선	온양온천	4594	4534	20180203	9128
20180129	경원선	녹양	4794	4333	20180201	9127
20180120	2호선	신설동	4725	4401	20180123	9126
20180119	수인선	소래포구	4710	4412	20180122	9122
20180129	9호선	노들	4784	4337	20180201	9121
20180205	경의선	금릉	4610	4509	20180208	9119
20180201	2호선	신설동	4541	4578	20180204	9119
20180118	경부선	서정리	4586	4523	20180121	9109
20180212	2호선	신설동	4664	4440	20180215	9104
20180205	경의선	풍산	4696	4408	20180208	9104
20180126	경원선	월계	4835	4263	20180129	9098
20180211	경부선	화서	4579	4512	20180214	9091
20180129	수인선	원인재	4540	4549	20180201	9089
20180206	경의선	금릉	4557	4530	20180209	9087
20180201	6호선	청구	4304	4783	20180204	9087
20180128	경의선	문산	4128	4958	20180131	9086
20180212	6호선	청구	4258	4824	20180215	9082
20180208	2호선	신설동	4402	4677	20180211	9079
20180125	수인선	연수	4534	4542	20180128	9076
20180114	경의선	행신	4769	4307	20180117	9076
20180123	경의선	풍산	4740	4335	20180126	9075
20180206	2호선	신설동	4541	4531	20180209	9072
20180127	9호선	증미	4491	4581	20180130	9072
20180206	수인선	원인재	4482	4589	20180209	9071
20180129	경원선	월계	4753	4318	20180201	9071
20180204	중앙선	상봉(시외버스터미널)	4553	4515	20180207	9068
20180120	5호선	개화산	4681	4387	20180123	9068
20180121	6호선	보문	4750	4317	20180124	9067
20180211	5호선	고덕	4594	4472	20180214	9066
20180119	5호선	청구	4776	4290	20180122	9066
20180206	분당선	매탄권선	4631	4433	20180209	9064
20180112	경원선	월계	4816	4246	20180115	9062
20180114	경부선	명학	4549	4512	20180117	9061
20180204	일산선	마두	4463	4597	20180207	9060
20180212	경부선	송탄	4548	4510	20180215	9058
20180201	5호선	청구	4699	4359	20180204	9058
20180212	경부선	서정리	4502	4551	20180215	9053
20180212	분당선	청명	4743	4308	20180215	9051
20180204	경의선	일산	4584	4466	20180207	9050
20180131	6호선	청구	4310	4740	20180203	9050
20180208	분당선	매탄권선	4630	4418	20180211	9048
20180211	장항선	온양온천	4513	4534	20180214	9047
20180123	경원선	한남	4579	4464	20180126	9043
20180114	일산선	마두	4516	4527	20180117	9043
20180204	경부선	화서	4526	4514	20180207	9040
20180129	경의선	금릉	4594	4443	20180201	9037
20180206	경원선	한남	4594	4441	20180209	9035
20180205	3호선	무악재	4499	4532	20180208	9031
20180208	경부선	송탄	4611	4419	20180211	9030
20180113	6호선	태릉입구	4298	4731	20180116	9029
20180201	장항선	온양온천	4521	4507	20180204	9028
20180208	분당선	청명	4709	4315	20180211	9024
20180120	분당선	상갈	4696	4327	20180123	9023
20180206	6호선	역촌	4164	4858	20180209	9022
20180205	수인선	원인재	4464	4557	20180208	9021
20180127	수인선	연수	4468	4553	20180130	9021
20180205	2호선	신설동	4495	4514	20180208	9009
20180127	6호선	효창공원앞	4721	4284	20180130	9005
20180121	7호선	보라매	4518	4481	20180124	8999
20180204	5호선	길동	4389	4608	20180207	8997
20180206	6호선	청구	4232	4764	20180209	8996
20180207	5호선	청구	4695	4300	20180210	8995
20180125	9호선	노들	4840	4155	20180128	8995
20180128	일산선	마두	4488	4506	20180131	8994
20180206	경의선	풍산	4603	4385	20180209	8988
20180130	분당선	매탄권선	4556	4431	20180202	8987
20180126	9호선	노들	4862	4125	20180129	8987
20180113	9호선2단계	종합운동장	5080	3907	20180116	8987
20180127	8호선	수진	4628	4358	20180130	8986
20180204	9호선	신방화	4448	4536	20180207	8984
20180113	경춘선	평내호평	4613	4371	20180116	8984
20180118	6호선	청구	4298	4684	20180121	8982
20180130	과천선	과천	4858	4123	20180202	8981
20180206	3호선	무악재	4455	4520	20180209	8975
20180122	5호선	영등포구청	4331	4644	20180125	8975
20180120	9호선2단계	종합운동장	4964	4011	20180123	8975
20180127	경강선	경기광주	4623	4350	20180130	8973
20180118	경의선	야당	4604	4365	20180121	8969
20180211	일산선	마두	4438	4530	20180214	8968
20180122	5호선	청구	4684	4280	20180125	8964
20180211	6호선	보문	4636	4325	20180214	8961
20180204	6호선	고려대(종암)	4502	4458	20180207	8960
20180123	수인선	원인재	4409	4547	20180126	8956
20180126	경부선	서울역	7702	1253	20180129	8955
20180201	경부선	서정리	4450	4504	20180204	8954
20180130	경부선	두정	4419	4535	20180202	8954
20180114	3호선	대청	4556	4398	20180117	8954
20180207	2호선	신설동	4412	4540	20180210	8952
20180124	수인선	연수	4434	4518	20180127	8952
20180118	과천선	과천	4890	4061	20180121	8951
20180121	경부선	명학	4509	4439	20180124	8948
20180127	7호선	용마산	4656	4291	20180130	8947
20180120	5호선	마천	4367	4579	20180123	8946
20180124	9호선	노들	4703	4242	20180127	8945
20180121	경인선	온수(성공회대입구)	4506	4439	20180124	8945
20180211	경의선	문산	4140	4804	20180214	8944
20180211	9호선	신방화	4442	4502	20180214	8944
20180131	과천선	과천	4930	4013	20180203	8943
20180122	분당선	매탄권선	4529	4412	20180125	8941
20180118	분당선	청명	4604	4337	20180121	8941
20180119	6호선	약수	4464	4476	20180122	8940
20180120	3호선	잠원	4586	4352	20180123	8938
20180114	경인선	온수(성공회대입구)	4564	4374	20180117	8938
20180124	경부선	두정	4419	4516	20180127	8935
20180114	경원선	덕정	4186	4748	20180117	8934
20180131	경부선	서정리	4450	4481	20180203	8931
20180127	5호선	마장	4562	4367	20180130	8929
20180115	5호선	청구	4743	4184	20180118	8927
20180121	중앙선	상봉(시외버스터미널)	4553	4371	20180124	8924
20180126	분당선	매탄권선	4727	4196	20180129	8923
20180129	6호선	역촌	4108	4813	20180201	8921
20180118	5호선	청구	4684	4237	20180121	8921
20180126	경원선	녹천	4909	4010	20180129	8919
20180129	안산선	반월	4547	4371	20180201	8918
20180125	경원선	녹천	4871	4046	20180128	8917
20180123	3호선	무악재	4433	4483	20180126	8916
20180206	5호선	청구	4610	4305	20180209	8915
20180211	6호선	삼각지	4942	3969	20180214	8911
20180203	경부선	서정리	4859	4051	20180206	8910
20180127	분당선	이매	4391	4519	20180130	8910
20180115	5호선	영등포구청	4418	4490	20180118	8908
20180118	5호선	영등포구청	4350	4554	20180121	8904
20180204	6호선	보문	4630	4273	20180207	8903
20180123	6호선	역촌	4055	4845	20180126	8900
20180212	5호선	청구	4697	4195	20180215	8892
20180212	장항선	온양온천	4478	4411	20180215	8889
20180117	5호선	영등포구청	4338	4548	20180120	8886
20180204	7호선	뚝섬유원지	4549	4336	20180207	8885
20180130	9호선	신목동	4605	4280	20180202	8885
20180131	경부선	송탄	4490	4393	20180203	8883
20180122	경의선	야당	4516	4364	20180125	8880
20180124	6호선	월드컵경기장(성산)	4360	4519	20180127	8879
20180128	6호선	고려대(종암)	4485	4391	20180131	8876
20180113	5호선	마곡	4662	4213	20180116	8875
20180131	2호선	신설동	4312	4561	20180203	8873
20180121	5호선	방화	4427	4446	20180124	8873
20180130	5호선	영등포구청	4414	4457	20180202	8871
20180122	2호선	신설동	4522	4346	20180125	8868
20180205	6호선	청구	4170	4694	20180208	8864
20180117	분당선	청명	4625	4238	20180120	8863
20180212	5호선	영등포구청	4382	4480	20180215	8862
20180112	경의선	풍산	4600	4262	20180115	8862
20180208	경의선	야당	4603	4258	20180211	8861
20180205	분당선	매탄권선	4517	4340	20180208	8857
20180207	분당선	매탄권선	4508	4345	20180210	8853
20180120	경의선	운정	4625	4227	20180123	8852
20180211	3호선	대청	4570	4281	20180214	8851
20180203	경춘선	평내호평	4585	4265	20180206	8850
20180112	경부선	서울역	7674	1176	20180115	8850
20180126	경부선	송탄	4657	4186	20180129	8843
20180208	중앙선	양평	4411	4429	20180211	8840
20180113	3호선	잠원	4598	4242	20180116	8840
20180206	안산선	반월	4507	4332	20180209	8839
20180203	6호선	상월곡(한국과학기술연구원)	4716	4123	20180206	8839
20180119	5호선	영등포구청	4370	4469	20180122	8839
20180128	5호선	고덕	4444	4393	20180131	8837
20180211	7호선	보라매	4453	4383	20180214	8836
20180129	3호선	무악재	4346	4488	20180201	8834
20180128	경인선	온수(성공회대입구)	4469	4364	20180131	8833
20180127	3호선	경찰병원	4509	4324	20180130	8833
20180117	수인선	소래포구	4613	4220	20180120	8833
20180207	경부선	송탄	4463	4369	20180210	8832
20180118	2호선	신설동	4416	4411	20180121	8827
20180211	경원선	가능	4578	4248	20180214	8826
20180129	경의선	풍산	4624	4201	20180201	8825
20180115	분당선	매탄권선	4533	4291	20180118	8824
20180114	8호선	모란	4955	3869	20180117	8824
20180117	장항선	온양온천	4435	4388	20180120	8823
20180119	안산선	수리산	5144	3677	20180122	8821
20180128	9호선	양천향교	4284	4532	20180131	8816
20180127	중앙선	중랑	4477	4339	20180130	8816
20180115	안산선	초지	4429	4387	20180118	8816
20180204	6호선	대흥(서강대앞)	4269	4546	20180207	8815
20180208	경부선	서정리	4442	4372	20180211	8814
20180121	5호선	행당	4606	4208	20180124	8814
20180124	경원선	녹천	4738	4075	20180127	8813
20180205	5호선	청구	4582	4229	20180208	8811
20180130	우이신설선	정릉	4352	4459	20180202	8811
20180128	3호선	대청	4525	4286	20180131	8811
20180207	과천선	과천	4796	4014	20180210	8810
20180124	경원선	월계	4584	4226	20180127	8810
20180127	9호선2단계	종합운동장	5054	3752	20180130	8806
20180120	9호선2단계	선정릉	4387	4418	20180123	8805
20180117	9호선	신목동	4682	4120	20180120	8802
20180112	안산선	반월	4642	4157	20180115	8799
20180131	9호선	신목동	4745	4050	20180203	8795
20180129	경원선	한남	4400	4395	20180201	8795
20180204	7호선	천왕	4569	4221	20180207	8790
20180123	2호선	신설동	4405	4384	20180126	8789
20180122	6호선	청구	4105	4684	20180125	8789
20180131	5호선	영등포구청	4331	4457	20180203	8788
20180124	경원선	녹양	4580	4208	20180127	8788
20180118	중앙선	양평	4419	4367	20180121	8786
20180205	경원선	한남	4455	4328	20180208	8783
20180130	6호선	약수	4515	4268	20180202	8783
20180125	수인선	원인재	4369	4407	20180128	8776
20180113	우이신설선	북한산보국문	4644	4128	20180116	8772
20180115	6호선	청구	4079	4687	20180118	8766
20180207	분당선	청명	4604	4160	20180210	8764
20180117	경의선	야당	4507	4257	20180120	8764
20180126	경의선	금릉	4369	4394	20180129	8763
20180125	3호선	무악재	4398	4365	20180128	8763
20180120	6호선	상월곡(한국과학기술연구원)	4662	4099	20180123	8761
20180122	분당선	청명	4537	4223	20180125	8760
20180123	분당선	매탄권선	4448	4311	20180126	8759
20180125	경원선	녹양	4546	4210	20180128	8756
20180122	안산선	수리산	4936	3819	20180125	8755
20180113	2호선	신설동	4454	4298	20180116	8752
20180118	안산선	수리산	4965	3785	20180121	8750
20180128	경원선	가능	4549	4199	20180131	8748
20180201	과천선	과천	4743	4004	20180204	8747
20180113	수인선	소래포구	4345	4402	20180116	8747
20180204	경부선	명학	4421	4324	20180207	8745
20180126	경의선	가좌	4611	4132	20180129	8743
20180201	안산선	수리산	4965	3776	20180204	8741
20180128	7호선	천왕	4442	4299	20180131	8741
20180131	분당선	청명	4595	4145	20180203	8740
20180201	5호선	영등포구청	4327	4412	20180204	8739
20180129	6호선	청구	4162	4576	20180201	8738
20180121	경의선	탄현	4492	4246	20180124	8738
20180127	8호선	신흥	4248	4487	20180130	8735
20180120	5호선	마곡	4581	4153	20180123	8734
20180118	9호선	신목동	4629	4103	20180121	8732
20180212	경의선	야당	4556	4173	20180215	8729
20180113	수인선	원인재	4408	4321	20180116	8729
20180115	분당선	청명	4517	4208	20180118	8725
20180204	3호선	일원	4125	4599	20180207	8724
20180127	9호선	마곡나루	4413	4308	20180130	8721
20180130	장항선	온양온천	4326	4393	20180202	8719
20180205	경부선	서정리	4288	4429	20180208	8717
20180206	9호선	신목동	4716	3999	20180209	8715
20180201	경의선	야당	4518	4197	20180204	8715
20180207	5호선	영등포구청	4320	4391	20180210	8711
20180125	경원선	월계	4598	4109	20180128	8707
20180201	분당선	청명	4520	4186	20180204	8706
20180117	안산선	수리산	4956	3750	20180120	8706
20180119	경원선	이촌(국립중앙박물관)	4933	3771	20180122	8704
20180126	수인선	원인재	4335	4365	20180129	8700
20180114	경의선	탄현	4444	4249	20180117	8693
20180113	5호선	개화산	4512	4175	20180116	8687
20180126	경원선	녹양	4596	4090	20180129	8686
20180205	경부선	송탄	4342	4342	20180208	8684
20180204	경부선	의왕	4353	4326	20180207	8679
20180127	5호선	애오개	4434	4244	20180130	8678
20180119	9호선	신목동	4602	4076	20180122	8678
20180125	6호선	역촌	4021	4653	20180128	8674
20180131	경의선	야당	4463	4210	20180203	8673
20180120	수인선	원인재	4354	4318	20180123	8672
20180125	2호선	신설동	4330	4339	20180128	8669
20180208	9호선	신목동	4536	4132	20180211	8668
20180211	3호선	매봉	4393	4268	20180214	8661
20180204	5호선	방화	4378	4274	20180207	8652
20180123	안산선	반월	4448	4200	20180126	8648
20180119	안산선	대야미	4615	4030	20180122	8645
20180204	8호선	문정	4194	4449	20180207	8643
20180121	5호선	여의나루	4208	4435	20180124	8643
20180127	6호선	태릉입구	4070	4572	20180130	8642
20180127	3호선	오금	4541	4100	20180130	8641
20180208	안산선	수리산	4934	3704	20180211	8638
20180127	9호선2단계	선정릉	4307	4327	20180130	8634
20180129	5호선	청구	4509	4119	20180201	8628
20180124	3호선	무악재	4299	4329	20180127	8628
20180112	3호선	무악재	4334	4293	20180115	8627
20180113	경부선	서울역	7659	966	20180116	8625
20180117	2호선	신설동	4245	4372	20180120	8617
20180115	2호선	신설동	4198	4419	20180118	8617
20180127	경부선	서정리	4674	3941	20180130	8615
20180123	5호선	청구	4490	4125	20180126	8615
20180114	6호선	보문	4482	4133	20180117	8615
20180201	경부선	송탄	4376	4235	20180204	8611
20180127	8호선	산성	4377	4228	20180130	8605
20180120	안산선	반월	4528	4072	20180123	8600
20180204	경원선	가능	4500	4097	20180207	8597
20180130	우이신설선	성신여대입구(돈암)	4389	4208	20180202	8597
20180114	8호선	수진	4471	4119	20180117	8590
20180204	경인선	온수(성공회대입구)	4373	4216	20180207	8589
20180112	경원선	한남	4346	4243	20180115	8589
20180203	8호선	송파	4357	4230	20180206	8587
20180118	수인선	소래포구	4450	4136	20180121	8586
20180120	경부선	서울역	7689	894	20180123	8583
20180204	5호선	방이	4371	4208	20180207	8579
20180125	경의선	금릉	4349	4230	20180128	8579
20180124	경의선	가좌	4512	4062	20180127	8574
20180130	안산선	수리산	4814	3759	20180202	8573
20180206	분당선	청명	4383	4188	20180209	8571
20180112	6호선	청구	4095	4476	20180115	8571
20180125	5호선	청구	4444	4122	20180128	8566
20180211	8호선	문정	4200	4365	20180214	8565
20180131	안산선	수리산	4942	3623	20180203	8565
20180126	분당선	청명	4514	4051	20180129	8565
20180114	중앙선	상봉(시외버스터미널)	4330	4232	20180117	8562
20180121	8호선	문정	4198	4363	20180124	8561
20180130	분당선	청명	4345	4212	20180202	8557
20180128	경부선	명학	4316	4241	20180131	8557
20180118	6호선	약수	4268	4288	20180121	8556
20180211	5호선	여의나루	4125	4430	20180214	8555
20180125	경의선	가좌	4450	4104	20180128	8554
20180120	8호선	송파	4399	4154	20180123	8553
20180120	분당선	선정릉	4176	4375	20180123	8551
20180113	5호선	마천	4217	4332	20180116	8549
20180114	8호선	문정	4236	4311	20180117	8547
20180124	6호선	역촌	3937	4603	20180127	8540
20180126	과천선	과천	4660	3879	20180129	8539
20180112	5호선	청구	4461	4074	20180115	8535
20180201	수인선	소래포구	4384	4150	20180204	8534
20180204	8호선	수진	4422	4104	20180207	8526
20180115	경의선	야당	4380	4143	20180118	8523
20180127	경부선	서울역	7600	921	20180130	8521
20180126	6호선	역촌	3981	4540	20180129	8521
20180115	안산선	수리산	4836	3684	20180118	8520
20180126	경의선	풍산	4390	4128	20180129	8518
20180211	경인선	온수(성공회대입구)	4354	4161	20180214	8515
20180125	경원선	한남	4231	4282	20180128	8513
20180112	분당선	청명	4537	3976	20180115	8513
20180126	3호선	무악재	4268	4244	20180129	8512
20180205	분당선	청명	4430	4079	20180208	8509
20180123	분당선	청명	4358	4151	20180126	8509
20180121	중앙선	덕소	4224	4280	20180124	8504
20180112	과천선	과천	4722	3781	20180115	8503
20180207	9호선	신목동	4503	3998	20180210	8501
20180123	6호선	청구	4017	4482	20180126	8499
20180212	9호선	신목동	4513	3981	20180215	8494
20180211	5호선	방이	4353	4139	20180214	8492
20180129	경부선	서정리	4155	4337	20180201	8492
20180114	경부선	서정리	3740	4751	20180117	8491
20180121	과천선	선바위	4570	3917	20180124	8487
20180121	7호선	까치울	4255	4227	20180124	8482
20180212	안산선	수리산	4866	3615	20180215	8481
20180124	5호선	청구	4411	4070	20180127	8481
20180212	과천선	과천	4612	3868	20180215	8480
20180124	수인선	원인재	4156	4324	20180127	8480
20180121	7호선	춘의	4358	4120	20180124	8478
20180207	경의선	야당	4375	4102	20180210	8477
20180129	경부선	송탄	4311	4166	20180201	8477
20180120	우이신설선	북한산보국문	4526	3942	20180123	8468
20180129	분당선	매탄권선	4282	4179	20180201	8461
20180212	안산선	대야미	4439	4021	20180215	8460
20180203	5호선	개화산	4361	4099	20180206	8460
20180201	6호선	약수	4247	4209	20180204	8456
20180114	5호선	여의나루	4105	4350	20180117	8455
20180115	9호선	신목동	4445	4009	20180118	8454
20180123	과천선	과천	4577	3876	20180126	8453
20180121	5호선	방이	4282	4171	20180124	8453
20180205	안산선	수리산	4803	3649	20180208	8452
20180126	6호선	청구	3999	4447	20180129	8446
20180124	경원선	한남	4269	4175	20180127	8444
20180120	경인선	인천	4517	3924	20180123	8441
20180114	3호선	교대(법원.검찰청)	5172	3267	20180117	8439
20180128	중앙선	상봉(시외버스터미널)	4321	4113	20180131	8434
20180211	경부선	명학	4215	4218	20180214	8433
20180211	경원선	덕정	4050	4380	20180214	8430
20180113	9호선2단계	선정릉	4198	4231	20180116	8429
20180115	6호선	약수	4215	4212	20180118	8427
20180114	5호선	방화	4244	4183	20180117	8427
20180123	경부선	송탄	4248	4178	20180126	8426
20180120	경원선	녹양	4442	3984	20180123	8426
20180113	8호선	송파	4301	4125	20180116	8426
20180123	경부선	서정리	4168	4256	20180126	8424
20180114	5호선	방이	4292	4132	20180117	8424
20180211	과천선	선바위	4469	3954	20180214	8423
20180131	경원선	이촌(국립중앙박물관)	4741	3680	20180203	8421
20180130	안산선	초지	4204	4212	20180202	8416
20180126	경부선	서정리	4273	4142	20180129	8415
20180125	6호선	청구	3994	4421	20180128	8415
20180203	5호선	마곡	4453	3958	20180206	8411
20180130	5호선	신길	3797	4614	20180202	8411
20180122	과천선	과천	4535	3876	20180125	8411
20180112	6호선	역촌	3956	4455	20180115	8411
20180203	5호선	마천	4098	4312	20180206	8410
20180131	5호선	오금	4214	4191	20180203	8405
20180131	안산선	대야미	4468	3937	20180203	8405
20180127	2호선	신설동	4257	4148	20180130	8405
20180127	경의선	백마	4429	3975	20180130	8404
20180204	5호선	행당	4363	4038	20180207	8401
20180113	분당선	상갈	4352	4049	20180116	8401
20180120	경의선	금릉	4301	4099	20180123	8400
20180205	5호선	영등포구청	4176	4221	20180208	8397
20180206	5호선	영등포구청	4121	4275	20180209	8396
20180117	6호선	약수	4215	4179	20180120	8394
20180121	9호선	양천향교	4083	4309	20180124	8392
20180122	9호선	신목동	4346	4043	20180125	8389
20180203	경원선	월계	4359	4028	20180206	8387
20180206	과천선	과천	4546	3840	20180209	8386
20180128	경원선	덕정	4001	4381	20180131	8382
20180117	경부선	신도림	4174	4208	20180120	8382
20180208	6호선	약수	4191	4190	20180211	8381
20180130	경원선	이촌(국립중앙박물관)	4664	3717	20180202	8381
20180130	경의선	야당	4205	4176	20180202	8381
20180113	5호선	여의나루	4160	4218	20180116	8378
20180121	3호선	매봉	4264	4112	20180124	8376
20180128	경의선	행신	4286	4089	20180131	8375
20180203	경의선	운정	4333	4041	20180206	8374
20180128	3호선	교대(법원.검찰청)	5165	3206	20180131	8371
20180203	우이신설선	북한산보국문	4472	3897	20180206	8369
20180119	경부선	세류	4318	4049	20180122	8367
20180125	경의선	풍산	4323	4043	20180128	8366
20180119	안산선	초지	4295	4070	20180122	8365
20180207	안산선	수리산	4796	3566	20180210	8362
20180211	7호선	춘의	4245	4115	20180214	8360
20180126	안산선	반월	4402	3957	20180129	8359
20180129	5호선	영등포구청	4134	4224	20180201	8358
20180120	5호선	을지로4가	3908	4450	20180123	8358
20180205	과천선	과천	4480	3872	20180208	8352
20180211	경부선	송탄	3972	4379	20180214	8351
20180211	일산선	원흥	4435	3914	20180214	8349
20180121	경부선	서정리	3693	4656	20180124	8349
20180121	8호선	몽촌토성(평화의문)	4218	4131	20180124	8349
20180115	수인선	소래포구	4327	4019	20180118	8346
20180124	경의선	금릉	4247	4097	20180127	8344
20180128	3호선	매봉	4324	4019	20180131	8343
20180206	경부선	성환	4087	4255	20180209	8342
20180121	경원선	소요산	4539	3802	20180124	8341
20180130	경부선	서정리	4144	4195	20180202	8339
20180204	경의선	행신	4293	4045	20180207	8338
20180205	경의선	야당	4316	4021	20180208	8337
20180128	6호선	보문	4367	3969	20180131	8336
20180128	경부선	송탄	3861	4471	20180131	8332
20180127	분당선	선정릉	4077	4255	20180130	8332
20180113	경의선	운정	4370	3961	20180116	8331
20180115	과천선	과천	4542	3788	20180118	8330
20180123	경의선	야당	4314	4013	20180126	8327
20180118	안산선	대야미	4387	3940	20180121	8327
20180205	9호선	신목동	4361	3965	20180208	8326
20180121	3호선	일원	3959	4367	20180124	8326
20180117	안산선	대야미	4365	3955	20180120	8320
20180206	경부선	송탄	4180	4138	20180209	8318
20180201	9호선	신목동	4432	3885	20180204	8317
20180125	분당선	매탄권선	4236	4080	20180128	8316
20180120	공항철도 1호선	청라국제도시	4267	4048	20180123	8315
20180121	3호선	교대(법원.검찰청)	5102	3209	20180124	8311
20180128	분당선	가천대	3823	4486	20180131	8309
20180123	5호선	영등포구청	4013	4294	20180126	8307
20180211	8호선	가락시장	3538	4767	20180214	8305
20180128	5호선	방이	4199	4105	20180131	8304
20180204	8호선	몽촌토성(평화의문)	4223	4079	20180207	8302
20180211	6호선	대흥(서강대앞)	3978	4323	20180214	8301
20180117	5호선	신길	3798	4503	20180120	8301
20180211	경의선	탄현	4227	4072	20180214	8299
20180126	경원선	한남	4194	4104	20180129	8298
20180124	안산선	반월	4241	4055	20180127	8296
20180115	5호선	신길	3790	4504	20180118	8294
20180125	분당선	청명	4276	4017	20180128	8293
20180124	6호선	청구	3904	4386	20180127	8290
20180201	안산선	대야미	4322	3966	20180204	8288
20180113	6호선	상월곡(한국과학기술연구원)	4474	3810	20180116	8284
20180121	수인선	연수	4078	4203	20180124	8281
20180126	5호선	청구	4317	3962	20180129	8279
20180207	5호선	신길	3788	4487	20180210	8275
20180121	8호선	가락시장	3626	4646	20180124	8272
20180124	2호선	신설동	4081	4188	20180127	8269
20180124	8호선	모란	4752	3516	20180127	8268
20180121	경원선	도봉	4286	3982	20180124	8268
20180211	6호선	불광	4407	3860	20180214	8267
20180130	5호선	동대문역사문화공원	3972	4292	20180202	8264
20180130	경부선	송탄	4164	4099	20180202	8263
20180118	경원선	이촌(국립중앙박물관)	4638	3625	20180121	8263
20180201	경원선	이촌(국립중앙박물관)	4637	3625	20180204	8262
20180129	분당선	청명	4285	3976	20180201	8261
20180211	5호선	방화	4175	4085	20180214	8260
20180125	안산선	반월	4237	4022	20180128	8259
20180121	분당선	가천대	3695	4564	20180124	8259
20180128	6호선	불광	4446	3810	20180131	8256
20180114	9호선	양천향교	3991	4264	20180117	8255
20180207	6호선	약수	4188	4065	20180210	8253
20180119	경부선	신도림	4167	4079	20180122	8246
20180118	수인선	호구포	4115	4129	20180121	8244
20180211	경의선	행신	4256	3984	20180214	8240
20180205	경인선	도원	4087	4152	20180208	8239
20180131	5호선	신길	3817	4421	20180203	8238
20180117	경원선	이촌(국립중앙박물관)	4664	3573	20180120	8237
20180114	분당선	서울숲	4105	4128	20180117	8233
20180114	중앙선	덕소	4032	4198	20180117	8230
20180128	8호선	몽촌토성(평화의문)	4171	4058	20180131	8229
20180117	8호선	모란	4747	3479	20180120	8226
20180113	분당선	선정릉	4037	4186	20180116	8223
20180204	경원선	덕정	3981	4241	20180207	8222
20180122	5호선	신길	3705	4512	20180125	8217
20180205	5호선	오금	4116	4098	20180208	8214
20180114	8호선	가락시장	3621	4592	20180117	8213
20180201	5호선	오금	4032	4179	20180204	8211
20180211	9호선	양천향교	4065	4139	20180214	8204
20180130	5호선	오금	4138	4065	20180202	8203
20180124	분당선	매탄권선	4141	4062	20180127	8203
20180119	수인선	호구포	4128	4075	20180122	8203
20180120	경원선	월계	4359	3839	20180123	8198
20180120	수인선	인하대	4298	3899	20180123	8197
20180208	8호선	모란	4662	3534	20180211	8196
20180208	우이신설선	가오리	4054	4142	20180211	8196
20180204	경부선	송탄	3858	4337	20180207	8195
20180128	3호선	일원	3855	4339	20180131	8194
20180211	2호선	을지로4가	4294	3899	20180214	8193
20180131	6호선	약수	4123	4068	20180203	8191
20180120	분당선	구성	4068	4112	20180123	8180
20180121	과천선	대공원	3960	4219	20180124	8179
20180131	수인선	호구포	4112	4066	20180203	8178
20180212	6호선	약수	4126	4048	20180215	8174
20180211	8호선	수진	4209	3962	20180214	8171
20180113	안산선	반월	4359	3812	20180116	8171
20180114	과천선	선바위	4382	3787	20180117	8169
20180201	8호선	모란	4684	3480	20180204	8164
20180131	수인선	소래포구	4302	3861	20180203	8163
20180125	9호선	신목동	4322	3840	20180128	8162
20180114	수인선	연수	4047	4115	20180117	8162
20180204	8호선	가락시장	3567	4594	20180207	8161
20180208	경원선	이촌(국립중앙박물관)	4575	3582	20180211	8157
20180212	경원선	이촌(국립중앙박물관)	4572	3584	20180215	8156
20180121	6호선	대흥(서강대앞)	3973	4183	20180124	8156
20180212	5호선	오금	4019	4134	20180215	8153
20180205	장항선	온양온천	4033	4117	20180208	8150
20180117	5호선	오금	4142	4008	20180120	8150
20180114	경원선	도봉	4230	3919	20180117	8149
20180123	6호선	약수	4094	4050	20180126	8144
20180115	안산선	대야미	4254	3890	20180118	8144
20180203	수인선	원인재	4062	4081	20180206	8143
20180114	6호선	대흥(서강대앞)	3909	4234	20180117	8143
20180119	우이신설선	가오리	4103	4039	20180122	8142
20180207	5호선	오금	4091	4049	20180210	8140
20180206	6호선	약수	4032	4108	20180209	8140
20180122	6호선	약수	4157	3983	20180125	8140
20180208	안산선	대야미	4247	3892	20180211	8139
20180207	장항선	온양온천	4041	4098	20180210	8139
20180211	3호선	일원	3913	4225	20180214	8138
20180131	우이신설선	가오리	4039	4093	20180203	8132
20180123	9호선	신목동	4345	3787	20180126	8132
20180113	경의선	풍산	4116	4015	20180116	8131
20180212	5호선	신길	3702	4428	20180215	8130
20180203	경부선	서울역	7305	823	20180206	8128
20180112	9호선	신목동	4356	3771	20180115	8127
20180128	경의선	탄현	4132	3994	20180131	8126
20180124	경의선	풍산	4206	3920	20180127	8126
20180115	경부선	신도림	4145	3978	20180118	8123
20180114	7호선	춘의	4193	3928	20180117	8121
20180130	8호선	모란	4715	3405	20180202	8120
20180131	5호선	동대문역사문화공원	3602	4513	20180203	8115
20180129	9호선	신목동	4299	3815	20180201	8114
20180120	경부선	세류	4103	4011	20180123	8114
20180130	우이신설선	가오리	3836	4277	20180202	8113
20180127	5호선	개화산	4137	3974	20180130	8111
20180129	과천선	과천	4410	3697	20180201	8107
20180118	5호선	신길	3646	4461	20180121	8107
20180208	경인선	도화	4241	3862	20180211	8103
20180124	과천선	과천	4424	3679	20180127	8103
20180206	안산선	수리산	4634	3468	20180209	8102
20180208	9호선	신반포	3982	4118	20180211	8100
20180128	8호선	문정	4036	4064	20180131	8100
20180122	8호선	모란	4645	3455	20180125	8100
20180131	우이신설선	정릉	4210	3884	20180203	8094
20180212	8호선	모란	4684	3405	20180215	8089
20180114	6호선	구산	4571	3518	20180117	8089
20180125	경부선	서정리	4098	3990	20180128	8088
20180118	8호선	모란	4649	3438	20180121	8087
20180121	6호선	구산	4544	3542	20180124	8086
20180121	일산선	원흥	4225	3860	20180124	8085
20180206	경의선	야당	4207	3875	20180209	8082
20180205	6호선	약수	4084	3994	20180208	8078
20180129	5호선	신길	3690	4388	20180201	8078
20180114	3호선	일원	3832	4244	20180117	8076
20180211	3호선	교대(법원.검찰청)	4939	3136	20180214	8075
20180123	안산선	수리산	4639	3436	20180126	8075
20180129	경의선	야당	4184	3889	20180201	8073
20180122	수인선	소래포구	4195	3878	20180125	8073
20180203	5호선	을지로4가	3730	4341	20180206	8071
20180131	8호선	모란	4678	3390	20180203	8068
20180121	수인선	인천논현	3969	4099	20180124	8068
20180128	6호선	삼각지	4543	3523	20180131	8066
20180201	9호선	신반포	4007	4055	20180204	8062
20180204	6호선	구산	4430	3628	20180207	8058
20180127	우이신설선	북한산보국문	4226	3828	20180130	8054
20180205	안산선	초지	4031	4022	20180208	8053
20180208	우이신설선	정릉	4182	3868	20180211	8050
20180114	7호선	까치울	4161	3888	20180117	8049
20180207	경인선	도원	3906	4142	20180210	8048
20180121	6호선	불광	4296	3748	20180124	8044
20180205	5호선	신길	3633	4410	20180208	8043
20180120	중앙선	용문	3930	4112	20180123	8042
20180204	8호선	모란	4562	3477	20180207	8039
20180118	경부선	신도림	4117	3922	20180121	8039
20180203	경의선	가좌	4141	3897	20180206	8038
20180119	5호선	신길	3733	4305	20180122	8038
20180208	5호선	신길	3668	4367	20180211	8035
20180207	우이신설선	가오리	4056	3977	20180210	8033
20180203	중앙선	양평	3934	4098	20180206	8032
20180201	우이신설선	성신여대입구(돈암)	4002	4030	20180204	8032
20180208	5호선	동대문역사문화공원	3668	4363	20180211	8031
20180201	5호선	신길	3688	4341	20180204	8029
20180121	8호선	수진	4219	3808	20180124	8027
20180208	수인선	소래포구	4203	3821	20180211	8024
20180207	경원선	이촌(국립중앙박물관)	4490	3531	20180210	8021
20180130	안산선	대야미	4193	3827	20180202	8020
20180127	4호선	삼각지	3379	4641	20180130	8020
20180125	과천선	과천	4357	3663	20180128	8020
20180129	안산선	수리산	4599	3420	20180201	8019
20180119	경인선	도화	4277	3738	20180122	8015
20180207	안산선	대야미	4212	3802	20180210	8014
20180212	우이신설선	가오리	3979	4034	20180215	8013
20180114	경부선	당정	4004	4007	20180117	8011
20180120	경원선	소요산	4341	3668	20180123	8009
20180114	3호선	매봉	4121	3888	20180117	8009
20180127	5호선	마천	3987	4018	20180130	8005
20180127	3호선	잠원	4109	3894	20180130	8003
20180113	5호선	을지로4가	3770	4232	20180116	8002
20180127	경춘선	평내호평	4090	3910	20180130	8000
20180113	중앙선	양평	3852	4148	20180116	8000
20180115	8호선	모란	4625	3371	20180118	7996
20180203	분당선	상갈	4134	3861	20180206	7995
20180119	우이신설선	성신여대입구(돈암)	4032	3963	20180122	7995
20180115	경원선	이촌(국립중앙박물관)	4509	3486	20180118	7995
20180114	6호선	불광	4276	3719	20180117	7995
20180206	경부선	서정리	3996	3996	20180209	7992
20180201	우이신설선	가오리	3925	4066	20180204	7991
20180128	5호선	방화	3982	4006	20180131	7988
20180113	경의선	금릉	4072	3916	20180116	7988
20180206	5호선	신길	3620	4367	20180209	7987
20180121	경부선	군포	4136	3850	20180124	7986
20180118	5호선	오금	3981	4004	20180121	7985
20180128	일산선	원흥	4288	3695	20180131	7983
20180124	분당선	청명	4169	3813	20180127	7982
20180124	경부선	송탄	4046	3935	20180127	7981
20180122	5호선	오금	4065	3916	20180125	7981
20180204	분당선	서울숲	3917	4062	20180207	7979
20180115	경원선	동두천중앙	4089	3890	20180118	7979
20180122	안산선	대야미	4162	3815	20180125	7977
20180122	우이신설선	가오리	3934	4042	20180125	7976
20180112	5호선	영등포구청	3933	4042	20180115	7975
20180204	6호선	삼각지	4489	3482	20180207	7971
20180204	분당선	가천대	3524	4446	20180207	7970
20180211	6호선	구산	4463	3506	20180214	7969
20180131	우이신설선	성신여대입구(돈암)	4042	3926	20180203	7968
20180121	경원선	녹양	4129	3839	20180124	7968
20180120	경의선	가좌	4059	3908	20180123	7967
20180203	수인선	소래포구	3990	3973	20180206	7963
20180117	수인선	호구포	4034	3929	20180120	7963
20180204	7호선	춘의	4175	3786	20180207	7961
20180122	경원선	이촌(국립중앙박물관)	4477	3483	20180125	7960
20180112	안산선	수리산	4640	3320	20180115	7960
20180127	경인선	구일	3965	3993	20180130	7958
20180117	우이신설선	가오리	3912	4045	20180120	7957
20180205	우이신설선	가오리	3946	4005	20180208	7951
20180121	2호선	신설동	4115	3835	20180124	7950
20180119	5호선	오금	3975	3972	20180122	7947
20180208	5호선	오금	3928	4018	20180211	7946
20180124	경부선	서정리	4033	3913	20180127	7946
20180115	5호선	오금	3983	3956	20180118	7939
20180203	공항철도 1호선	청라국제도시	4044	3894	20180206	7938
20180211	분당선	서울숲	3920	4016	20180214	7936
20180129	5호선	오금	3948	3985	20180201	7933
20180131	경인선	도화	4117	3813	20180203	7930
20180131	경부선	신도림	4032	3895	20180203	7927
20180119	우이신설선	정릉	4151	3775	20180122	7926
20180117	안산선	초지	4023	3902	20180120	7925
20180204	9호선	양천향교	3868	4055	20180207	7923
20180128	과천선	선바위	4148	3775	20180131	7923
20180119	경부선	성환	4237	3682	20180122	7919
20180120	5호선	양평	4075	3840	20180123	7915
20180112	6호선	약수	3950	3965	20180115	7915
20180204	과천선	선바위	4216	3697	20180207	7913
20180128	6호선	구산	4340	3569	20180131	7909
20180120	7호선	부천종합운동장	4183	3724	20180123	7907
20180114	일산선	원흥	4252	3655	20180117	7907
20180124	9호선	신목동	4184	3722	20180127	7906
20180208	경인선	도원	3827	4076	20180211	7903
20180118	안산선	초지	4056	3845	20180121	7901
20180201	수인선	호구포	3957	3942	20180204	7899
20180123	5호선	신길	3610	4289	20180126	7899
20180113	공항철도 1호선	청라국제도시	4097	3800	20180116	7897
20180212	5호선	동대문역사문화공원	3674	4222	20180215	7896
20180114	6호선	월드컵경기장(성산)	3905	3990	20180117	7895
20180126	9호선	신목동	4245	3646	20180129	7891
20180203	안산선	반월	4217	3673	20180206	7890
20180129	6호선	약수	3927	3962	20180201	7889
20180120	경의선	풍산	4050	3839	20180123	7889
20180204	일산선	원흥	4140	3748	20180207	7888
20180204	경의선	탄현	4005	3878	20180207	7883
20180119	경의선	서울역	3426	4456	20180122	7882
20180204	6호선	월드컵경기장(성산)	3818	4061	20180207	7879
20180117	경인선	도화	4122	3757	20180120	7879
20180201	경부선	신도림	3950	3926	20180204	7876
20180113	경의선	가좌	4012	3864	20180116	7876
20180122	경원선	동두천중앙	4062	3813	20180125	7875
20180122	수인선	호구포	3910	3957	20180125	7867
20180204	중앙선	덕소	3859	4006	20180207	7865
20180113	7호선	삼산체육관	4179	3686	20180116	7865
20180127	6호선	상월곡(한국과학기술연구원)	4157	3705	20180130	7862
20180130	수인선	호구포	3979	3882	20180202	7861
20180128	경부선	서정리	3520	4340	20180131	7860
20180117	경원선	동두천중앙	4003	3855	20180120	7858
20180207	경인선	도화	4148	3709	20180210	7857
20180130	수인선	소래포구	4056	3800	20180202	7856
20180208	경부선	신도림	3995	3860	20180211	7855
20180126	6호선	약수	3889	3965	20180129	7854
20180127	5호선	여의나루	3818	4024	20180130	7842
20180119	9호선	신반포	3966	3875	20180122	7841
20180124	장항선	온양온천	3986	3854	20180127	7840
20180205	5호선	동대문역사문화공원	3643	4193	20180208	7836
20180205	경원선	이촌(국립중앙박물관)	4381	3454	20180208	7835
20180122	경부선	신도림	3994	3841	20180125	7835
20180203	7호선	부천종합운동장	4073	3761	20180206	7834
20180206	5호선	동대문역사문화공원	3619	4206	20180209	7825
20180115	우이신설선	정릉	3991	3834	20180118	7825
20180211	8호선	몽촌토성(평화의문)	3878	3944	20180214	7822
20180114	7호선	용마산	3933	3888	20180117	7821
20180201	우이신설선	정릉	4096	3723	20180204	7819
20180117	우이신설선	성신여대입구(돈암)	3940	3877	20180120	7817
20180120	9호선	개화	4462	3354	20180123	7816
20180205	안산선	대야미	4065	3750	20180208	7815
20180124	5호선	영등포구청	3843	3971	20180127	7814
20180204	3호선	교대(법원.검찰청)	4781	3031	20180207	7812
20180125	안산선	수리산	4456	3351	20180128	7807
20180121	경부선	당정	3907	3899	20180124	7806
20180212	우이신설선	정릉	4058	3747	20180215	7805
20180113	경부선	세류	3916	3889	20180116	7805
20180125	6호선	약수	3901	3903	20180128	7804
20180121	분당선	서울숲	3801	4002	20180124	7803
20180206	5호선	오금	3900	3900	20180209	7800
20180212	경인선	도화	4113	3685	20180215	7798
20180114	경원선	소요산	4148	3650	20180117	7798
20180207	5호선	동대문역사문화공원	3600	4197	20180210	7797
20180117	우이신설선	정릉	4046	3749	20180120	7795
20180208	경원선	동두천중앙	4002	3786	20180211	7788
20180118	우이신설선	성신여대입구(돈암)	3870	3918	20180121	7788
20180113	과천선	대공원	3737	4047	20180116	7784
20180206	우이신설선	가오리	3792	3987	20180209	7779
20180205	경인선	도화	4078	3701	20180208	7779
20180121	경인선	간석	3965	3814	20180124	7779
20180128	7호선	춘의	3966	3812	20180131	7778
20180207	9호선	신반포	3909	3868	20180210	7777
20180128	중앙선	덕소	3807	3970	20180131	7777
20180203	경원선	녹양	4121	3655	20180206	7776
20180203	9호선	개화	4464	3310	20180206	7774
20180212	수인선	호구포	3894	3878	20180215	7772
20180201	5호선	동대문역사문화공원	3504	4267	20180204	7771
20180207	수인선	호구포	3885	3884	20180210	7769
20180211	중앙선	덕소	3774	3994	20180214	7768
20180207	8호선	모란	4502	3265	20180210	7767
20180128	공항철도 1호선	디지털미디어시티	3951	3814	20180131	7765
20180208	우이신설선	성신여대입구(돈암)	3882	3882	20180211	7764
20180114	수인선	인천논현	3827	3937	20180117	7764
20180127	5호선	마곡	4113	3650	20180130	7763
20180128	8호선	가락시장	3352	4410	20180131	7762
20180128	6호선	대흥(서강대앞)	3763	3996	20180131	7759
20180128	분당선	서울숲	3878	3880	20180131	7758
20180207	우이신설선	정릉	4014	3743	20180210	7757
20180113	경원선	월계	4098	3657	20180116	7755
20180208	수인선	호구포	3867	3886	20180211	7753
20180115	경인선	도화	4087	3666	20180118	7753
20180113	경원선	녹양	4147	3604	20180116	7751
20180118	9호선	신반포	3774	3975	20180121	7749
20180122	우이신설선	정릉	4010	3730	20180125	7740
20180124	안산선	수리산	4441	3293	20180127	7734
20180112	경의선	야당	3958	3772	20180115	7730
20180119	경원선	동두천중앙	4007	3722	20180122	7729
20180114	5호선	올림픽공원(한국체대)	3859	3870	20180117	7729
20180125	경부선	송탄	3945	3780	20180128	7725
20180113	분당선	구성	3849	3873	20180116	7722
20180119	중앙선	양평	3819	3902	20180122	7721
20180212	안산선	초지	3970	3747	20180215	7717
20180211	경원선	도봉	3931	3782	20180214	7713
20180206	9호선	구반포	3690	4023	20180209	7713
20180203	7호선	삼산체육관	4054	3658	20180206	7712
20180115	경부선	세류	3990	3722	20180118	7712
20180208	경부선	세류	3956	3754	20180211	7710
20180122	경의선	서울역	3411	4298	20180125	7709
20180207	분당선	개포동	3691	4013	20180210	7704
20180128	분당선	강남구청	3512	4192	20180131	7704
20180131	9호선	신반포	3845	3858	20180203	7703
20180123	경원선	이촌(국립중앙박물관)	4349	3351	20180126	7700
20180125	경의선	야당	3989	3709	20180128	7698
20180123	5호선	동대문역사문화공원	3561	4135	20180126	7696
20180203	5호선	양평	3868	3824	20180206	7692
20180131	안산선	초지	3888	3804	20180203	7692
20180207	우이신설선	성신여대입구(돈암)	3882	3806	20180210	7688
20180126	안산선	수리산	4473	3215	20180129	7688
20180117	5호선	동대문역사문화공원	3565	4123	20180120	7688
20180127	경의선	운정	3994	3690	20180130	7684
20180112	8호선	모란	4363	3320	20180115	7683
20180129	안산선	대야미	4042	3632	20180201	7674
20180206	장항선	온양온천	3854	3816	20180209	7670
20180121	공항철도 1호선	디지털미디어시티	3829	3840	20180124	7669
20180203	경의선	금릉	3860	3808	20180206	7668
20180121	2호선	양천구청	3709	3959	20180124	7668
20180121	경부선	서울역	6889	776	20180124	7665
20180114	경인선	간석	3904	3761	20180117	7665
20180112	경원선	이촌(국립중앙박물관)	4297	3367	20180115	7664
20180203	경의선	풍산	3936	3726	20180206	7662
20180118	5호선	동대문역사문화공원	3497	4165	20180121	7662
20180125	5호선	영등포구청	3766	3895	20180128	7661
20180126	장항선	온양온천	3853	3807	20180129	7660
20180118	우이신설선	가오리	3745	3915	20180121	7660
20180117	경의선	능곡	3923	3737	20180120	7660
20180122	경인선	도화	3979	3679	20180125	7658
20180206	수인선	호구포	3859	3798	20180209	7657
20180206	8호선	모란	4393	3264	20180209	7657
20180119	5호선	동대문역사문화공원	3394	4262	20180122	7656
20180115	5호선	동대문역사문화공원	3524	4129	20180118	7653
20180114	경부선	군포	3986	3667	20180117	7653
20180118	경인선	도화	3968	3684	20180121	7652
20180119	경춘선	마석	3842	3808	20180122	7650
20180130	9호선	신반포	3727	3922	20180202	7649
20180208	경의선	능곡	3984	3664	20180211	7648
20180130	경의선	능곡	3904	3744	20180202	7648
20180212	경부선	신도림	3863	3783	20180215	7646
20180123	장항선	온양온천	3809	3835	20180126	7644
20180114	6호선	효창공원앞	3939	3698	20180117	7637
20180123	5호선	오금	3868	3767	20180126	7635
20180130	6호선	창신	4051	3583	20180202	7634
20180121	2호선	을지로4가	3951	3683	20180124	7634
20180205	8호선	모란	4411	3222	20180208	7633
20180112	경부선	세류	3990	3641	20180115	7631
20180204	3호선	매봉	3817	3813	20180207	7630
20180118	경원선	동두천중앙	3945	3685	20180121	7630
20180115	우이신설선	가오리	3779	3850	20180118	7629
20180130	경부선	신도림	3859	3768	20180202	7627
20180206	9호선	신반포	3792	3834	20180209	7626
20180118	경춘선	마석	3795	3831	20180121	7626
20180205	우이신설선	정릉	3905	3720	20180208	7625
20180124	5호선	신길	3445	4180	20180127	7625
20180131	경의선	능곡	4045	3579	20180203	7624
20180122	경의선	능곡	3963	3661	20180125	7624
20180122	경춘선	마석	3776	3846	20180125	7622
20180115	수인선	호구포	3757	3864	20180118	7621
20180112	5호선	오금	3865	3755	20180115	7620
20180121	수인선	소래포구	3920	3698	20180124	7618
20180208	6호선	창신	4165	3452	20180211	7617
20180203	우이신설선	솔샘	4057	3560	20180206	7617
20180204	경원선	도봉	3991	3625	20180207	7616
20180212	수인선	소래포구	4020	3595	20180215	7615
20180206	경원선	이촌(국립중앙박물관)	4311	3304	20180209	7615
20180205	경원선	동두천중앙	3886	3727	20180208	7613
20180128	8호선	수진	3932	3678	20180131	7610
20180125	5호선	신길	3507	4099	20180128	7606
20180125	5호선	동대문역사문화공원	3542	4063	20180128	7605
20180112	5호선	신길	3517	4085	20180115	7602
20180211	5호선	마장	3808	3793	20180214	7601
20180211	경부선	서정리	3421	4179	20180214	7600
20180119	경의선	능곡	3983	3616	20180122	7599
20180212	우이신설선	성신여대입구(돈암)	3813	3783	20180215	7596
20180206	우이신설선	정릉	3906	3690	20180209	7596
20180206	안산선	대야미	3964	3632	20180209	7596
20180121	중앙선	중랑	3909	3686	20180124	7595
20180211	7호선	용마산	3752	3841	20180214	7593
20180128	경원선	도봉	3889	3704	20180131	7593
20180126	경의선	야당	3962	3631	20180129	7593
20180118	우이신설선	정릉	3963	3627	20180121	7590
20180123	수인선	호구포	3694	3893	20180126	7587
20180113	분당선	매탄권선	4086	3500	20180116	7586
20180115	우이신설선	성신여대입구(돈암)	3864	3718	20180118	7582
20180127	8호선	송파	3889	3692	20180130	7581
20180113	7호선	부천종합운동장	3955	3622	20180116	7577
20180113	분당선	신갈	3876	3701	20180116	7577
20180112	안산선	대야미	4044	3533	20180115	7577
20180129	경원선	이촌(국립중앙박물관)	4285	3283	20180201	7568
20180122	안산선	초지	3838	3725	20180125	7563
20180114	2호선	양천구청	3743	3815	20180117	7558
20180114	5호선	거여	3854	3703	20180117	7557
20180204	7호선	용마산	3688	3867	20180207	7555
20180201	경인선	도화	3925	3628	20180204	7553
20180113	5호선	양평	3872	3681	20180116	7553
20180123	우이신설선	가오리	3689	3863	20180126	7552
20180131	경원선	동두천중앙	3953	3597	20180203	7550
20180119	9호선	구반포	3692	3858	20180122	7550
20180126	5호선	동대문역사문화공원	3466	4081	20180129	7547
20180121	5호선	거여	3823	3722	20180124	7545
20180121	경인선	인천	4126	3418	20180124	7544
20180118	경부선	세류	3922	3621	20180121	7543
20180126	5호선	영등포구청	3715	3826	20180129	7541
20180122	5호선	동대문역사문화공원	3540	4001	20180125	7541
20180207	6호선	창신	4134	3406	20180210	7540
20180129	5호선	동대문역사문화공원	3495	4043	20180201	7538
20180124	경의선	야당	3915	3619	20180127	7534
20180211	2호선	신설동	3951	3578	20180214	7529
20180201	안산선	초지	3827	3696	20180204	7523
20180117	경부선	세류	3865	3658	20180120	7523
20180127	분당선	상갈	3898	3624	20180130	7522
20180207	경부선	신도림	3805	3716	20180210	7521
20180208	경춘선	마석	3682	3836	20180211	7518
20180122	우이신설선	성신여대입구(돈암)	3830	3687	20180125	7517
20180128	2호선	신설동	3893	3623	20180131	7516
20180211	분당선	가천대	3345	4169	20180214	7514
20180205	수인선	호구포	3680	3833	20180208	7513
20180204	6호선	불광	4094	3419	20180207	7513
20180207	수인선	소래포구	3935	3576	20180210	7511
20180206	경인선	도화	3913	3598	20180209	7511
20180112	5호선	동대문역사문화공원	3416	4095	20180115	7511
20180114	수인선	소래포구	3791	3718	20180117	7509
20180130	경원선	동두천중앙	3847	3661	20180202	7508
20180131	경인선	도원	3746	3760	20180203	7506
20180129	수인선	호구포	3752	3753	20180201	7505
20180201	경의선	능곡	3908	3595	20180204	7503
20180121	7호선	용마산	3672	3828	20180124	7500
20180120	우이신설선	솔샘	3988	3510	20180123	7498
20180208	안산선	초지	3824	3672	20180211	7496
20180129	우이신설선	가오리	3684	3808	20180201	7492
20180206	경인선	도원	3634	3855	20180209	7489
20180112	우이신설선	가오리	3754	3735	20180115	7489
20180205	9호선	신반포	3752	3736	20180208	7488
20180131	분당선	개포동	3697	3791	20180203	7488
20180212	경부선	세류	3904	3583	20180215	7487
20180122	경부선	세류	3856	3619	20180125	7475
20180204	7호선	까치울	3780	3691	20180207	7471
20180115	경의선	능곡	3918	3548	20180118	7466
20180212	경의선	서울역	3113	4352	20180215	7465
20180112	수인선	호구포	3777	3687	20180115	7464
20180203	수인선	인하대	3869	3594	20180206	7463
20180128	7호선	까치울	3737	3722	20180131	7459
20180212	경의선	능곡	3913	3542	20180215	7455
20180212	경원선	동두천중앙	3856	3598	20180215	7454
20180126	8호선	모란	4212	3241	20180129	7453
20180126	경원선	이촌(국립중앙박물관)	4216	3236	20180129	7452
20180130	경춘선	사릉	3642	3808	20180202	7450
20180124	5호선	동대문역사문화공원	3466	3981	20180127	7447
20180211	7호선	까치울	3790	3655	20180214	7445
20180125	5호선	오금	3749	3695	20180128	7444
20180207	경의선	능곡	3853	3590	20180210	7443
20180204	공항철도 1호선	디지털미디어시티	3765	3678	20180207	7443
20180120	경원선	녹천	4083	3360	20180123	7443
20180117	9호선	신반포	3709	3732	20180120	7441
20180211	경부선	군포	3820	3619	20180214	7439
20180129	우이신설선	정릉	3798	3640	20180201	7438
20180201	경부선	세류	3809	3628	20180204	7437
20180117	수인선	숭의	3866	3570	20180120	7436
20180128	수인선	연수	3742	3691	20180131	7433
20180120	중앙선	양평	3617	3816	20180123	7433
20180208	9호선	구반포	3563	3862	20180211	7425
20180126	5호선	오금	3738	3686	20180129	7424
20180120	과천선	과천	4200	3224	20180123	7424
20180114	경강선	경기광주	3667	3757	20180117	7424
20180114	2호선	신설동	3703	3720	20180117	7423
20180118	경의선	능곡	3867	3554	20180121	7421
20180201	경인선	도원	3676	3742	20180204	7418
20180126	5호선	신길	3478	3935	20180129	7413
20180114	중앙선	중랑	3765	3647	20180117	7412
20180117	분당선	개포동	3621	3789	20180120	7410
20180211	공항철도 1호선	디지털미디어시티	3716	3693	20180214	7409
20180120	8호선	모란	4102	3304	20180123	7406
20180128	경부선	서울역	6631	772	20180131	7403
20180205	우이신설선	성신여대입구(돈암)	3774	3622	20180208	7396
20180125	경원선	이촌(국립중앙박물관)	4153	3243	20180128	7396
20180204	수인선	연수	3722	3672	20180207	7394
20180114	2호선	을지로4가	3828	3565	20180117	7393
20180130	경인선	도화	3841	3551	20180202	7392
20180126	우이신설선	가오리	3649	3738	20180129	7387
20180118	경부선	서울역	6367	1019	20180121	7386
20180211	6호선	효창공원앞	3861	3524	20180214	7385
20180131	6호선	창신	4158	3227	20180203	7385
20180203	분당선	구성	3656	3728	20180206	7384
20180127	공항철도 1호선	청라국제도시	3714	3669	20180130	7383
20180207	경원선	동두천중앙	3807	3575	20180210	7382
20180205	경부선	신도림	3758	3621	20180208	7379
20180123	8호선	모란	4243	3136	20180126	7379
20180212	9호선	구반포	3496	3882	20180215	7378
20180201	경원선	동두천중앙	3816	3562	20180204	7378
20180127	수인선	원인재	3751	3627	20180130	7378
20180124	5호선	오금	3685	3691	20180127	7376
20180123	안산선	대야미	3889	3484	20180126	7373
20180119	경인선	인천	4175	3195	20180122	7370
20180120	분당선	매탄권선	3908	3459	20180123	7367
20180119	경춘선	사릉	3847	3519	20180122	7366
20180113	우이신설선	성신여대입구(돈암)	3617	3749	20180116	7366
20180115	경부선	서울역	6232	1132	20180118	7364
20180211	2호선	양천구청	3593	3767	20180214	7360
20180119	분당선	대모산입구	3804	3551	20180122	7355
20180204	2호선	양천구청	3566	3783	20180207	7349
20180124	6호선	약수	3723	3625	20180127	7348
20180211	수인선	인천논현	3548	3799	20180214	7347
20180117	경의선	서울역	3247	4098	20180120	7345
20180203	8호선	모란	3998	3345	20180206	7343
20180131	수인선	숭의	3801	3542	20180203	7343
20180123	우이신설선	성신여대입구(돈암)	3660	3682	20180126	7342
20180119	수인선	숭의	3839	3503	20180122	7342
20180122	경춘선	사릉	3714	3626	20180125	7340
20180113	우이신설선	솔샘	3910	3427	20180116	7337
20180119	경강선	판교	3680	3656	20180122	7336
20180117	경춘선	마석	3628	3701	20180120	7329
20180126	수인선	호구포	3667	3660	20180129	7327
20180204	5호선	거여	3751	3574	20180207	7325
20180129	우이신설선	성신여대입구(돈암)	3750	3574	20180201	7324
20180128	2호선	양천구청	3535	3788	20180131	7323
20180123	안산선	초지	3764	3557	20180126	7321
20180118	수인선	숭의	3768	3552	20180121	7320
20180203	경부선	세류	3681	3638	20180206	7319
20180113	8호선	모란	4013	3304	20180116	7317
20180121	5호선	개롱	3607	3707	20180124	7314
20180117	경인선	도원	3548	3764	20180120	7312
20180206	우이신설선	성신여대입구(돈암)	3685	3623	20180209	7308
20180125	우이신설선	가오리	3606	3701	20180128	7307
20180112	안산선	초지	3789	3518	20180115	7307
20180211	5호선	거여	3759	3547	20180214	7306
20180203	과천선	과천	4053	3252	20180206	7305
20180123	우이신설선	정릉	3719	3586	20180126	7305
20180204	8호선	신흥	3549	3755	20180207	7304
20180203	우이신설선	성신여대입구(돈암)	3586	3717	20180206	7303
20180114	5호선	개롱	3601	3701	20180117	7302
20180211	수인선	연수	3742	3559	20180214	7301
20180113	경원선	녹천	4072	3229	20180116	7301
20180128	경부선	군포	3803	3495	20180131	7298
20180119	경춘선	퇴계원	3824	3473	20180122	7297
20180114	8호선	산성	3698	3597	20180117	7295
20180205	6호선	창신	3900	3393	20180208	7293
20180130	경부선	세류	3734	3558	20180202	7292
20180127	안산선	반월	3879	3409	20180130	7288
20180126	우이신설선	성신여대입구(돈암)	3566	3720	20180129	7286
20180130	9호선	구반포	3448	3833	20180202	7281
20180120	경원선	동두천중앙	3665	3611	20180123	7276
20180125	8호선	모란	4156	3119	20180128	7275
20180123	경부선	세류	3778	3497	20180126	7275
20180128	2호선	을지로4가	3786	3488	20180131	7274
20180126	안산선	대야미	3916	3357	20180129	7273
20180125	수인선	호구포	3624	3649	20180128	7273
20180207	안산선	초지	3693	3579	20180210	7272
20180131	경강선	판교	3671	3599	20180203	7270
20180114	경부선	서울역	6432	836	20180117	7268
20180206	6호선	창신	4004	3263	20180209	7267
20180121	5호선	신금호	3556	3710	20180124	7266
20180201	6호선	창신	4016	3248	20180204	7264
20180115	9호선	신반포	3617	3647	20180118	7264
20180204	분당선	강남구청	3338	3924	20180207	7262
20180128	5호선	거여	3676	3586	20180131	7262
20180128	수인선	인천논현	3558	3701	20180131	7259
20180128	7호선	용마산	3532	3726	20180131	7258
20180121	3호선	경찰병원	3649	3609	20180124	7258
20180126	우이신설선	정릉	3882	3375	20180129	7257
20180204	2호선	을지로4가	3637	3618	20180207	7255
20180124	경원선	이촌(국립중앙박물관)	4117	3138	20180127	7255
20180117	6호선	창신	4067	3183	20180120	7250
20180128	경강선	경기광주	3545	3701	20180131	7246
20180122	중앙선	양평	3610	3631	20180125	7241
20180205	경의선	능곡	3744	3496	20180208	7240
20180119	과천선	대공원	3613	3627	20180122	7240
20180207	경부선	세류	3719	3519	20180210	7238
20180121	3호선	오금	3652	3585	20180124	7237
20180121	경강선	경기광주	3530	3701	20180124	7231
20180113	9호선	개화	4222	3009	20180116	7231
20180119	분당선	개포동	3570	3660	20180122	7230
20180122	9호선	신반포	3520	3709	20180125	7229
20180121	8호선	산성	3541	3685	20180124	7226
20180121	3호선	을지로3가	3657	3568	20180124	7225
20180120	경부선	성환	3848	3374	20180123	7222
20180212	9호선	신반포	3578	3643	20180215	7221
20180204	2호선	신설동	3755	3463	20180207	7218
20180112	우이신설선	성신여대입구(돈암)	3636	3582	20180115	7218
20180204	경부선	군포	3746	3471	20180207	7217
20180207	9호선	구반포	3490	3725	20180210	7215
20180120	9호선	선유도	3630	3583	20180123	7213
20180121	경춘선	평내호평	3710	3502	20180124	7212
20180206	경부선	신도림	3676	3535	20180209	7211
20180131	경부선	세류	3752	3459	20180203	7211
20180203	9호선	선유도	3677	3532	20180206	7209
20180113	경인선	인천	3934	3275	20180116	7209
20180125	안산선	대야미	3802	3402	20180128	7204
20180124	우이신설선	가오리	3525	3678	20180127	7203
20180211	경인선	간석	3691	3511	20180214	7202
20180125	장항선	온양온천	3604	3598	20180128	7202
20180113	과천선	과천	4046	3155	20180116	7201
20180112	우이신설선	정릉	3792	3409	20180115	7201
20180121	6호선	효창공원앞	3770	3429	20180124	7199
20180129	경인선	도화	3732	3459	20180201	7191
20180127	경의선	금릉	3625	3566	20180130	7191
20180118	경인선	도원	3572	3619	20180121	7191
20180126	경부선	세류	3708	3481	20180129	7189
20180117	경강선	판교	3611	3576	20180120	7187
20180128	3호선	을지로3가	3618	3568	20180131	7186
20180208	경강선	판교	3593	3592	20180211	7185
20180128	경인선	간석	3611	3574	20180131	7185
20180114	과천선	대공원	3460	3721	20180117	7181
20180211	3호선	을지로3가	3499	3681	20180214	7180
20180130	경춘선	마석	3370	3809	20180202	7179
20180121	6호선	태릉입구	3339	3840	20180124	7179
20180118	경춘선	퇴계원	3721	3453	20180121	7174
20180115	경춘선	퇴계원	3753	3421	20180118	7174
20180128	5호선	신금호	3460	3713	20180131	7173
20180122	수인선	숭의	3716	3455	20180125	7171
20180115	경의선	서울역	3260	3911	20180118	7171
20180204	경부선	서정리	3124	4043	20180207	7167
20180124	수인선	호구포	3517	3647	20180127	7164
20180121	5호선	마천	3422	3742	20180124	7164
20180130	경강선	판교	3614	3549	20180202	7163
20180118	9호선	구반포	3443	3720	20180121	7163
20180115	경춘선	마석	3558	3603	20180118	7161
20180112	경의선	서울역	3161	4000	20180115	7161
20180122	경춘선	퇴계원	3744	3415	20180125	7159
20180112	경부선	신도림	3558	3597	20180115	7155
20180131	경의선	서울역	3075	4079	20180203	7154
20180115	중앙선	양평	3594	3557	20180118	7151
20180204	3호선	오금	3734	3416	20180207	7150
20180212	경강선	판교	3603	3544	20180215	7147
20180212	6호선	창신	3980	3167	20180215	7147
20180121	5호선	왕십리(성동구청)	3192	3955	20180124	7147
20180208	수인선	숭의	3672	3473	20180211	7145
20180118	경의선	서울역	3171	3974	20180121	7145
20180112	경인선	도화	3759	3385	20180115	7144
20180203	분당선	매탄권선	3740	3403	20180206	7143
20180117	경부선	서울역	6130	1013	20180120	7143
20180131	경춘선	마석	3633	3508	20180203	7141
20180129	안산선	초지	3590	3551	20180201	7141
20180114	3호선	을지로3가	3633	3506	20180117	7139
20180117	경춘선	사릉	3633	3505	20180120	7138
20180118	6호선	창신	3983	3152	20180121	7135
20180208	경의선	서울역	3049	4085	20180211	7134
20180205	경부선	세류	3710	3424	20180208	7134
20180115	경춘선	사릉	3691	3441	20180118	7132
20180112	9호선	신반포	3504	3628	20180115	7132
20180128	3호선	경찰병원	3480	3650	20180131	7130
20180112	수인선	소래포구	3683	3447	20180115	7130
20180115	수인선	숭의	3709	3420	20180118	7129
20180201	경강선	판교	3562	3563	20180204	7125
20180204	8호선	산성	3542	3582	20180207	7124
20180117	중앙선	양평	3555	3569	20180120	7124
20180206	안산선	초지	3644	3479	20180209	7123
20180130	경의선	서울역	3223	3900	20180202	7123
20180128	중앙선	중랑	3568	3549	20180131	7117
20180114	우이신설선	북한산보국문	3793	3323	20180117	7116
20180123	경의선	능곡	3749	3365	20180126	7114
20180128	경부선	당정	3572	3539	20180131	7111
20180125	9호선	신반포	3514	3588	20180128	7102
20180131	중앙선	양평	3550	3551	20180203	7101
20180120	경의선	야당	3712	3389	20180123	7101
20180124	안산선	대야미	3735	3365	20180127	7100
20180131	경춘선	사릉	3591	3506	20180203	7097
20180119	경인선	도원	3508	3588	20180122	7096
20180201	경의선	서울역	3004	4091	20180204	7095
20180120	경원선	한남	3533	3562	20180123	7095
20180204	경강선	경기광주	3512	3580	20180207	7092
20180204	9호선	증미	3433	3657	20180207	7090
20180122	경강선	판교	3603	3487	20180125	7090
20180125	우이신설선	정릉	3640	3448	20180128	7088
20180123	경인선	도화	3648	3439	20180126	7087
20180120	안산선	초지	3725	3362	20180123	7087
20180120	우이신설선	성신여대입구(돈암)	3431	3654	20180123	7085
20180206	경원선	동두천중앙	3653	3431	20180209	7084
20180122	6호선	창신	3822	3262	20180125	7084
20180128	6호선	월드컵경기장(성산)	3433	3649	20180131	7082
20180112	경부선	성환	3818	3264	20180115	7082
20180204	3호선	을지로3가	3578	3501	20180207	7079
20180201	수인선	숭의	3659	3418	20180204	7077
20180117	9호선	구반포	3442	3635	20180120	7077
20180129	경부선	신도림	3622	3454	20180201	7076
20180114	3호선	오금	3551	3525	20180117	7076
20180118	경강선	판교	3555	3517	20180121	7072
20180204	6호선	효창공원앞	3661	3409	20180207	7070
20180203	경원선	녹천	3878	3188	20180206	7066
20180201	경춘선	마석	3449	3617	20180204	7066
20180212	경부선	서울역	5797	1268	20180215	7065
20180118	경춘선	사릉	3590	3474	20180121	7064
20180125	우이신설선	성신여대입구(돈암)	3503	3557	20180128	7060
20180112	경강선	판교	3538	3518	20180115	7056
20180127	경의선	가좌	3609	3446	20180130	7055
20180207	경강선	판교	3551	3503	20180210	7054
20180113	경원선	소요산	3955	3098	20180116	7053
20180129	경부선	세류	3658	3392	20180201	7050
20180204	수인선	인천논현	3467	3580	20180207	7047
20180129	경의선	능곡	3727	3319	20180201	7046
20180113	9호선	선유도	3628	3418	20180116	7046
20180129	경원선	동두천중앙	3658	3384	20180201	7042
20180206	경부선	세류	3578	3462	20180209	7040
20180207	경의선	서울역	3025	4012	20180210	7037
20180114	3호선	경찰병원	3500	3537	20180117	7037
20180114	6호선	태릉입구	3224	3809	20180117	7033
20180114	경의선	백마	3627	3406	20180117	7033
20180123	9호선	신반포	3480	3551	20180126	7031
20180121	분당선	강남구청	3208	3821	20180124	7029
20180206	경의선	능곡	3653	3374	20180209	7027
20180120	분당선	신갈	3552	3475	20180123	7027
20180129	6호선	창신	3894	3131	20180201	7025
20180129	수인선	소래포구	3675	3347	20180201	7022
20180208	경부선	성환	3486	3533	20180211	7019
20180114	8호선	신흥	3418	3600	20180117	7018
20180127	5호선	을지로4가	3218	3796	20180130	7014
20180120	9호선	노들	3863	3148	20180123	7011
20180201	9호선	구반포	3424	3584	20180204	7008
20180211	6호선	상월곡(한국과학기술연구원)	3682	3322	20180214	7004
20180131	9호선	구반포	3390	3614	20180203	7004
20180127	경원선	월계	3694	3306	20180130	7000
20180117	경춘선	퇴계원	3669	3330	20180120	6999
20180125	안산선	초지	3526	3472	20180128	6998
20180114	5호선	마천	3310	3682	20180117	6992
20180211	8호선	산성	3516	3472	20180214	6988
20180127	7호선	삼산체육관	3651	3337	20180130	6988
20180205	수인선	소래포구	3653	3333	20180208	6986
20180121	경의선	백마	3541	3445	20180124	6986
20180206	수인선	소래포구	3592	3391	20180209	6983
20180121	8호선	신흥	3393	3590	20180124	6983
20180113	경의선	야당	3683	3298	20180116	6981
20180114	경춘선	평내호평	3579	3400	20180117	6979
20180114	5호선	신금호	3371	3607	20180117	6978
20180204	5호선	마천	3322	3655	20180207	6977
20180114	분당선	강남구청	3102	3874	20180117	6976
20180207	수인선	숭의	3580	3395	20180210	6975
20180125	경부선	서울역	5973	1002	20180128	6975
20180211	경부선	당정	3482	3491	20180214	6973
20180211	8호선	신흥	3326	3646	20180214	6972
20180204	중앙선	중랑	3627	3344	20180207	6971
20180114	공항철도 1호선	디지털미디어시티	3536	3432	20180117	6968
20180131	경춘선	퇴계원	3661	3306	20180203	6967
20180124	우이신설선	정릉	3593	3374	20180127	6967
20180204	경인선	간석	3546	3414	20180207	6960
20180130	분당선	개포동	3373	3587	20180202	6960
20180124	우이신설선	성신여대입구(돈암)	3495	3465	20180127	6960
20180121	우이신설선	북한산보국문	3677	3278	20180124	6955
20180129	9호선	신반포	3458	3494	20180201	6952
20180115	경인선	도원	3460	3490	20180118	6950
20180119	9호선	공항시장	3271	3675	20180122	6946
20180122	경부선	성환	3339	3604	20180125	6943
20180115	6호선	창신	3911	3031	20180118	6942
20180127	5호선	양평	3535	3406	20180130	6941
20180126	경강선	판교	3471	3470	20180129	6941
20180119	6호선	창신	3887	3054	20180122	6941
20180131	분당선	대모산입구	3621	3316	20180203	6937
20180130	수인선	숭의	3605	3329	20180202	6934
20180204	5호선	개롱	3328	3601	20180207	6929
20180204	9호선2단계	언주	3591	3337	20180207	6928
20180121	9호선	증미	3404	3522	20180124	6926
20180212	경춘선	사릉	3564	3358	20180215	6922
20180211	분당선	강남구청	3154	3768	20180214	6922
20180121	6호선	상월곡(한국과학기술연구원)	3660	3260	20180124	6920
20180123	수인선	소래포구	3607	3310	20180126	6917
20180127	경부선	세류	3529	3387	20180130	6916
20180130	경인선	도원	3491	3424	20180202	6915
20180208	6호선	독바위	3370	3542	20180211	6912
20180125	6호선	창신	3770	3140	20180128	6910
20180121	4호선	삼각지	2904	4002	20180124	6906
20180126	9호선	신반포	3438	3467	20180129	6905
20180117	9호선	공항시장	3200	3704	20180120	6904
20180208	경춘선	퇴계원	3610	3292	20180211	6902
20180126	경의선	서울역	2943	3959	20180129	6902
20180206	분당선	개포동	3362	3536	20180209	6898
20180123	경원선	동두천중앙	3518	3379	20180126	6897
20180206	경강선	판교	3495	3401	20180209	6896
20180115	경강선	판교	3575	3321	20180118	6896
20180125	경부선	신도림	3510	3384	20180128	6894
20180211	5호선	개롱	3328	3565	20180214	6893
20180130	경춘선	퇴계원	3468	3423	20180202	6891
20180205	경강선	판교	3514	3376	20180208	6890
20180201	중앙선	양평	3348	3540	20180204	6888
20180121	경인선	구일	3439	3449	20180124	6888
20180130	분당선	대모산입구	3496	3378	20180202	6874
20180123	경부선	신도림	3492	3380	20180126	6872
20180122	분당선	개포동	3359	3513	20180125	6872
20180204	3호선	경찰병원	3379	3490	20180207	6869
20180127	경의선	풍산	3544	3324	20180130	6868
20180127	우이신설선	솔샘	3667	3200	20180130	6867
20180201	경춘선	퇴계원	3536	3328	20180204	6864
20180203	9호선	노들	3693	3170	20180206	6863
20180115	경부선	성환	3308	3554	20180118	6862
20180122	9호선	구반포	3300	3561	20180125	6861
20180123	경강선	판교	3456	3404	20180126	6860
20180118	분당선	대모산입구	3589	3268	20180121	6857
20180212	수인선	숭의	3592	3264	20180215	6856
20180205	경춘선	사릉	3498	3356	20180208	6854
20180128	6호선	효창공원앞	3559	3294	20180131	6853
20180114	9호선	마곡나루	3365	3488	20180117	6853
20180203	경의선	야당	3584	3268	20180206	6852
20180208	경춘선	사릉	3516	3334	20180211	6850
20180204	7호선	반포	3381	3469	20180207	6850
20180205	수인선	숭의	3594	3255	20180208	6849
20180123	경의선	서울역	3072	3770	20180126	6842
20180128	8호선	산성	3431	3410	20180131	6841
20180122	분당선	대모산입구	3517	3321	20180125	6838
20180204	경부선	당정	3375	3461	20180207	6836
20180127	7호선	부천종합운동장	3625	3209	20180130	6834
20180126	6호선	창신	3825	3007	20180129	6832
20180129	경강선	판교	3458	3372	20180201	6830
20180117	경인선	인천	3878	2952	20180120	6830
20180128	경의선	백마	3479	3349	20180131	6828
20180114	6호선	상월곡(한국과학기술연구원)	3619	3209	20180117	6828
20180123	6호선	창신	3742	3085	20180126	6827
20180115	9호선	구반포	3285	3535	20180118	6820
20180128	5호선	개롱	3308	3510	20180131	6818
20180114	5호선	왕십리(성동구청)	3116	3702	20180117	6818
20180121	5호선	애오개	3374	3443	20180124	6817
20180205	경의선	서울역	2890	3925	20180208	6815
20180207	9호선	공항시장	3158	3656	20180210	6814
20180201	분당선	대모산입구	3491	3323	20180204	6814
20180129	경부선	성환	3321	3493	20180201	6814
20180115	9호선	공항시장	3134	3678	20180118	6812
20180121	5호선	개화산	3377	3431	20180124	6808
20180130	6호선	독바위	3234	3572	20180202	6806
20180205	9호선	구반포	3265	3538	20180208	6803
20180211	중앙선	중랑	3507	3293	20180214	6800
20180204	우이신설선	북한산보국문	3555	3245	20180207	6800
20180112	6호선	창신	3768	3029	20180115	6797
20180128	8호선	신흥	3270	3526	20180131	6796
20180211	5호선	신금호	3325	3470	20180214	6795
20180203	경원선	소요산	3794	3001	20180206	6795
20180203	과천선	대공원	3238	3556	20180206	6794
20180112	경의선	능곡	3546	3247	20180115	6793
20180207	경춘선	사릉	3466	3326	20180210	6792
20180129	경부선	서울역	5738	1052	20180201	6790
20180122	경부선	서울역	5729	1061	20180125	6790
20180212	경춘선	마석	3406	3379	20180215	6785
20180204	5호선	애오개	3318	3467	20180207	6785
20180123	중앙선	양평	3435	3346	20180126	6781
20180211	3호선	오금	3452	3327	20180214	6779
20180203	6호선	역촌	3163	3613	20180206	6776
20180128	5호선	여의나루	3239	3531	20180131	6770
20180120	3호선	무악재	3377	3393	20180123	6770
20180203	경원선	한남	3329	3439	20180206	6768
20180123	9호선	구반포	3232	3533	20180126	6765
20180126	경의선	능곡	3561	3198	20180129	6759
20180117	분당선	대모산입구	3528	3230	20180120	6758
20180212	경춘선	퇴계원	3587	3170	20180215	6757
20180114	경부선	성환	3116	3638	20180117	6754
20180114	9호선2단계	종합운동장	3799	2949	20180117	6748
20180114	9호선2단계	언주	3565	3183	20180117	6748
20180124	9호선	신반포	3350	3395	20180127	6745
20180113	9호선	노들	3624	3119	20180116	6743
20180121	7호선	반포	3341	3401	20180124	6742
20180201	경춘선	사릉	3431	3309	20180204	6740
20180120	6호선	역촌	3161	3579	20180123	6740
20180114	분당선	선릉	2249	4490	20180117	6739
20180129	경의선	서울역	2826	3910	20180201	6736
20180125	경의선	능곡	3515	3221	20180128	6736
20180118	9호선	공항시장	3134	3601	20180121	6735
20180127	수인선	인하대	3534	3200	20180130	6734
20180125	경인선	도화	3517	3215	20180128	6732
20180208	분당선	개포동	3337	3393	20180211	6730
20180129	경인선	도원	3349	3379	20180201	6728
20180211	5호선	애오개	3283	3443	20180214	6726
20180203	분당선	신갈	3420	3305	20180206	6725
20180121	분당선	상갈	3300	3424	20180124	6724
20180131	과천선	대공원	3196	3527	20180203	6723
20180130	9호선	공항시장	3100	3622	20180202	6722
20180120	경부선	신도림	3130	3592	20180123	6722
20180212	9호선	공항시장	3128	3591	20180215	6719
20180120	경춘선	남춘천	3349	3367	20180123	6716
20180120	경원선	이촌(국립중앙박물관)	3763	2953	20180123	6716
20180126	경부선	신도림	3419	3296	20180129	6715
20180124	6호선	창신	3670	3040	20180127	6710
20180211	경의선	백마	3457	3252	20180214	6709
20180207	경춘선	마석	3368	3338	20180210	6706
20180124	안산선	초지	3390	3316	20180127	6706
20180120	안산선	대야미	3675	3030	20180123	6705
20180206	수인선	숭의	3492	3212	20180209	6704
20180124	경인선	도화	3497	3206	20180127	6703
20180114	5호선	애오개	3366	3337	20180117	6703
20180211	경강선	경기광주	3259	3441	20180214	6700
20180123	경부선	서울역	5726	974	20180126	6700
20180123	경춘선	마석	3353	3345	20180126	6698
20180122	9호선	공항시장	3125	3572	20180125	6697
20180121	수인선	원인재	3316	3381	20180124	6697
20180114	5호선	개화산	3353	3344	20180117	6697
20180121	경부선	성환	3036	3658	20180124	6694
20180128	경원선	소요산	3602	3091	20180131	6693
20180207	분당선	대모산입구	3477	3215	20180210	6692
20180211	9호선2단계	언주	3559	3132	20180214	6691
20180122	6호선	독바위	3256	3431	20180125	6687
20180128	5호선	마천	3227	3459	20180131	6686
20180124	경부선	세류	3435	3251	20180127	6686
20180119	6호선	독바위	3371	3313	20180122	6684
20180211	5호선	마천	3209	3471	20180214	6680
20180114	분당선	상갈	3305	3374	20180117	6679
20180204	2호선	한양대	3100	3578	20180207	6678
20180208	분당선	대모산입구	3451	3226	20180211	6677
20180128	3호선	오금	3407	3269	20180131	6676
20180126	경인선	도화	3512	3163	20180129	6675
20180201	6호선	독바위	3298	3376	20180204	6674
20180126	분당선	개포동	3250	3419	20180129	6669
20180122	경인선	도원	3310	3357	20180125	6667
20180201	분당선	개포동	3248	3418	20180204	6666
20180203	3호선	무악재	3263	3401	20180206	6664
20180130	경부선	서울역	5591	1072	20180202	6663
20180131	9호선	공항시장	3093	3568	20180203	6661
20180127	경원선	녹양	3544	3117	20180130	6661
20180127	분당선	구성	3316	3344	20180130	6660
20180125	9호선	구반포	3159	3501	20180128	6660
20180124	분당선	개포동	3270	3389	20180127	6659
20180119	경원선	소요산	3619	3039	20180122	6658
20180204	분당선	선릉	2118	4537	20180207	6655
20180211	7호선	반포	3345	3309	20180214	6654
20180211	6호선	태릉입구	3137	3511	20180214	6648
20180124	경부선	신도림	3363	3285	20180127	6648
20180203	경원선	동두천중앙	3427	3220	20180206	6647
20180211	3호선	경찰병원	3320	3324	20180214	6644
20180205	경춘선	마석	3297	3347	20180208	6644
20180128	우이신설선	북한산보국문	3462	3179	20180131	6641
20180129	경춘선	사릉	3376	3264	20180201	6640
20180128	9호선2단계	언주	3505	3135	20180131	6640
20180114	4호선	삼각지	2814	3826	20180117	6640
20180212	분당선	대모산입구	3455	3184	20180215	6639
20180128	5호선	애오개	3222	3411	20180131	6633
20180115	분당선	대모산입구	3493	3139	20180118	6632
20180212	분당선	개포동	3194	3435	20180215	6629
20180121	9호선2단계	언주	3508	3118	20180124	6626
20180205	경부선	성환	3147	3478	20180208	6625
20180118	분당선	개포동	3205	3418	20180121	6623
20180128	경춘선	평내호평	3443	3177	20180131	6620
20180126	안산선	초지	3428	3191	20180129	6619
20180123	경춘선	사릉	3392	3225	20180126	6617
20180127	8호선	모란	3623	2993	20180130	6616
20180113	경부선	성환	3579	3036	20180116	6615
20180204	5호선	왕십리(성동구청)	3021	3593	20180207	6614
20180113	경원선	동두천중앙	3352	3262	20180116	6614
20180113	경원선	한남	3275	3336	20180116	6611
20180205	경춘선	퇴계원	3459	3151	20180208	6610
20180205	중앙선	양평	3350	3259	20180208	6609
20180113	분당선	청명	3441	3165	20180116	6606
20180206	9호선	공항시장	3030	3575	20180209	6605
20180125	경부선	세류	3456	3144	20180128	6600
20180124	경의선	능곡	3454	3142	20180127	6596
20180117	6호선	독바위	3243	3351	20180120	6594
20180205	6호선	독바위	3217	3376	20180208	6593
20180112	경원선	동두천중앙	3367	3226	20180115	6593
20180112	분당선	개포동	3246	3346	20180115	6592
20180113	3호선	무악재	3282	3307	20180116	6589
20180212	경부선	성환	3226	3362	20180215	6588
20180129	분당선	개포동	3244	3344	20180201	6588
20180204	6호선	상월곡(한국과학기술연구원)	3468	3118	20180207	6586
20180124	경강선	판교	3347	3239	20180127	6586
20180205	9호선	공항시장	3083	3500	20180208	6583
20180128	6호선	상월곡(한국과학기술연구원)	3477	3103	20180131	6580
20180129	수인선	숭의	3355	3218	20180201	6573
20180112	9호선	구반포	3228	3345	20180115	6573
20180115	분당선	개포동	3193	3379	20180118	6572
20180204	5호선	마장	3349	3221	20180207	6570
20180206	경의선	서울역	2813	3755	20180209	6568
20180126	9호선	구반포	3191	3377	20180129	6568
20180121	2호선	한양대	3142	3423	20180124	6565
20180129	분당선	대모산입구	3382	3180	20180201	6562
20180204	5호선	신금호	3171	3383	20180207	6554
20180201	9호선	공항시장	3079	3475	20180204	6554
20180201	경부선	성환	3291	3262	20180204	6553
20180119	경의선	공덕	3373	3178	20180122	6551
20180126	수인선	소래포구	3365	3182	20180129	6547
20180125	경강선	판교	3302	3245	20180128	6547
20180125	경의선	서울역	2849	3692	20180128	6541
20180205	분당선	대모산입구	3361	3179	20180208	6540
20180118	6호선	독바위	3212	3328	20180121	6540
20180204	경부선	서울역	5832	707	20180207	6539
20180203	경원선	이촌(국립중앙박물관)	3743	2796	20180206	6539
20180129	9호선	구반포	3178	3361	20180201	6539
20180127	우이신설선	성신여대입구(돈암)	3231	3308	20180130	6539
20180204	5호선	여의나루	3083	3455	20180207	6538
20180212	중앙선	양평	3333	3202	20180215	6535
20180207	경춘선	퇴계원	3390	3143	20180210	6533
20180207	중앙선	양평	3216	3316	20180210	6532
20180212	6호선	독바위	3226	3304	20180215	6530
20180118	경부선	성환	3243	3285	20180121	6528
20180127	9호선	선유도	3281	3246	20180130	6527
20180129	경춘선	퇴계원	3432	3091	20180201	6523
20180127	9호선	개화	3786	2732	20180130	6518
20180131	경부선	서울역	5504	1011	20180203	6515
20180128	6호선	태릉입구	3074	3437	20180131	6511
20180206	경춘선	사릉	3288	3222	20180209	6510
20180204	분당선	상갈	3233	3272	20180207	6505
20180123	9호선	공항시장	2967	3538	20180126	6505
20180131	경인선	인천	3702	2801	20180203	6503
20180121	5호선	마장	3287	3216	20180124	6503
20180211	우이신설선	북한산보국문	3450	3052	20180214	6502
20180128	5호선	왕십리(성동구청)	2985	3517	20180131	6502
20180127	9호선	노들	3529	2973	20180130	6502
20180125	경원선	동두천중앙	3333	3169	20180128	6502
20180125	6호선	독바위	3180	3322	20180128	6502
20180131	경의선	공덕	3447	3054	20180203	6501
20180114	경인선	인천	3564	2937	20180117	6501
20180123	수인선	숭의	3312	3188	20180126	6500
20180206	6호선	독바위	3193	3304	20180209	6497
20180113	6호선	역촌	3075	3422	20180116	6497
20180113	경원선	이촌(국립중앙박물관)	3670	2827	20180116	6497
20180203	안산선	대야미	3554	2940	20180206	6494
20180131	6호선	독바위	3242	3252	20180203	6494
20180208	9호선	공항시장	3011	3480	20180211	6491
20180129	경춘선	마석	3220	3270	20180201	6490
20180121	안산선	반월	3255	3233	20180124	6488
20180112	경춘선	사릉	3326	3161	20180115	6487
20180207	경부선	성환	3283	3203	20180210	6486
20180204	6호선	태릉입구	3051	3435	20180207	6486
20180120	분당선	청명	3321	3165	20180123	6486
20180124	경원선	동두천중앙	3311	3174	20180127	6485
20180130	중앙선	양평	3193	3289	20180202	6482
20180204	경의선	백마	3358	3123	20180207	6481
20180114	수인선	원인재	3146	3335	20180117	6481
20180123	분당선	개포동	3166	3310	20180126	6476
20180114	7호선	반포	3255	3219	20180117	6474
20180126	9호선	공항시장	3024	3447	20180129	6471
20180123	분당선	대모산입구	3325	3144	20180126	6469
20180113	안산선	대야미	3539	2916	20180116	6455
20180211	5호선	개화산	3237	3214	20180214	6451
20180206	분당선	대모산입구	3291	3160	20180209	6451
20180118	경인선	인천	3611	2840	20180121	6451
20180127	수인선	소래포구	3175	3275	20180130	6450
20180211	7호선	삼산체육관	3246	3201	20180214	6447
20180127	분당선	매탄권선	3400	3039	20180130	6439
20180124	경부선	서울역	5486	952	20180127	6438
20180208	경부선	서울역	5368	1067	20180211	6435
20180117	경의선	공덕	3345	3088	20180120	6433
20180124	경의선	서울역	2814	3617	20180127	6431
20180123	경춘선	퇴계원	3318	3113	20180126	6431
20180128	5호선	개화산	3259	3170	20180131	6429
20180203	분당선	청명	3300	3127	20180206	6427
20180203	9호선2단계	삼성중앙	3211	3216	20180206	6427
20180127	경원선	녹천	3564	2860	20180130	6424
20180128	중앙선	양평	3250	3172	20180131	6422
20180121	9호선	마곡나루	3150	3267	20180124	6417
20180211	5호선	왕십리(성동구청)	2965	3450	20180214	6415
20180207	6호선	독바위	3122	3290	20180210	6412
20180115	경인선	인천	3617	2792	20180118	6409
20180211	분당선	상갈	3130	3268	20180214	6398
20180129	6호선	독바위	3107	3288	20180201	6395
20180119	수인선	송도	3287	3108	20180122	6395
20180204	9호선	마곡나루	3117	3269	20180207	6386
20180118	경의선	공덕	3296	3090	20180121	6386
20180211	4호선	삼각지	2713	3672	20180214	6385
20180115	중앙선	용문	3180	3203	20180118	6383
20180126	분당선	대모산입구	3350	3032	20180129	6382
20180125	수인선	소래포구	3321	3060	20180128	6381
20180129	9호선	공항시장	2913	3466	20180201	6379
20180121	경원선	월계	3296	3082	20180124	6378
20180124	9호선	구반포	3071	3305	20180127	6376
20180113	경인선	도화	3328	3047	20180116	6375
20180204	경춘선	평내호평	3297	3075	20180207	6372
20180117	경부선	성환	3194	3172	20180120	6366
20180122	경인선	인천	3556	2806	20180125	6362
20180130	우이신설선	화계	3035	3325	20180202	6360
20180115	6호선	독바위	3144	3216	20180118	6360
20180205	분당선	개포동	3097	3262	20180208	6359
20180126	경부선	성환	3351	3006	20180129	6357
20180131	경부선	성환	3193	3163	20180203	6356
20180206	경춘선	마석	3196	3159	20180209	6355
20180112	수인선	숭의	3354	2998	20180115	6352
20180123	6호선	독바위	3104	3243	20180126	6347
20180128	9호선2단계	종합운동장	3572	2771	20180131	6343
20180120	경춘선	마석	3251	3092	20180123	6343
20180117	수인선	송도	3206	3136	20180120	6342
20180126	경원선	동두천중앙	3214	3127	20180129	6341
20180114	경부선	세류	3163	3175	20180117	6338
20180208	9호선	사평	3251	3086	20180211	6337
20180131	우이신설선	화계	3214	3121	20180203	6335
20180117	공항철도 1호선	공항화물청사	2954	3378	20180120	6332
20180121	경부선	세류	3136	3194	20180124	6330
20180201	우이신설선	화계	3209	3117	20180204	6326
20180131	공항철도 1호선	공항화물청사	2960	3365	20180203	6325
20180128	수인선	원인재	3040	3284	20180131	6324
20180112	경춘선	마석	3139	3182	20180115	6321
20180114	안산선	반월	3199	3118	20180117	6317
20180128	분당선	선릉	2061	4254	20180131	6315
20180212	경인선	도원	3173	3136	20180215	6309
20180206	경춘선	퇴계원	3233	3076	20180209	6309
20180204	5호선	개화산	3187	3122	20180207	6309
20180112	경춘선	퇴계원	3285	3021	20180115	6306
20180124	수인선	소래포구	3300	3001	20180127	6301
20180112	9호선	공항시장	2958	3343	20180115	6301
20180113	경춘선	남춘천	2965	3335	20180116	6300
20180121	분당선	선릉	2076	4221	20180124	6297
20180124	9호선	공항시장	2897	3395	20180127	6292
20180120	안산선	수리산	3408	2884	20180123	6292
20180211	수인선	원인재	3094	3195	20180214	6289
20180114	경의선	운정	3189	3100	20180117	6289
20180113	경부선	신도림	2922	3367	20180116	6289
20180120	경인선	도화	3338	2949	20180123	6287
20180114	5호선	마장	3177	3107	20180117	6284
20180122	경의선	공덕	3287	2994	20180125	6281
20180207	공항철도 1호선	공항화물청사	3003	3276	20180210	6279
20180128	7호선	반포	3118	3156	20180131	6274
20180118	공항철도 1호선	공항화물청사	2948	3326	20180121	6274
20180127	과천선	과천	3524	2748	20180130	6272
20180130	경부선	성환	3143	3127	20180202	6270
20180120	경의선	능곡	3181	3089	20180123	6270
20180208	경인선	인천	3567	2701	20180211	6268
20180204	경원선	월계	3208	3059	20180207	6267
20180201	공항철도 1호선	공항화물청사	2915	3352	20180204	6267
20180120	우이신설선	정릉	3414	2848	20180123	6262
20180115	경의선	공덕	3208	3054	20180118	6262
20180121	공항철도 1호선	청라국제도시	3126	3131	20180124	6257
20180203	경인선	인천	3312	2944	20180206	6256
20180203	경부선	성환	3364	2891	20180206	6255
20180121	경의선	금릉	3080	3173	20180124	6253
20180113	경춘선	마석	3118	3135	20180116	6253
20180126	6호선	독바위	3114	3135	20180129	6249
20180112	분당선	대모산입구	3275	2973	20180115	6248
20180206	공항철도 1호선	공항화물청사	2931	3304	20180209	6235
20180121	경의선	운정	3176	3059	20180124	6235
20180114	8호선	송파	3118	3115	20180117	6233
20180125	9호선	공항시장	2888	3344	20180128	6232
20180113	우이신설선	정릉	3380	2852	20180116	6232
20180201	경의선	공덕	3244	2984	20180204	6228
20180205	경부선	서울역	5155	1072	20180208	6227
20180211	6호선	월드컵경기장(성산)	3027	3198	20180214	6225
20180128	2호선	한양대	2966	3259	20180131	6225
20180207	경의선	공덕	3304	2915	20180210	6219
20180125	수인선	숭의	3216	2999	20180128	6215
20180124	분당선	대모산입구	3247	2963	20180127	6210
20180208	경의선	공덕	3313	2891	20180211	6204
20180128	경의선	운정	3144	3053	20180131	6197
20180119	공항철도 1호선	공항화물청사	2937	3260	20180122	6197
20180126	경춘선	퇴계원	3253	2942	20180129	6195
20180125	분당선	대모산입구	3172	3022	20180128	6194
20180203	우이신설선	정릉	3309	2881	20180206	6190
20180201	경인선	인천	3490	2698	20180204	6188
20180208	우이신설선	화계	3200	2979	20180211	6179
20180119	장항선	아산	3237	2940	20180122	6177
20180112	중앙선	양평	3053	3123	20180115	6176
20180204	4호선	삼각지	2679	3496	20180207	6175
20180130	공항철도 1호선	공항화물청사	2885	3287	20180202	6172
20180127	분당선	신갈	3145	3025	20180130	6170
20180203	9호선	샛강	3027	3142	20180206	6169
20180126	경춘선	사릉	3177	2991	20180129	6168
20180127	6호선	역촌	2923	3242	20180130	6165
20180114	경의선	금릉	3064	3095	20180117	6159
20180207	우이신설선	화계	3096	3059	20180210	6155
20180211	경원선	소요산	3310	2841	20180214	6151
20180204	경원선	소요산	3284	2866	20180207	6150
20180203	경춘선	마석	3065	3082	20180206	6147
20180201	경부선	서울역	5130	1017	20180204	6147
20180130	경의선	공덕	3205	2940	20180202	6145
20180212	경의선	공덕	3210	2931	20180215	6141
20180115	공항철도 1호선	공항화물청사	2851	3288	20180118	6139
20180127	경의선	야당	3158	2971	20180130	6129
20180124	6호선	독바위	2941	3188	20180127	6129
20180125	경춘선	사릉	3140	2988	20180128	6128
20180114	수인선	인하대	3111	3016	20180117	6127
20180203	경인선	도화	3201	2924	20180206	6125
20180211	경부선	서울역	5237	882	20180214	6119
20180208	공항철도 1호선	공항화물청사	2887	3231	20180211	6118
20180121	경의선	풍산	3116	3000	20180124	6116
20180128	4호선	삼각지	2570	3544	20180131	6114
20180207	경부선	서울역	5124	989	20180210	6113
20180123	경인선	도원	3032	3074	20180126	6106
20180119	경춘선	남춘천	2977	3127	20180122	6104
20180125	분당선	개포동	2925	3172	20180128	6097
20180127	3호선	무악재	3062	3033	20180130	6095
20180124	경춘선	사릉	3098	2997	20180127	6095
20180123	경부선	성환	3028	3066	20180126	6094
20180204	경인선	구일	3023	3067	20180207	6090
20180125	경춘선	퇴계원	3196	2894	20180128	6090
20180206	중앙선	양평	3039	3050	20180209	6089
20180121	9호선2단계	종합운동장	3379	2706	20180124	6085
20180205	경의선	공덕	3221	2863	20180208	6084
20180112	6호선	독바위	3027	3055	20180115	6082
20180203	3호선	학여울	2977	3104	20180206	6081
20180203	5호선	청구	3168	2912	20180206	6080
20180125	경춘선	마석	3026	3052	20180128	6078
20180128	5호선	마장	3094	2981	20180131	6075
20180130	경인선	인천	3418	2653	20180202	6071
20180212	우이신설선	화계	3066	3004	20180215	6070
20180126	경인선	도원	3035	3032	20180129	6067
20180205	공항철도 1호선	공항화물청사	2793	3273	20180208	6066
20180114	경원선	녹양	3121	2945	20180117	6066
20180112	경인선	도원	3028	3037	20180115	6065
20180211	경춘선	평내호평	3130	2931	20180214	6061
20180211	경원선	월계	3199	2857	20180214	6056
20180125	경인선	도원	3035	3021	20180128	6056
20180128	수인선	소래포구	3084	2971	20180131	6055
20180124	공항철도 1호선	공항화물청사	2815	3239	20180127	6054
20180128	경의선	풍산	3013	3040	20180131	6053
20180114	경원선	월계	3179	2874	20180117	6053
20180114	5호선	마곡	3083	2968	20180117	6051
20180128	9호선	마곡나루	2911	3135	20180131	6046
20180122	경춘선	남춘천	2935	3110	20180125	6045
20180129	중앙선	양평	3066	2975	20180201	6041
20180120	우이신설선	가오리	3173	2865	20180123	6038
20180203	우이신설선	가오리	3129	2908	20180206	6037
20180121	5호선	마곡	3054	2980	20180124	6034
20180112	경의선	공덕	3213	2821	20180115	6034
20180114	경원선	이촌(국립중앙박물관)	3427	2606	20180117	6033
20180122	공항철도 1호선	공항화물청사	2813	3218	20180125	6031
20180112	장항선	아산	3154	2876	20180115	6030
20180127	경원선	한남	2988	3041	20180130	6029
20180204	수인선	소래포구	3084	2943	20180207	6027
20180120	9호선2단계	삼성중앙	3026	2998	20180123	6024
20180119	분당선	매교	3059	2964	20180122	6023
20180120	5호선	청구	3221	2800	20180123	6021
20180206	경의선	공덕	3261	2759	20180209	6020
20180204	수인선	원인재	2988	3031	20180207	6019
20180201	경원선	소요산	3386	2629	20180204	6015
20180121	경의선	가좌	2979	3036	20180124	6015
20180212	공항철도 1호선	공항화물청사	2805	3209	20180215	6014
20180211	수인선	소래포구	3086	2924	20180214	6010
20180208	2호선	용두(동대문구청)	2928	3082	20180211	6010
20180206	우이신설선	화계	3005	3005	20180209	6010
20180203	안산선	수리산	3289	2720	20180206	6009
20180128	분당선	상갈	2917	3091	20180131	6008
20180115	경원선	소요산	3355	2653	20180118	6008
20180121	경원선	이촌(국립중앙박물관)	3449	2555	20180124	6004
20180114	경의선	풍산	3049	2951	20180117	6000
20180211	경인선	구일	3011	2986	20180214	5997
20180128	수인선	인하대	3053	2944	20180131	5997
20180211	경원선	녹양	3072	2919	20180214	5991
20180211	안산선	반월	2983	3008	20180214	5991
20180126	수인선	숭의	3151	2840	20180129	5991
20180207	9호선	사평	3039	2951	20180210	5990
20180212	경춘선	남춘천	2925	3059	20180215	5984
20180119	우이신설선	화계	3071	2913	20180122	5984
20180115	수인선	송도	3057	2924	20180118	5981
20180113	9호선	샛강	2930	3049	20180116	5979
20180117	경춘선	남춘천	2978	2996	20180120	5974
20180128	안산선	반월	2982	2990	20180131	5972
20180121	수인선	인하대	3035	2933	20180124	5968
20180113	우이신설선	가오리	3054	2914	20180116	5968
20180117	우이신설선	화계	3001	2966	20180120	5967
20180122	경의선	월롱	3401	2565	20180125	5966
20180208	경의선	수색	2961	3004	20180211	5965
20180120	9호선	샛강	2962	3002	20180123	5964
20180113	5호선	청구	3160	2799	20180116	5959
20180123	공항철도 1호선	공항화물청사	2762	3191	20180126	5953
20180117	경원선	소요산	3308	2645	20180120	5953
20180126	중앙선	양평	2968	2982	20180129	5950
20180113	안산선	수리산	3325	2624	20180116	5949
20180120	9호선	구반포	2897	3050	20180123	5947
20180125	공항철도 1호선	공항화물청사	2723	3223	20180128	5946
20180124	경춘선	마석	2949	2997	20180127	5946
20180211	경의선	운정	3012	2931	20180214	5943
20180204	3호선	학여울	2893	3050	20180207	5943
20180123	경의선	공덕	3153	2786	20180126	5939
20180115	우이신설선	화계	2955	2981	20180118	5936
20180112	공항철도 1호선	공항화물청사	2819	3114	20180115	5933
20180127	분당선	청명	3099	2833	20180130	5932
20180118	우이신설선	화계	2968	2961	20180121	5929
20180211	9호선	마곡나루	2937	2987	20180214	5924
20180127	경부선	성환	3233	2689	20180130	5922
20180129	경의선	공덕	3102	2818	20180201	5920
20180121	분당선	도곡	2974	2946	20180124	5920
20180124	경춘선	퇴계원	3097	2822	20180127	5919
20180122	우이신설선	화계	2912	3007	20180125	5919
20180201	경의선	수색	2945	2972	20180204	5917
20180118	과천선	대공원	2858	3059	20180121	5917
20180205	우이신설선	화계	3003	2911	20180208	5914
20180203	경의선	능곡	2977	2926	20180206	5903
20180117	공항철도 1호선	인천공항2터미널	3100	2800	20180120	5900
20180128	경의선	금릉	2981	2911	20180131	5892
20180126	경춘선	마석	2935	2957	20180129	5892
20180212	2호선	용두(동대문구청)	2875	3014	20180215	5889
20180204	분당선	도곡	2897	2985	20180207	5882
20180122	경원선	소요산	3338	2542	20180125	5880
20180114	분당선	도곡	2933	2944	20180117	5877
20180121	3호선	잠원	2879	2997	20180124	5876
20180128	경부선	성환	2687	3187	20180131	5874
20180119	경의선	수색	2920	2954	20180122	5874
20180113	경인선	도원	2973	2897	20180116	5870
20180124	수인선	숭의	3065	2804	20180127	5869
20180201	9호선	사평	2951	2912	20180204	5863
20180113	안산선	초지	3257	2606	20180116	5863
20180211	9호선2단계	종합운동장	3237	2624	20180214	5861
20180128	경인선	구일	2920	2941	20180131	5861
20180122	수인선	송도	3014	2847	20180125	5861
20180118	수인선	송도	3011	2850	20180121	5861
20180203	경춘선	남춘천	2937	2921	20180206	5858
20180127	안산선	대야미	3134	2722	20180130	5856
20180203	경부선	신도림	2733	3121	20180206	5854
20180127	경원선	이촌(국립중앙박물관)	3351	2502	20180130	5853
20180120	6호선	청구	2792	3058	20180123	5850
20180118	경원선	소요산	3300	2549	20180121	5849
20180130	2호선	용두(동대문구청)	2900	2945	20180202	5845
20180128	경부선	세류	2846	2998	20180131	5844
20180113	9호선	구반포	2825	3016	20180116	5841
20180204	9호선2단계	종합운동장	3212	2618	20180207	5830
20180128	9호선2단계	선정릉	2848	2982	20180131	5830
20180206	9호선	사평	2927	2902	20180209	5829
20180211	경의선	가좌	2959	2867	20180214	5826
20180211	경부선	성환	2631	3190	20180214	5821
20180128	경인선	인천	3217	2604	20180131	5821
20180113	장항선	아산	3029	2792	20180116	5821
20180211	경부선	세류	2859	2956	20180214	5815
20180211	분당선	선릉	1899	3916	20180214	5815
20180121	7호선	부천종합운동장	3022	2789	20180124	5811
20180204	안산선	반월	2865	2943	20180207	5808
20180129	공항철도 1호선	공항화물청사	2677	3128	20180201	5805
20180128	분당선	도곡	2830	2973	20180131	5803
20180204	경부선	세류	2827	2974	20180207	5801
20180211	8호선	송파	2862	2938	20180214	5800
20180113	경의선	능곡	2932	2868	20180116	5800
20180211	수인선	인하대	2928	2867	20180214	5795
20180128	공항철도 1호선	청라국제도시	2872	2920	20180131	5792
20180118	경의선	수색	2842	2950	20180121	5792
20180201	수인선	송도	2939	2849	20180204	5788
20180130	9호선	사평	2843	2940	20180202	5783
20180201	분당선	보정	3116	2663	20180204	5779
20180205	9호선	사평	2948	2822	20180208	5770
20180131	분당선	보정	3165	2605	20180203	5770
20180211	경의선	금릉	2881	2888	20180214	5769
20180123	경의선	수색	2860	2909	20180126	5769
20180204	경원선	녹양	2995	2772	20180207	5767
20180126	공항철도 1호선	공항화물청사	2697	3070	20180129	5767
20180121	9호선	노들	2999	2767	20180124	5766
20180206	경부선	서울역	4779	985	20180209	5764
20180126	경의선	공덕	3038	2723	20180129	5761
20180131	9호선	사평	3018	2742	20180203	5760
20180124	경부선	성환	2878	2882	20180127	5760
20180212	9호선	사평	2891	2868	20180215	5759
20180114	공항철도 1호선	청라국제도시	2869	2883	20180117	5752
20180120	장항선	아산	2907	2844	20180123	5751
20180212	경인선	인천	3240	2508	20180215	5748
20180130	중앙선	용문	2876	2870	20180202	5746
20180125	중앙선	양평	2862	2881	20180128	5743
20180211	경원선	이촌(국립중앙박물관)	3232	2506	20180214	5738
20180121	7호선	삼산체육관	2990	2747	20180124	5737
20180122	9호선	사평	2834	2902	20180125	5736
20180117	우이신설선	북한산우이	2960	2776	20180120	5736
20180119	분당선	보정	3216	2519	20180122	5735
20180117	분당선	보정	3140	2595	20180120	5735
20180131	경의선	수색	2750	2981	20180203	5731
20180204	3호선	잠원	2817	2911	20180207	5728
20180121	8호선	송파	2832	2895	20180124	5727
20180119	2호선	용답	2878	2848	20180122	5726
20180120	수인선	호구포	2912	2813	20180123	5725
20180204	9호선2단계	선정릉	2810	2911	20180207	5721
20180114	3호선	잠원	2834	2887	20180117	5721
20180211	5호선	마곡	2919	2800	20180214	5719
20180121	경원선	녹천	3076	2643	20180124	5719
20180211	3호선	잠원	2823	2893	20180214	5716
20180119	경의선	월롱	3286	2429	20180122	5715
20180127	경원선	동두천중앙	2934	2780	20180130	5714
20180121	3호선	도곡	2844	2867	20180124	5711
20180208	2호선	용답	2858	2851	20180211	5709
20180211	9호선	증미	2822	2886	20180214	5708
20180127	경원선	소요산	3157	2550	20180130	5707
20180204	경부선	성환	2580	3126	20180207	5706
20180211	9호선2단계	선정릉	2789	2916	20180214	5705
20180114	경의선	가좌	2836	2868	20180117	5704
20180119	경부선	세마	3040	2663	20180122	5703
20180119	9호선	사평	2959	2744	20180122	5703
20180131	수인선	송도	2929	2772	20180203	5701
20180121	우이신설선	솔샘	2912	2787	20180124	5699
20180204	3호선	도곡	2746	2948	20180207	5694
20180117	경의선	수색	2787	2905	20180120	5692
20180130	수인선	송도	2867	2824	20180202	5691
20180203	6호선	청구	2788	2902	20180206	5690
20180120	9호선	신반포	2847	2841	20180123	5688
20180117	분당선	매교	2869	2819	20180120	5688
20180130	6호선	버티고개	2942	2742	20180202	5684
20180114	과천선	과천	3058	2622	20180117	5680
20180128	경원선	녹양	2961	2717	20180131	5678
20180118	9호선	사평	2880	2796	20180121	5676
20180128	3호선	잠원	2790	2883	20180131	5673
20180113	9호선2단계	삼성중앙	2813	2859	20180116	5672
20180211	경의선	풍산	2905	2763	20180214	5668
20180208	수인선	송도	2914	2753	20180211	5667
20180118	분당선	매교	2865	2802	20180121	5667
20180120	6호선	약수	2865	2800	20180123	5665
20180120	경인선	도원	2840	2825	20180123	5665
20180124	경의선	공덕	3091	2572	20180127	5663
20180207	분당선	보정	3108	2554	20180210	5662
20180117	경의선	효창공원앞	2712	2950	20180120	5662
20180117	9호선	사평	2891	2765	20180120	5656
20180204	경의선	운정	2840	2815	20180207	5655
20180127	우이신설선	정릉	3096	2558	20180130	5654
20180201	분당선	매교	2826	2826	20180204	5652
20180113	6호선	약수	2837	2814	20180116	5651
20180129	우이신설선	화계	2809	2836	20180201	5645
20180128	과천선	과천	3101	2541	20180131	5642
20180211	분당선	도곡	2808	2832	20180214	5640
20180128	경원선	월계	2934	2704	20180131	5638
20180208	분당선	보정	3079	2553	20180211	5632
20180127	경인선	인천	3040	2590	20180130	5630
20180203	6호선	약수	2857	2771	20180206	5628
20180121	경원선	동두천중앙	2888	2740	20180124	5628
20180114	분당선	구성	2628	3000	20180117	5628
20180124	경인선	도원	2785	2840	20180127	5625
20180121	분당선	구성	2733	2891	20180124	5624
20180115	경의선	효창공원앞	2702	2922	20180118	5624
20180128	9호선	증미	2796	2826	20180131	5622
20180207	수인선	송도	2954	2665	20180210	5619
20180113	수인선	호구포	2894	2725	20180116	5619
20180126	우이신설선	화계	2833	2785	20180129	5618
20180125	경의선	공덕	3026	2587	20180128	5613
20180201	2호선	용답	2785	2827	20180204	5612
20180131	수인선	남동인더스파크	2699	2913	20180203	5612
20180115	분당선	매교	2848	2763	20180118	5611
20180130	경의선	수색	2871	2735	20180202	5606
20180113	6호선	청구	2776	2830	20180116	5606
20180207	경인선	인천	3218	2385	20180210	5603
20180114	경원선	녹천	3010	2593	20180117	5603
20180128	경원선	이촌(국립중앙박물관)	3212	2389	20180131	5601
20180204	5호선	마곡	2801	2799	20180207	5600
20180121	5호선	양평	2795	2803	20180124	5598
20180128	과천선	대공원	2706	2889	20180131	5595
20180114	3호선	도곡	2790	2805	20180117	5595
20180207	과천선	경마공원	2806	2786	20180210	5592
20180127	중앙선	양평	2661	2931	20180130	5592
20180114	우이신설선	솔샘	2891	2700	20180117	5591
20180128	5호선	마곡	2769	2819	20180131	5588
20180124	중앙선	양평	2783	2804	20180127	5587
20180211	공항철도 1호선	청라국제도시	2747	2839	20180214	5586
20180119	경의선	강매	3045	2536	20180122	5581
20180212	분당선	보정	3023	2553	20180215	5576
20180204	7호선	부천종합운동장	2948	2627	20180207	5575
20180128	5호선	양평	2779	2795	20180131	5574
20180122	경의선	수색	2746	2827	20180125	5573
20180118	분당선	보정	3045	2528	20180121	5573
20180211	과천선	과천	2994	2576	20180214	5570
20180114	9호선	증미	2805	2764	20180117	5569
20180208	경원선	소요산	3139	2428	20180211	5567
20180128	경의선	가좌	2779	2788	20180131	5567
20180212	수인선	송도	2864	2701	20180215	5565
20180114	9호선	노들	2962	2602	20180117	5564
20180211	3호선	학여울	2713	2850	20180214	5563
20180131	경원선	소요산	3023	2536	20180203	5559
20180122	경의선	강매	2955	2604	20180125	5559
20180130	분당선	보정	3053	2503	20180202	5556
20180131	경의선	효창공원앞	2642	2910	20180203	5552
20180113	경강선	이천	2710	2841	20180116	5551
20180122	2호선	용답	2731	2819	20180125	5550
20180123	우이신설선	화계	2781	2764	20180126	5545
20180117	경의선	강매	2909	2636	20180120	5545
20180123	9호선	사평	2770	2772	20180126	5542
20180127	과천선	대공원	2704	2834	20180130	5538
20180117	2호선	용답	2765	2773	20180120	5538
20180203	9호선	구반포	2711	2825	20180206	5536
20180127	9호선2단계	삼성중앙	2756	2780	20180130	5536
20180128	3호선	도곡	2704	2831	20180131	5535
20180204	8호선	송파	2713	2818	20180207	5531
20180117	수인선	월곶	2839	2688	20180120	5527
20180121	과천선	과천	2963	2563	20180124	5526
20180130	경의선	강매	2813	2712	20180202	5525
20180130	경의선	효창공원앞	2634	2890	20180202	5524
20180201	2호선	용두(동대문구청)	2683	2840	20180204	5523
20180115	9호선	사평	2801	2721	20180118	5522
20180204	공항철도 1호선	청라국제도시	2702	2818	20180207	5520
20180201	수인선	남동인더스파크	2618	2902	20180204	5520
20180118	2호선	용답	2753	2764	20180121	5517
20180211	9호선	노들	2880	2636	20180214	5516
20180204	우이신설선	북한산우이	2888	2618	20180207	5506
20180131	분당선	매교	2734	2768	20180203	5502
20180119	경의선	효창공원앞	2655	2846	20180122	5501
20180207	2호선	용답	2741	2758	20180210	5499
20180114	9호선2단계	선정릉	2723	2775	20180117	5498
20180127	경인선	도화	2910	2587	20180130	5497
20180204	분당선	구성	2605	2890	20180207	5495
20180208	경의선	강매	2903	2591	20180211	5494
20180119	경부선	오산대	2916	2577	20180122	5493
20180204	경의선	가좌	2758	2734	20180207	5492
20180120	수인선	송도	2776	2716	20180123	5492
20180204	경의선	금릉	2747	2744	20180207	5491
20180207	2호선	용두(동대문구청)	2668	2821	20180210	5489
20180119	경강선	이천	2715	2774	20180122	5489
20180208	3호선	학여울	2674	2814	20180211	5488
20180126	9호선	사평	2820	2668	20180129	5488
20180122	분당선	보정	3013	2475	20180125	5488
20180211	우이신설선	솔샘	2784	2703	20180214	5487
20180203	경인선	도원	2736	2750	20180206	5486
20180117	과천선	대공원	2673	2813	20180120	5486
20180125	경부선	성환	2774	2708	20180128	5482
20180212	2호선	용답	2732	2748	20180215	5480
20180128	8호선	송파	2704	2770	20180131	5474
20180122	경의선	효창공원앞	2601	2872	20180125	5473
20180204	과천선	과천	2893	2579	20180207	5472
20180125	우이신설선	화계	2721	2751	20180128	5472
20180115	2호선	용답	2738	2734	20180118	5472
20180112	경인선	인천	3125	2347	20180115	5472
20180131	2호선	용답	2763	2708	20180203	5471
20180118	경의선	강매	2942	2526	20180121	5468
20180120	경강선	이천	2697	2770	20180123	5467
20180204	5호선	양평	2671	2794	20180207	5465
20180128	우이신설선	성신여대입구(돈암)	2695	2769	20180131	5464
20180119	수인선	월곶	2758	2706	20180122	5464
20180127	9호선	샛강	2696	2763	20180130	5459
20180123	2호선	용답	2729	2730	20180126	5459
20180114	7호선	부천종합운동장	2820	2639	20180117	5459
20180128	경원선	녹천	2927	2531	20180131	5458
20180121	경춘선	남춘천	2592	2866	20180124	5458
20180119	2호선	용두(동대문구청)	2690	2767	20180122	5457
20180127	9호선	구반포	2685	2770	20180130	5455
20180115	경의선	수색	2711	2744	20180118	5455
20180208	과천선	경마공원	2720	2731	20180211	5451
20180121	9호선	개화	2979	2469	20180124	5448
20180203	안산선	초지	3007	2440	20180206	5447
20180204	9호선	노들	2872	2572	20180207	5444
20180205	경의선	효창공원앞	2642	2801	20180208	5443
20180204	경의선	풍산	2734	2708	20180207	5442
20180131	2호선	용두(동대문구청)	2678	2763	20180203	5441
20180206	경의선	수색	2668	2769	20180209	5437
20180204	경원선	이촌(국립중앙박물관)	3127	2308	20180207	5435
20180131	경부선	세마	2832	2600	20180203	5432
20180112	우이신설선	화계	2739	2693	20180115	5432
20180204	수인선	인하대	2797	2634	20180207	5431
20180127	우이신설선	가오리	2795	2634	20180130	5429
20180211	과천선	대공원	2630	2798	20180214	5428
20180112	분당선	매교	2747	2679	20180115	5426
20180114	경원선	동두천중앙	2758	2667	20180117	5425
20180208	경의선	효창공원앞	2608	2808	20180211	5416
20180205	경인선	인천	3089	2326	20180208	5415
20180211	분당선	선정릉	2646	2768	20180214	5414
20180115	경의선	강매	2896	2516	20180118	5412
20180114	7호선	삼산체육관	2772	2636	20180117	5408
20180206	2호선	용답	2668	2738	20180209	5406
20180211	5호선	양평	2660	2744	20180214	5404
20180127	경부선	신도림	2536	2868	20180130	5404
20180211	7호선	부천종합운동장	2770	2631	20180214	5401
20180122	분당선	매교	2715	2683	20180125	5398
20180212	경의선	효창공원앞	2584	2813	20180215	5397
20180207	경의선	수색	2655	2740	20180210	5395
20180211	분당선	매탄권선	2739	2653	20180214	5392
20180207	경의선	강매	2865	2527	20180210	5392
20180130	2호선	용답	2649	2742	20180202	5391
20180121	우이신설선	성신여대입구(돈암)	2651	2736	20180124	5387
20180115	경부선	세마	2815	2569	20180118	5384
20180203	경강선	이천	2700	2682	20180206	5382
20180131	경의선	강매	2877	2505	20180203	5382
20180114	5호선	양평	2673	2708	20180117	5381
20180115	분당선	보정	2949	2428	20180118	5377
20180117	수인선	남동인더스파크	2548	2827	20180120	5375
20180128	9호선	노들	2810	2564	20180131	5374
20180114	9호선	개화	2941	2429	20180117	5370
20180118	경의선	효창공원앞	2598	2771	20180121	5369
20180131	6호선	버티고개	2786	2581	20180203	5367
20180118	경춘선	남춘천	2619	2748	20180121	5367
20180208	분당선	매교	2694	2669	20180211	5363
20180206	수인선	송도	2684	2676	20180209	5360
20180122	수인선	남동인더스파크	2506	2850	20180125	5356
20180129	9호선	사평	2699	2655	20180201	5354
20180127	6호선	청구	2584	2769	20180130	5353
20180130	중앙선	도심	2899	2453	20180202	5352
20180127	안산선	수리산	3022	2330	20180130	5352
20180121	중앙선	양평	2758	2594	20180124	5352
20180128	우이신설선	솔샘	2742	2609	20180131	5351
20180211	우이신설선	성신여대입구(돈암)	2628	2718	20180214	5346
20180203	장항선	아산	2717	2629	20180206	5346
20180130	수인선	남동인더스파크	2582	2764	20180202	5346
20180123	수인선	남동인더스파크	2504	2839	20180126	5343
20180120	경춘선	퇴계원	2795	2548	20180123	5343
20180207	분당선	매교	2643	2698	20180210	5341
20180130	과천선	대공원	2630	2710	20180202	5340
20180211	분당선	구성	2506	2831	20180214	5337
20180121	9호선2단계	선정릉	2629	2708	20180124	5337
20180120	9호선	공항시장	2578	2759	20180123	5337
20180125	9호선	사평	2737	2599	20180128	5336
20180208	중앙선	도심	3039	2296	20180211	5335
20180117	경부선	세마	2796	2537	20180120	5333
20180205	수인선	송도	2747	2581	20180208	5328
20180121	우이신설선	북한산우이	2639	2689	20180124	5328
20180119	6호선	버티고개	2792	2535	20180122	5327
20180112	9호선	사평	2701	2626	20180115	5327
20180211	3호선	도곡	2665	2661	20180214	5326
20180118	2호선	용두(동대문구청)	2546	2779	20180121	5325
20180114	우이신설선	북한산우이	2736	2586	20180117	5322
20180205	2호선	용답	2625	2696	20180208	5321
20180204	경원선	녹천	2881	2440	20180207	5321
20180127	경의선	능곡	2694	2626	20180130	5320
20180120	경춘선	사릉	2796	2524	20180123	5320
20180124	우이신설선	화계	2658	2660	20180127	5318
20180212	분당선	매교	2684	2632	20180215	5316
20180211	경원선	녹천	2899	2416	20180214	5315
20180206	2호선	용두(동대문구청)	2600	2715	20180209	5315
20180129	수인선	송도	2722	2590	20180201	5312
20180207	경의선	효창공원앞	2552	2759	20180210	5311
20180212	경의선	수색	2681	2626	20180215	5307
20180115	2호선	용두(동대문구청)	2593	2711	20180118	5304
20180122	2호선	용두(동대문구청)	2578	2724	20180125	5302
20180128	7호선	삼산체육관	2686	2614	20180131	5300
20180207	6호선	버티고개	2725	2573	20180210	5298
20180130	분당선	매교	2628	2666	20180202	5294
20180122	경부선	세마	2795	2498	20180125	5293
20180114	분당선	매탄권선	2689	2603	20180117	5292
20180201	경의선	강매	2837	2453	20180204	5290
20180120	6호선	독바위	2453	2836	20180123	5289
20180212	6호선	버티고개	2768	2520	20180215	5288
20180127	경춘선	남춘천	2567	2721	20180130	5288
20180121	안산선	대야미	2754	2534	20180124	5288
20180128	경원선	동두천중앙	2679	2608	20180131	5287
20180208	경부선	세마	2772	2514	20180211	5286
20180127	5호선	청구	2856	2430	20180130	5286
20180112	경의선	월롱	3066	2219	20180115	5285
20180131	중앙선	도심	2971	2312	20180203	5283
20180123	경의선	강매	2798	2484	20180126	5282
20180118	경부선	세마	2731	2551	20180121	5282
20180208	6호선	버티고개	2740	2540	20180211	5280
20180204	우이신설선	솔샘	2759	2521	20180207	5280
20180120	수인선	숭의	2754	2524	20180123	5278
20180203	5호선	충정로(경기대입구)	2803	2473	20180206	5276
20180122	6호선	버티고개	2682	2591	20180125	5273
20180131	과천선	경마공원	2629	2643	20180203	5272
20180114	중앙선	양평	2638	2633	20180117	5271
20180117	중앙선	도심	2933	2331	20180120	5264
20180113	수인선	송도	2708	2553	20180116	5261
20180114	우이신설선	성신여대입구(돈암)	2628	2632	20180117	5260
20180204	우이신설선	성신여대입구(돈암)	2621	2636	20180207	5257
20180211	경인선	인천	2930	2325	20180214	5255
20180129	경의선	효창공원앞	2541	2710	20180201	5251
20180123	수인선	송도	2715	2536	20180126	5251
20180128	7호선	부천종합운동장	2709	2541	20180131	5250
20180129	2호선	용답	2633	2616	20180201	5249
20180206	경의선	효창공원앞	2540	2708	20180209	5248
20180206	분당선	매교	2655	2587	20180209	5242
20180203	9호선	신반포	2690	2551	20180206	5241
20180115	수인선	남동인더스파크	2483	2758	20180118	5241
20180201	중앙선	도심	2928	2309	20180204	5237
20180115	중앙선	도심	2947	2287	20180118	5234
20180113	우이신설선	4.19민주묘지	2706	2528	20180116	5234
20180130	경부선	세마	2738	2493	20180202	5231
20180119	수인선	남동인더스파크	2483	2746	20180122	5229
20180119	4호선	동작(현충원)	2579	2648	20180122	5227
20180127	6호선	약수	2649	2575	20180130	5224
20180118	수인선	월곶	2692	2532	20180121	5224
20180121	분당선	매탄권선	2615	2606	20180124	5221
20180201	경부선	세마	2740	2480	20180204	5220
20180123	분당선	보정	2908	2312	20180126	5220
20180115	경부선	오산대	2664	2556	20180118	5220
20180201	6호선	버티고개	2774	2445	20180204	5219
20180123	경의선	효창공원앞	2468	2751	20180126	5219
20180112	2호선	용답	2631	2588	20180115	5219
20180212	경부선	세마	2712	2506	20180215	5218
20180206	6호선	버티고개	2748	2470	20180209	5218
20180118	6호선	버티고개	2698	2518	20180121	5216
20180123	경인선	인천	3035	2180	20180126	5215
20180205	분당선	보정	2861	2353	20180208	5214
20180205	경의선	강매	2812	2398	20180208	5210
20180204	7호선	삼산체육관	2651	2558	20180207	5209
20180129	2호선	용두(동대문구청)	2552	2655	20180201	5207
20180117	2호선	용두(동대문구청)	2524	2682	20180120	5206
20180129	경인선	인천	2977	2228	20180201	5205
20180124	수인선	남동인더스파크	2476	2725	20180127	5201
20180119	경춘선	별내	2616	2584	20180122	5200
20180208	수인선	남동인더스파크	2468	2729	20180211	5197
20180121	6호선	역촌	2407	2790	20180124	5197
20180201	경의선	효창공원앞	2511	2685	20180204	5196
20180129	분당선	매교	2664	2532	20180201	5196
20180205	6호선	버티고개	2653	2541	20180208	5194
20180125	경의선	수색	2585	2609	20180128	5194
20180127	경인선	도원	2584	2606	20180130	5190
20180117	6호선	버티고개	2686	2502	20180120	5188
20180211	경원선	동두천중앙	2641	2545	20180214	5186
20180120	경의선	홍대입구	2097	3088	20180123	5185
20180212	경의선	강매	2831	2353	20180215	5184
20180112	3호선	학여울	2564	2618	20180115	5182
20180118	중앙선	도심	2873	2308	20180121	5181
20180113	9호선	신목동	2794	2386	20180116	5180
20180128	분당선	선정릉	2501	2678	20180131	5179
20180207	수인선	남동인더스파크	2471	2706	20180210	5177
20180204	6호선	역촌	2362	2814	20180207	5176
20180203	9호선	공항시장	2491	2684	20180206	5175
20180120	분당선	개포동	2612	2560	20180123	5172
20180114	경춘선	남춘천	2424	2747	20180117	5171
20180206	경인선	인천	2956	2213	20180209	5169
20180126	수인선	남동인더스파크	2467	2701	20180129	5168
20180206	분당선	보정	2844	2323	20180209	5167
20180205	경의선	수색	2565	2602	20180208	5167
20180118	수인선	남동인더스파크	2437	2730	20180121	5167
20180130	경원선	소요산	2858	2305	20180202	5163
20180113	9호선	공항시장	2451	2710	20180116	5161
20180206	경의선	강매	2756	2402	20180209	5158
20180121	경원선	한남	2655	2503	20180124	5158
20180119	경강선	초월	2737	2421	20180122	5158
20180205	중앙선	용문	2620	2536	20180208	5156
20180201	과천선	경마공원	2540	2616	20180204	5156
20180120	우이신설선	북한산우이	2572	2575	20180123	5147
20180115	경춘선	남춘천	2424	2722	20180118	5146
20180121	경의선	야당	2603	2539	20180124	5142
20180115	6호선	버티고개	2695	2446	20180118	5141
20180125	경의선	효창공원앞	2476	2663	20180128	5139
20180125	수인선	남동인더스파크	2474	2663	20180128	5137
20180115	수인선	월곶	2607	2525	20180118	5132
20180112	수인선	송도	2608	2522	20180115	5130
20180126	분당선	매교	2603	2519	20180129	5122
20180114	6호선	역촌	2385	2737	20180117	5122
20180205	2호선	용두(동대문구청)	2517	2600	20180208	5117
20180203	수인선	호구포	2598	2519	20180206	5117
20180203	9호선	신목동	2796	2318	20180206	5114
20180120	경부선	세마	2785	2329	20180123	5114
20180212	경원선	소요산	2909	2203	20180215	5112
20180205	분당선	매교	2553	2558	20180208	5111
20180208	수인선	월곶	2593	2516	20180211	5109
20180130	우이신설선	삼양사거리	2349	2760	20180202	5109
20180211	5호선	올림픽공원(한국체대)	2511	2595	20180214	5106
20180207	경부선	세마	2668	2437	20180210	5105
20180123	6호선	버티고개	2653	2451	20180126	5104
20180204	9호선	개화	2779	2322	20180207	5101
20180119	중앙선	도심	2877	2220	20180122	5097
20180124	9호선	사평	2591	2505	20180127	5096
20180115	4호선	동작(현충원)	2531	2565	20180118	5096
20180204	분당선	매탄권선	2521	2574	20180207	5095
20180204	경원선	동두천중앙	2606	2489	20180207	5095
20180124	2호선	용답	2534	2561	20180127	5095
20180119	공항철도 1호선	공덕	2211	2883	20180122	5094
20180112	분당선	보정	2887	2202	20180115	5089
20180121	9호선	선유도	2551	2537	20180124	5088
20180113	9호선	신반포	2599	2483	20180116	5082
20180128	분당선	구성	2318	2763	20180131	5081
20180117	경부선	오산대	2562	2517	20180120	5079
20180121	수인선	호구포	2541	2535	20180124	5076
20180123	분당선	매교	2547	2525	20180126	5072
20180126	경의선	월롱	2976	2095	20180129	5071
20180120	경강선	판교	2558	2511	20180123	5069
20180208	장항선	쌍용(나사렛대)	2583	2485	20180211	5068
20180125	경의선	강매	2731	2336	20180128	5067
20180124	경의선	수색	2484	2583	20180127	5067
20180126	2호선	용답	2508	2555	20180129	5063
20180129	경의선	수색	2496	2565	20180201	5061
20180114	분당선	신갈	2523	2532	20180117	5055
20180204	분당선	선정릉	2451	2603	20180207	5054
20180129	경부선	세마	2651	2399	20180201	5050
20180211	6호선	역촌	2400	2646	20180214	5046
20180112	경의선	수색	2509	2536	20180115	5045
20180114	안산선	대야미	2662	2380	20180117	5042
20180121	8호선	모란	2807	2234	20180124	5041
20180120	9호선	신목동	2726	2314	20180123	5040
20180112	경의선	효창공원앞	2485	2553	20180115	5038
20180125	2호선	용답	2520	2516	20180128	5036
20180129	경의선	강매	2679	2353	20180201	5032
20180112	경부선	세마	2675	2357	20180115	5032
20180122	중앙선	도심	2835	2195	20180125	5030
20180112	경의선	강매	2719	2309	20180115	5028
20180203	경춘선	퇴계원	2654	2369	20180206	5023
20180112	경춘선	남춘천	2524	2499	20180115	5023
20180207	중앙선	도심	2823	2196	20180210	5019
20180204	과천선	대공원	2409	2610	20180207	5019
20180121	분당선	신갈	2539	2475	20180124	5014
20180206	수인선	남동인더스파크	2343	2670	20180209	5013
20180127	장항선	아산	2599	2410	20180130	5009
20180207	경원선	소요산	2731	2275	20180210	5006
20180114	9호선	선유도	2455	2544	20180117	4999
20180207	수인선	월곶	2593	2404	20180210	4997
20180204	경인선	인천	2760	2236	20180207	4996
20180112	경부선	오산대	2641	2354	20180115	4995
20180123	경부선	세마	2602	2392	20180126	4994
20180128	분당선	매탄권선	2546	2447	20180131	4993
20180131	수인선	월곶	2612	2380	20180203	4992
20180124	수인선	송도	2548	2443	20180127	4991
20180212	경강선	이천	2434	2554	20180215	4988
20180130	공항철도 1호선	공덕	2114	2874	20180202	4988
20180114	분당선	선정릉	2375	2613	20180117	4988
20180207	경춘선	남춘천	2454	2532	20180210	4986
20180131	경원선	동두천	2210	2776	20180203	4986
20180212	경부선	오산대	2508	2476	20180215	4984
20180211	9호선	개화	2762	2221	20180214	4983
20180124	분당선	매교	2509	2474	20180127	4983
20180128	9호선	선유도	2400	2581	20180131	4981
20180203	6호선	창신	2721	2259	20180206	4980
20180113	경춘선	퇴계원	2687	2293	20180116	4980
20180126	경의선	수색	2479	2493	20180129	4972
20180117	장항선	쌍용(나사렛대)	2619	2351	20180120	4970
20180211	안산선	대야미	2606	2361	20180214	4967
20180122	수인선	월곶	2550	2417	20180125	4967
20180208	과천선	대공원	2408	2556	20180211	4964
20180129	수인선	남동인더스파크	2307	2657	20180201	4964
20180114	경인선	도화	2558	2406	20180117	4964
20180121	경인선	도원	2499	2464	20180124	4963
20180113	수인선	숭의	2550	2412	20180116	4962
20180129	분당선	보정	2732	2228	20180201	4960
20180203	경춘선	사릉	2574	2385	20180206	4959
20180119	경원선	동두천	2259	2699	20180122	4958
20180131	공항철도 1호선	공덕	2188	2769	20180203	4957
20180131	경의선	월롱	2503	2454	20180203	4957
20180203	6호선	독바위	2344	2612	20180206	4956
20180208	경강선	이천	2460	2494	20180211	4954
20180129	6호선	버티고개	2552	2402	20180201	4954
20180212	수인선	월곶	2527	2426	20180215	4953
20180127	경춘선	마석	2464	2489	20180130	4953
20180124	경인선	인천	2867	2084	20180127	4951
20180124	경의선	강매	2642	2309	20180127	4951
20180126	경의선	효창공원앞	2402	2546	20180129	4948
20180128	6호선	역촌	2257	2689	20180131	4946
20180204	9호선	선유도	2423	2513	20180207	4936
20180205	수인선	남동인더스파크	2303	2632	20180208	4935
20180131	우이신설선	4.19민주묘지	2467	2468	20180203	4935
20180121	장항선	아산	2838	2097	20180124	4935
20180115	경춘선	별내	2510	2422	20180118	4932
20180207	과천선	대공원	2399	2532	20180210	4931
20180127	9호선	공항시장	2372	2559	20180130	4931
20180114	장항선	아산	2786	2145	20180117	4931
20180121	경춘선	마석	2416	2514	20180124	4930
20180122	경강선	이천	2440	2484	20180125	4924
20180113	경강선	판교	2499	2423	20180116	4922
20180203	중앙선	용문	2360	2561	20180206	4921
20180126	경인선	인천	2810	2107	20180129	4917
20180120	경강선	여주	2593	2321	20180123	4914
20180208	공항철도 1호선	공덕	2149	2764	20180211	4913
20180131	우이신설선	삼양사거리	2391	2522	20180203	4913
20180112	수인선	남동인더스파크	2377	2536	20180115	4913
20180203	5호선	신길	2313	2596	20180206	4909
20180208	경춘선	별내	2517	2389	20180211	4906
20180208	경부선	오산대	2519	2386	20180211	4905
20180118	경부선	오산대	2520	2384	20180121	4904
20180203	분당선	개포동	2458	2445	20180206	4903
20180201	경원선	동두천	2232	2670	20180204	4902
20180112	경강선	이천	2378	2524	20180115	4902
20180125	분당선	매교	2461	2437	20180128	4898
20180126	경의선	강매	2625	2272	20180129	4897
20180124	경의선	효창공원앞	2376	2520	20180127	4896
20180207	우이신설선	삼양사거리	2335	2560	20180210	4895
20180117	우이신설선	4.19민주묘지	2439	2453	20180120	4892
20180208	우이신설선	4.19민주묘지	2450	2441	20180211	4891
20180119	우이신설선	4.19민주묘지	2460	2431	20180122	4891
20180212	공항철도 1호선	공덕	2131	2758	20180215	4889
20180126	분당선	보정	2677	2210	20180129	4887
20180112	6호선	버티고개	2559	2328	20180115	4887
20180126	6호선	버티고개	2590	2294	20180129	4884
20180201	수인선	월곶	2504	2371	20180204	4875
20180205	중앙선	도심	2745	2127	20180208	4872
20180205	우이신설선	삼양사거리	2306	2565	20180208	4871
20180204	분당선	신갈	2414	2457	20180207	4871
20180212	수인선	남동인더스파크	2292	2578	20180215	4870
20180201	분당선	구룡	2478	2392	20180204	4870
20180120	5호선	신길	2297	2573	20180123	4870
20180201	우이신설선	삼양사거리	2333	2535	20180204	4868
20180131	경강선	이천	2365	2503	20180203	4868
20180112	2호선	용두(동대문구청)	2376	2490	20180115	4866
20180128	5호선	올림픽공원(한국체대)	2433	2429	20180131	4862
20180119	중앙선	용문	2347	2515	20180122	4862
20180114	우이신설선	정릉	2619	2243	20180117	4862
20180118	우이신설선	솔밭공원	2461	2400	20180121	4861
20180128	9호선	개화	2685	2175	20180131	4860
20180115	경강선	이천	2382	2476	20180118	4858
20180122	경부선	오산대	2475	2381	20180125	4856
20180208	우이신설선	솔밭공원	2438	2416	20180211	4854
20180117	경의선	월롱	2501	2352	20180120	4853
20180114	경원선	한남	2393	2458	20180117	4851
20180124	분당선	보정	2690	2160	20180127	4850
20180115	경의선	월롱	2362	2487	20180118	4849
20180113	경부선	세마	2613	2236	20180116	4849
20180128	8호선	모란	2701	2146	20180131	4847
20180130	경원선	동두천	2199	2647	20180202	4846
20180119	우이신설선	삼양사거리	2362	2483	20180122	4845
20180131	경강선	초월	2438	2401	20180203	4839
20180208	경춘선	남춘천	2423	2414	20180211	4837
20180125	6호선	버티고개	2529	2308	20180128	4837
20180114	경의선	야당	2445	2392	20180117	4837
20180118	경강선	이천	2373	2463	20180121	4836
20180128	경의선	야당	2472	2362	20180131	4834
20180205	경부선	세마	2525	2307	20180208	4832
20180131	경부선	오산대	2506	2325	20180203	4831
20180128	경춘선	마석	2374	2453	20180131	4827
20180208	우이신설선	삼양사거리	2309	2515	20180211	4824
20180201	경춘선	별내	2463	2361	20180204	4824
20180118	공항철도 1호선	공덕	2117	2707	20180121	4824
20180126	수인선	송도	2461	2360	20180129	4821
20180211	9호선	선유도	2386	2433	20180214	4819
20180117	공항철도 1호선	공덕	2067	2752	20180120	4819
20180203	수인선	송도	2458	2360	20180206	4818
20180126	경부선	세마	2565	2253	20180129	4818
20180118	경의선	월롱	2457	2359	20180121	4816
20180212	우이신설선	삼양사거리	2314	2501	20180215	4815
20180122	경원선	동두천	2228	2585	20180125	4813
20180206	중앙선	도심	2732	2080	20180209	4812
20180212	중앙선	도심	2766	2045	20180215	4811
20180207	경강선	이천	2356	2454	20180210	4810
20180207	공항철도 1호선	공덕	2102	2708	20180210	4810
20180113	5호선	신길	2273	2537	20180116	4810
20180115	장항선	아산	2600	2209	20180118	4809
20180211	8호선	모란	2659	2149	20180214	4808
20180122	우이신설선	삼양사거리	2250	2557	20180125	4807
20180130	경강선	초월	2405	2400	20180202	4805
20180130	우이신설선	솔밭공원	2351	2453	20180202	4804
20180125	수인선	송도	2464	2340	20180128	4804
20180124	6호선	버티고개	2508	2296	20180127	4804
20180211	분당선	신갈	2385	2417	20180214	4802
20180201	경부선	오산대	2512	2288	20180204	4800
20180121	안산선	수리산	2506	2294	20180124	4800
20180128	경춘선	남춘천	2298	2501	20180131	4799
20180126	장항선	아산	2511	2287	20180129	4798
20180113	경부선	오산대	2588	2210	20180116	4798
20180208	경의선	월롱	2422	2375	20180211	4797
20180122	공항철도 1호선	공덕	2100	2693	20180125	4793
20180117	경강선	초월	2449	2344	20180120	4793
20180130	우이신설선	4.19민주묘지	2323	2468	20180202	4791
20180127	수인선	호구포	2469	2322	20180130	4791
20180126	경춘선	남춘천	2453	2335	20180129	4788
20180201	경의선	월롱	2409	2378	20180204	4787
20180203	4호선	남태령	3916	870	20180206	4786
20180203	우이신설선	북한산우이	2396	2390	20180206	4786
20180131	경춘선	별내	2452	2331	20180203	4783
20180112	공항철도 1호선	공덕	2025	2756	20180115	4781
20180206	경부선	세마	2472	2307	20180209	4779
20180118	우이신설선	4.19민주묘지	2381	2397	20180121	4778
20180207	경의선	월롱	2471	2305	20180210	4776
20180119	장항선	쌍용(나사렛대)	2491	2285	20180122	4776
20180121	우이신설선	정릉	2492	2283	20180124	4775
20180115	경원선	동두천	2153	2622	20180118	4775
20180117	우이신설선	삼양사거리	2305	2469	20180120	4774
20180204	중앙선	양평	2395	2377	20180207	4772
20180201	경강선	이천	2366	2405	20180204	4771
20180115	우이신설선	삼양사거리	2252	2518	20180118	4770
20180123	2호선	용두(동대문구청)	2339	2429	20180126	4768
20180208	분당선	구룡	2450	2314	20180211	4764
20180201	우이신설선	솔밭공원	2431	2333	20180204	4764
20180130	경춘선	별내	2400	2362	20180202	4762
20180115	우이신설선	4.19민주묘지	2348	2414	20180118	4762
20180125	경인선	인천	2752	2008	20180128	4760
20180129	경원선	동두천	2224	2535	20180201	4759
20180131	우이신설선	솔밭공원	2414	2342	20180203	4756
20180124	경부선	세마	2480	2276	20180127	4756
20180115	경강선	초월	2388	2368	20180118	4756
20180123	중앙선	도심	2648	2107	20180126	4755
20180119	경의선	디지털미디어시티	2493	2262	20180122	4755
20180203	경강선	판교	2473	2281	20180206	4754
20180113	경춘선	사릉	2496	2257	20180116	4753
20180201	중앙선	용문	2375	2376	20180204	4751
20180208	경원선	동두천	2150	2599	20180211	4749
20180201	경춘선	남춘천	2388	2361	20180204	4749
20180201	공항철도 1호선	공덕	2051	2696	20180204	4747
20180211	경의선	야당	2437	2308	20180214	4745
20180121	경인선	도화	2424	2320	20180124	4744
20180112	장항선	쌍용(나사렛대)	2514	2230	20180115	4744
20180126	경강선	이천	2338	2402	20180129	4740
20180123	공항철도 1호선	공덕	2075	2663	20180126	4738
20180117	4호선	동작(현충원)	2323	2415	20180120	4738
20180117	경강선	이천	2278	2456	20180120	4734
20180118	경춘선	별내	2404	2329	20180121	4733
20180113	중앙선	용문	2279	2454	20180116	4733
20180115	공항철도 1호선	공덕	2013	2719	20180118	4732
20180127	경강선	이천	2268	2462	20180130	4730
20180206	공항철도 1호선	공덕	2045	2684	20180209	4729
20180114	경춘선	마석	2356	2368	20180117	4724
20180126	2호선	용두(동대문구청)	2363	2358	20180129	4721
20180122	경춘선	별내	2419	2301	20180125	4720
20180125	분당선	보정	2634	2085	20180128	4719
20180201	과천선	대공원	2283	2435	20180204	4718
20180212	경의선	월롱	2268	2448	20180215	4716
20180207	우이신설선	4.19민주묘지	2334	2382	20180210	4716
20180129	경강선	이천	2294	2422	20180201	4716
20180201	우이신설선	4.19민주묘지	2303	2412	20180204	4715
20180122	우이신설선	4.19민주묘지	2311	2403	20180125	4714
20180117	장항선	아산	2557	2157	20180120	4714
20180113	6호선	창신	2595	2118	20180116	4713
20180127	9호선	신목동	2569	2143	20180130	4712
20180121	우이신설선	가오리	2440	2271	20180124	4711
20180113	3호선	학여울	2333	2378	20180116	4711
20180127	안산선	초지	2501	2208	20180130	4709
20180203	수인선	숭의	2443	2265	20180206	4708
20180122	우이신설선	솔밭공원	2390	2318	20180125	4708
20180113	6호선	독바위	2256	2452	20180116	4708
20180128	분당선	신갈	2316	2391	20180131	4707
20180120	경부선	오산대	2489	2218	20180123	4707
20180203	우이신설선	화계	2414	2292	20180206	4706
20180207	우이신설선	솔밭공원	2365	2339	20180210	4704
20180118	경원선	동두천	2130	2574	20180121	4704
20180212	경강선	초월	2405	2298	20180215	4703
20180122	경강선	초월	2362	2339	20180125	4701
20180203	5호선	오금	2350	2350	20180206	4700
20180204	우이신설선	정릉	2521	2174	20180207	4695
20180130	분당선	구룡	2333	2361	20180202	4694
20180130	경부선	오산대	2395	2298	20180202	4693
20180123	경의선	월롱	2295	2397	20180126	4692
20180211	경인선	도화	2459	2231	20180214	4690
20180205	경원선	동두천	2131	2557	20180208	4688
20180126	공항철도 1호선	공덕	2033	2654	20180129	4687
20180129	중앙선	도심	2650	2033	20180201	4683
20180125	경부선	세마	2444	2238	20180128	4682
20180211	중앙선	양평	2328	2353	20180214	4681
20180212	장항선	아산	2387	2293	20180215	4680
20180128	경원선	한남	2389	2291	20180131	4680
20180117	경춘선	별내	2368	2310	20180120	4678
20180127	분당선	개포동	2355	2321	20180130	4676
20180206	우이신설선	솔밭공원	2323	2352	20180209	4675
20180205	수인선	월곶	2405	2270	20180208	4675
20180114	경부선	신도림	2268	2406	20180117	4674
20180129	경원선	소요산	2638	2032	20180201	4670
20180125	2호선	용두(동대문구청)	2268	2402	20180128	4670
20180208	4호선	동작(현충원)	2318	2351	20180211	4669
20180129	경춘선	남춘천	2289	2377	20180201	4666
20180122	장항선	아산	2485	2181	20180125	4666
20180208	경강선	초월	2384	2280	20180211	4664
20180130	수인선	월곶	2394	2270	20180202	4664
20180120	5호선	오금	2376	2287	20180123	4663
20180120	5호선	충정로(경기대입구)	2470	2191	20180123	4661
20180205	우이신설선	솔밭공원	2326	2334	20180208	4660
20180117	경원선	동두천	2144	2516	20180120	4660
20180131	분당선	구룡	2393	2266	20180203	4659
20180128	안산선	대야미	2416	2243	20180131	4659
20180207	경부선	오산대	2403	2254	20180210	4657
20180206	우이신설선	삼양사거리	2253	2404	20180209	4657
20180131	경춘선	남춘천	2259	2398	20180203	4657
20180122	4호선	동작(현충원)	2265	2392	20180125	4657
20180119	우이신설선	솔밭공원	2408	2247	20180122	4655
20180115	우이신설선	솔밭공원	2312	2343	20180118	4655
20180201	4호선	동작(현충원)	2267	2383	20180204	4650
20180130	경강선	이천	2269	2381	20180202	4650
20180128	수인선	호구포	2330	2319	20180131	4649
20180119	경부선	광명	2489	2158	20180122	4647
20180118	4호선	동작(현충원)	2296	2350	20180121	4646
20180113	분당선	개포동	2307	2337	20180116	4644
20180124	수인선	월곶	2382	2260	20180127	4642
20180130	경의선	월롱	2278	2359	20180202	4637
20180205	경원선	소요산	2689	1947	20180208	4636
20180117	우이신설선	솔밭공원	2369	2267	20180120	4636
20180117	경의선	서강대	2328	2307	20180120	4635
20180119	경부선	지제	2463	2171	20180122	4634
20180123	경춘선	남춘천	2343	2288	20180126	4631
20180113	5호선	충정로(경기대입구)	2443	2188	20180116	4631
20180201	경강선	초월	2315	2315	20180204	4630
20180130	우이신설선	삼양	2122	2502	20180202	4624
20180118	과천선	경마공원	2285	2333	20180121	4618
20180204	경인선	도화	2402	2214	20180207	4616
20180204	3호선	무악재	2251	2365	20180207	4616
20180114	분당선	청명	2336	2279	20180117	4615
20180207	4호선	동작(현충원)	2296	2318	20180210	4614
20180205	경부선	오산대	2355	2259	20180208	4614
20180211	분당선	청명	2354	2259	20180214	4613
20180129	우이신설선	삼양사거리	2215	2398	20180201	4613
20180113	수인선	월곶	2351	2258	20180116	4609
20180207	경원선	동두천	2164	2439	20180210	4603
20180129	수인선	월곶	2380	2223	20180201	4603
20180129	공항철도 1호선	공덕	2016	2586	20180201	4602
20180118	우이신설선	삼양사거리	2179	2420	20180121	4599
20180112	경원선	소요산	2470	2129	20180115	4599
20180124	공항철도 1호선	공덕	2012	2586	20180127	4598
20180119	경의선	서강대	2292	2306	20180122	4598
20180114	3호선	무악재	2241	2357	20180117	4598
20180113	우이신설선	화계	2382	2215	20180116	4597
20180118	경강선	초월	2352	2241	20180121	4593
20180129	경부선	오산대	2362	2229	20180201	4591
20180211	안산선	수리산	2369	2221	20180214	4590
20180211	수인선	호구포	2302	2287	20180214	4589
20180117	중앙선	용문	2293	2296	20180120	4589
20180113	5호선	오금	2363	2226	20180116	4589
20180206	경부선	오산대	2376	2212	20180209	4588
20180205	경강선	이천	2251	2335	20180208	4586
20180120	우이신설선	화계	2333	2253	20180123	4586
20180207	경강선	초월	2320	2265	20180210	4585
20180121	중앙선	용문	2418	2167	20180124	4585
20180112	중앙선	도심	2598	1987	20180115	4585
20180125	중앙선	도심	2570	2013	20180128	4583
20180117	과천선	경마공원	2317	2266	20180120	4583
20180126	수인선	월곶	2320	2259	20180129	4579
20180127	경춘선	퇴계원	2432	2145	20180130	4577
20180204	경춘선	남춘천	2140	2436	20180207	4576
20180120	6호선	창신	2527	2049	20180123	4576
20180127	9호선	신반포	2317	2258	20180130	4575
20180211	경원선	한남	2292	2282	20180214	4574
20180114	안산선	수리산	2396	2178	20180117	4574
20180125	수인선	월곶	2333	2240	20180128	4573
20180113	경의선	홍대입구	1919	2653	20180116	4572
20180207	경춘선	별내	2298	2273	20180210	4571
20180127	경강선	판교	2360	2211	20180130	4571
20180112	수인선	월곶	2357	2214	20180115	4571
20180121	분당선	선정릉	2148	2422	20180124	4570
20180205	우이신설선	4.19민주묘지	2289	2280	20180208	4569
20180205	공항철도 1호선	공덕	2021	2546	20180208	4567
20180114	경인선	도원	2289	2278	20180117	4567
20180124	경의선	월롱	2309	2257	20180127	4566
20180123	수인선	월곶	2331	2230	20180126	4561
20180205	경의선	월롱	2141	2418	20180208	4559
20180204	분당선	개포동	2277	2282	20180207	4559
20180123	경강선	이천	2248	2308	20180126	4556
20180212	우이신설선	4.19민주묘지	2256	2299	20180215	4555
20180206	우이신설선	4.19민주묘지	2261	2290	20180209	4551
20180204	분당선	청명	2301	2243	20180207	4544
20180117	경의선	디지털미디어시티	2298	2245	20180120	4543
20180121	경원선	서빙고	2188	2354	20180124	4542
20180128	경인선	도화	2345	2195	20180131	4540
20180205	경강선	초월	2228	2308	20180208	4536
20180121	3호선	무악재	2219	2315	20180124	4534
20180212	경춘선	별내	2323	2208	20180215	4531
20180131	4호선	동작(현충원)	2253	2275	20180203	4528
20180125	공항철도 1호선	공덕	1968	2557	20180128	4525
20180126	경부선	오산대	2388	2136	20180129	4524
20180119	경원선	덕계	2351	2171	20180122	4522
20180122	과천선	대공원	2191	2328	20180125	4519
20180205	우이신설선	삼양	2129	2388	20180208	4517
20180120	경춘선	가평	2102	2414	20180123	4516
20180123	경원선	동두천	1998	2517	20180126	4515
20180212	경원선	동두천	2062	2452	20180215	4514
20180211	경춘선	남춘천	2192	2318	20180214	4510
20180203	분당선	매교	2236	2273	20180206	4509
20180128	우이신설선	정릉	2456	2053	20180131	4509
20180204	우이신설선	가오리	2336	2171	20180207	4507
20180115	경의선	디지털미디어시티	2319	2187	20180118	4506
20180121	경부선	신도림	2217	2288	20180124	4505
20180129	우이신설선	4.19민주묘지	2192	2312	20180201	4504
20180123	경강선	초월	2301	2201	20180126	4502
20180211	우이신설선	정릉	2407	2094	20180214	4501
20180113	분당선	매교	2220	2279	20180116	4499
20180206	경원선	동두천	2059	2435	20180209	4494
20180130	경춘선	남춘천	2182	2312	20180202	4494
20180121	경의선	능곡	2286	2206	20180124	4492
20180120	경원선	동두천	2046	2444	20180123	4490
20180131	경춘선	갈매	2395	2094	20180203	4489
20180118	중앙선	용문	2212	2276	20180121	4488
20180114	경의선	능곡	2243	2244	20180117	4487
20180212	우이신설선	솔밭공원	2280	2206	20180215	4486
20180206	경의선	월롱	2186	2299	20180209	4485
20180204	수인선	호구포	2272	2213	20180207	4485
20180124	2호선	용두(동대문구청)	2187	2298	20180127	4485
20180124	우이신설선	4.19민주묘지	2262	2223	20180127	4485
20180204	안산선	대야미	2321	2163	20180207	4484
20180129	경의선	월롱	2131	2353	20180201	4484
20180130	경춘선	갈매	2309	2173	20180202	4482
20180206	수인선	월곶	2323	2158	20180209	4481
20180115	경의선	서강대	2225	2256	20180118	4481
20180208	경춘선	갈매	2347	2132	20180211	4479
20180126	3호선	학여울	2192	2286	20180129	4478
20180206	경춘선	별내	2316	2161	20180209	4477
20180127	경춘선	사릉	2319	2158	20180130	4477
20180123	경부선	오산대	2358	2117	20180126	4475
20180212	4호선	동작(현충원)	2177	2296	20180215	4473
20180120	분당선	대모산입구	2339	2133	20180123	4472
20180131	우이신설선	삼양	2078	2393	20180203	4471
20180118	경의선	디지털미디어시티	2317	2154	20180121	4471
20180129	분당선	구룡	2261	2208	20180201	4469
20180207	우이신설선	삼양	2101	2367	20180210	4468
20180123	과천선	대공원	2185	2283	20180126	4468
20180207	분당선	구룡	2286	2177	20180210	4463
20180115	경춘선	갈매	2367	2096	20180118	4463
20180203	경부선	세마	2391	2071	20180206	4462
20180129	경강선	초월	2210	2248	20180201	4458
20180212	우이신설선	삼양	2068	2386	20180215	4454
20180125	경의선	월롱	2281	2173	20180128	4454
20180208	장항선	아산	2365	2084	20180211	4449
20180203	2호선	용답	2243	2206	20180206	4449
20180206	경강선	이천	2175	2273	20180209	4448
20180122	경춘선	갈매	2388	2060	20180125	4448
20180201	우이신설선	삼양	2092	2353	20180204	4445
20180119	우이신설선	북한산우이	2331	2114	20180122	4445
20180113	우이신설선	북한산우이	2227	2218	20180116	4445
20180127	6호선	독바위	2106	2334	20180130	4440
20180124	중앙선	도심	2460	1978	20180127	4438
20180206	우이신설선	삼양	2065	2372	20180209	4437
20180204	경의선	야당	2278	2158	20180207	4436
20180112	경부선	지제	2360	2075	20180115	4435
20180205	경춘선	남춘천	2169	2263	20180208	4432
20180117	우이신설선	삼양	2062	2368	20180120	4430
20180118	장항선	아산	2359	2070	20180121	4429
20180205	경춘선	별내	2285	2143	20180208	4428
20180121	분당선	청명	2235	2192	20180124	4427
20180118	경춘선	갈매	2341	2086	20180121	4427
20180118	경의선	서강대	2229	2196	20180121	4425
20180119	경춘선	갈매	2399	2025	20180122	4424
20180117	경춘선	갈매	2384	2040	20180120	4424
20180126	우이신설선	삼양사거리	2103	2320	20180129	4423
20180128	3호선	무악재	2125	2296	20180131	4421
20180122	중앙선	용문	2237	2184	20180125	4421
20180131	경의선	디지털미디어시티	2268	2151	20180203	4419
20180206	경강선	초월	2265	2151	20180209	4416
20180211	3호선	무악재	2158	2250	20180214	4408
20180112	경강선	초월	2300	2108	20180115	4408
20180120	5호선	영등포구청	2186	2220	20180123	4406
20180127	5호선	신길	2072	2330	20180130	4402
20180123	우이신설선	삼양사거리	2065	2336	20180126	4401
20180112	경의선	서강대	2168	2230	20180115	4398
20180205	분당선	구룡	2235	2161	20180208	4396
20180131	장항선	아산	2260	2135	20180203	4395
20180126	경강선	초월	2340	2053	20180129	4393
20180208	우이신설선	삼양	2115	2275	20180211	4390
20180126	중앙선	도심	2500	1890	20180129	4390
20180129	장항선	아산	2300	2087	20180201	4387
20180204	경원선	한남	2165	2220	20180207	4385
20180112	경춘선	별내	2225	2160	20180115	4385
20180201	경춘선	갈매	2299	2084	20180204	4383
20180128	경인선	도원	2225	2158	20180131	4383
20180128	장항선	아산	2486	1896	20180131	4382
20180122	경춘선	가평	2176	2205	20180125	4381
20180122	경의선	디지털미디어시티	2234	2139	20180125	4373
20180206	경원선	소요산	2450	1919	20180209	4369
20180204	장항선	아산	2555	1813	20180207	4368
20180123	경의선	디지털미디어시티	2278	2088	20180126	4366
20180120	2호선	용답	2146	2220	20180123	4366
20180128	안산선	수리산	2285	2079	20180131	4364
20180115	장항선	쌍용(나사렛대)	2233	2130	20180118	4363
20180114	수인선	호구포	2190	2172	20180117	4362
20180211	우이신설선	가오리	2224	2136	20180214	4360
20180203	경의선	홍대입구	1762	2597	20180206	4359
20180127	5호선	충정로(경기대입구)	2328	2028	20180130	4356
20180117	경원선	덕계	2276	2080	20180120	4356
20180115	우이신설선	삼양	2032	2324	20180118	4356
20180123	경춘선	별내	2213	2135	20180126	4348
20180123	우이신설선	솔밭공원	2181	2163	20180126	4344
20180127	경부선	세마	2309	2032	20180130	4341
20180114	경원선	서빙고	2070	2269	20180117	4339
20180125	경부선	오산대	2225	2113	20180128	4338
20180131	중앙선	용문	2166	2171	20180203	4337
20180119	경의선	홍대입구	1811	2526	20180122	4337
20180119	경춘선	가평	2084	2253	20180122	4337
20180128	우이신설선	북한산우이	2244	2090	20180131	4334
20180207	3호선	학여울	2134	2196	20180210	4330
20180122	우이신설선	삼양	2003	2326	20180125	4329
20180211	경춘선	마석	2153	2174	20180214	4327
20180126	우이신설선	솔밭공원	2232	2093	20180129	4325
20180211	경인선	도원	2154	2170	20180214	4324
20180125	우이신설선	삼양사거리	2022	2302	20180128	4324
20180123	경원선	소요산	2403	1919	20180126	4322
20180120	수인선	월곶	2187	2134	20180123	4321
20180120	분당선	매교	2143	2177	20180123	4320
20180129	경춘선	별내	2238	2081	20180201	4319
20180119	공항철도 1호선	영종	2150	2164	20180122	4314
20180118	장항선	쌍용(나사렛대)	2194	2117	20180121	4311
20180117	3호선	학여울	2123	2188	20180120	4311
20180206	분당선	구룡	2188	2122	20180209	4310
20180122	경의선	서강대	2150	2156	20180125	4306
20180114	우이신설선	가오리	2198	2108	20180117	4306
20180127	6호선	창신	2363	1939	20180130	4302
20180113	2호선	용답	2161	2137	20180116	4298
20180203	경부선	오산대	2312	1980	20180206	4292
20180208	중앙선	용문	2131	2159	20180211	4290
20180119	우이신설선	삼양	2033	2256	20180122	4289
20180123	우이신설선	4.19민주묘지	2092	2196	20180126	4288
20180122	경원선	덕계	2238	2048	20180125	4286
20180204	안산선	수리산	2283	2000	20180207	4283
20180131	장항선	쌍용(나사렛대)	2228	2055	20180203	4283
20180130	4호선	동작(현충원)	2055	2228	20180202	4283
20180129	우이신설선	솔밭공원	2149	2131	20180201	4280
20180122	장항선	쌍용(나사렛대)	2158	2122	20180125	4280
20180208	경원선	덕계	2218	2060	20180211	4278
20180127	5호선	오금	2149	2128	20180130	4277
20180124	경강선	초월	2175	2095	20180127	4270
20180204	9호선	공항시장	1971	2298	20180207	4269
20180123	우이신설선	삼양	1984	2285	20180126	4269
20180204	경인선	도원	2142	2126	20180207	4268
20180127	우이신설선	화계	2256	2012	20180130	4268
20180121	9호선	공항시장	1979	2286	20180124	4265
20180203	수인선	월곶	2182	2082	20180206	4264
20180131	경의선	서강대	2124	2137	20180203	4261
20180119	경춘선	청평	2185	2075	20180122	4260
20180129	우이신설선	삼양	1998	2260	20180201	4258
20180112	우이신설선	삼양사거리	2020	2237	20180115	4257
20180207	경춘선	갈매	2245	2011	20180210	4256
20180128	분당선	청명	2090	2165	20180131	4255
20180127	수인선	숭의	2183	2072	20180130	4255
20180131	우이신설선	북한산우이	2233	2021	20180203	4254
20180204	경춘선	마석	2053	2200	20180207	4253
20180118	우이신설선	삼양	1985	2268	20180121	4253
20180208	경의선	디지털미디어시티	2189	2060	20180211	4249
20180124	우이신설선	삼양사거리	1988	2260	20180127	4248
20180121	경춘선	퇴계원	2195	2045	20180124	4240
20180201	장항선	아산	2272	1962	20180204	4234
20180114	중앙선	용문	2257	1973	20180117	4230
20180121	분당선	개포동	2133	2096	20180124	4229
20180112	경원선	동두천	1928	2300	20180115	4228
20180130	4호선	남태령	3047	1179	20180202	4226
20180119	4호선	남태령	3132	1090	20180122	4222
20180125	우이신설선	솔밭공원	2132	2089	20180128	4221
20180131	경원선	덕계	2214	2005	20180203	4219
20180122	경춘선	청평	2230	1987	20180125	4217
20180128	경의선	능곡	2132	2077	20180131	4209
20180120	경춘선	청평	2118	2091	20180123	4209
20180112	우이신설선	솔밭공원	2164	2043	20180115	4207
20180128	우이신설선	가오리	2132	2073	20180131	4205
20180207	경원선	덕계	2224	1978	20180210	4202
20180118	경원선	덕계	2210	1991	20180121	4201
20180201	경원선	덕계	2168	2030	20180204	4198
20180131	3호선	학여울	2052	2145	20180203	4197
20180130	경의선	디지털미디어시티	2190	2006	20180202	4196
20180125	경강선	이천	2071	2125	20180128	4196
20180127	수인선	송도	2131	2064	20180130	4195
20180121	9호선	샛강	2099	2095	20180124	4194
20180125	경강선	초월	2110	2083	20180128	4193
20180119	경강선	여주	1943	2245	20180122	4188
20180203	2호선	용두(동대문구청)	2012	2174	20180206	4186
20180112	경부선	광명	2290	1894	20180115	4184
20180113	장항선	쌍용(나사렛대)	2234	1948	20180116	4182
20180212	경춘선	갈매	2237	1941	20180215	4178
20180118	우이신설선	북한산우이	2170	2006	20180121	4176
20180127	경의선	홍대입구	1651	2523	20180130	4174
20180120	경의선	공덕	2224	1949	20180123	4173
20180114	경강선	이천	2014	2158	20180117	4172
20180211	분당선	개포동	2099	2072	20180214	4171
20180113	분당선	대모산입구	2184	1987	20180116	4171
20180127	2호선	용답	2057	2113	20180130	4170
20180115	공항철도 1호선	영종	2128	2039	20180118	4167
20180130	경의선	서강대	2108	2054	20180202	4162
20180127	경부선	오산대	2209	1950	20180130	4159
20180208	경원선	서빙고	2058	2100	20180211	4158
20180119	분당선	구룡	2174	1983	20180122	4157
20180113	경춘선	가평	2040	2117	20180116	4157
20180212	경원선	덕계	2173	1982	20180215	4155
20180211	장항선	아산	2351	1800	20180214	4151
20180126	경부선	지제	2225	1924	20180129	4149
20180115	경부선	지제	2172	1977	20180118	4149
20180207	경의선	서강대	2056	2092	20180210	4148
20180126	경의선	디지털미디어시티	2093	2053	20180129	4146
20180123	장항선	아산	2195	1948	20180126	4143
20180121	수인선	송도	2063	2077	20180124	4140
20180130	경원선	서빙고	2029	2109	20180202	4138
20180117	경의선	홍대입구	1797	2340	20180120	4137
20180124	경부선	오산대	2155	1977	20180127	4132
20180118	공항철도 1호선	영종	2083	2049	20180121	4132
20180204	경의선	능곡	2104	2027	20180207	4131
20180121	경강선	이천	1962	2167	20180124	4129
20180112	4호선	남태령	3026	1103	20180115	4129
20180126	우이신설선	4.19민주묘지	2069	2058	20180129	4127
20180124	경춘선	남춘천	1999	2128	20180127	4127
20180124	우이신설선	솔밭공원	2081	2046	20180127	4127
20180122	3호선	학여울	2023	2104	20180125	4127
20180114	경부선	오산대	2011	2116	20180117	4127
20180125	경춘선	남춘천	2049	2077	20180128	4126
20180130	경원선	덕계	2104	2019	20180202	4123
20180208	경의선	서강대	2078	2043	20180211	4121
20180205	4호선	동작(현충원)	2024	2095	20180208	4119
20180130	3호선	학여울	2005	2114	20180202	4119
20180125	우이신설선	4.19민주묘지	2018	2100	20180128	4118
20180113	경의선	서강대	2063	2053	20180116	4116
20180112	4호선	동작(현충원)	2048	2068	20180115	4116
20180201	3호선	학여울	2042	2072	20180204	4114
20180128	경원선	서빙고	1967	2147	20180131	4114
20180211	9호선	신반포	2025	2087	20180214	4112
20180113	5호선	영등포구청	2022	2089	20180116	4111
20180124	경강선	이천	1980	2129	20180127	4109
20180112	우이신설선	4.19민주묘지	2048	2061	20180115	4109
20180115	경원선	덕계	2163	1944	20180118	4107
20180118	경원선	서빙고	2029	2076	20180121	4105
20180205	경원선	서빙고	2035	2068	20180208	4103
20180201	경의선	디지털미디어시티	2110	1993	20180204	4103
20180201	경원선	서빙고	2000	2100	20180204	4100
20180115	경춘선	가평	1938	2162	20180118	4100
20180208	중앙선	양원	1934	2165	20180211	4099
20180203	5호선	영등포구청	2035	2063	20180206	4098
20180125	경의선	디지털미디어시티	2062	2036	20180128	4098
20180112	경의선	디지털미디어시티	2083	2015	20180115	4098
20180114	9호선	공항시장	1922	2174	20180117	4096
20180122	경강선	곤지암	2046	2048	20180125	4094
20180117	경춘선	청평	2096	1996	20180120	4092
20180119	경강선	곤지암	2065	2026	20180122	4091
20180212	장항선	쌍용(나사렛대)	2125	1963	20180215	4088
20180126	경춘선	별내	2070	2018	20180129	4088
20180115	과천선	대공원	1974	2114	20180118	4088
20180121	9호선	신반포	2005	2080	20180124	4085
20180119	경원선	서빙고	2035	2050	20180122	4085
20180203	경원선	동두천	1890	2192	20180206	4082
20180120	경부선	지제	2198	1884	20180123	4082
20180211	경의선	능곡	2046	2035	20180214	4081
20180122	경부선	지제	2109	1971	20180125	4080
20180211	경원선	서빙고	1933	2145	20180214	4078
20180114	안산선	초지	2150	1928	20180117	4078
20180212	경부선	지제	2058	2019	20180215	4077
20180212	경의선	서강대	2054	2020	20180215	4074
20180120	장항선	쌍용(나사렛대)	2136	1937	20180123	4073
20180115	경춘선	청평	2153	1918	20180118	4071
20180126	4호선	남태령	2992	1075	20180129	4067
20180206	경춘선	남춘천	2017	2049	20180209	4066
20180126	경원선	소요산	2217	1848	20180129	4065
20180205	경춘선	갈매	2160	1904	20180208	4064
20180117	분당선	구룡	2056	2008	20180120	4064
20180114	수인선	송도	2004	2059	20180117	4063
20180207	장항선	아산	2185	1877	20180210	4062
20180211	9호선	공항시장	1911	2148	20180214	4059
20180122	우이신설선	북한산우이	2088	1967	20180125	4055
20180208	4호선	남태령	2950	1104	20180211	4054
20180123	경의선	서강대	2073	1980	20180126	4053
20180115	경강선	곤지암	1992	2060	20180118	4052
20180122	공항철도 1호선	영종	2045	2006	20180125	4051
20180113	경강선	여주	2008	2042	20180116	4050
20180207	4호선	남태령	2938	1111	20180210	4049
20180207	경의선	디지털미디어시티	2084	1962	20180210	4046
20180118	경강선	곤지암	2071	1974	20180121	4045
20180113	경의선	공덕	2163	1882	20180116	4045
20180125	경춘선	별내	2054	1990	20180128	4044
20180201	장항선	쌍용(나사렛대)	2047	1996	20180204	4043
20180127	분당선	대모산입구	2103	1937	20180130	4040
20180120	경춘선	춘천	2115	1925	20180123	4040
20180114	9호선	신반포	2003	2034	20180117	4037
20180124	경의선	디지털미디어시티	2020	2016	20180127	4036
20180129	경춘선	갈매	2154	1881	20180201	4035
20180206	경의선	디지털미디어시티	2059	1975	20180209	4034
20180124	경원선	동두천	1837	2195	20180127	4032
20180212	경의선	디지털미디어시티	2068	1963	20180215	4031
20180113	경원선	동두천	1793	2238	20180116	4031
20180205	경의선	디지털미디어시티	2044	1986	20180208	4030
20180127	수인선	월곶	2063	1965	20180130	4028
20180126	우이신설선	삼양	1884	2142	20180129	4026
20180127	중앙선	용문	1935	2089	20180130	4024
20180208	공항철도 1호선	영종	2024	1997	20180211	4021
20180206	4호선	동작(현충원)	1961	2060	20180209	4021
20180123	경춘선	갈매	2181	1838	20180126	4019
20180120	공항철도 1호선	영종	2068	1951	20180123	4019
20180118	분당선	구룡	2076	1942	20180121	4018
20180201	경의선	서강대	2034	1982	20180204	4016
20180117	경강선	곤지암	2030	1983	20180120	4013
20180129	4호선	동작(현충원)	1968	2044	20180201	4012
20180211	9호선	샛강	2015	1995	20180214	4010
20180204	경강선	이천	1936	2074	20180207	4010
20180115	3호선	학여울	1983	2026	20180118	4009
20180206	경춘선	갈매	2119	1889	20180209	4008
20180119	수인선	신포	1936	2072	20180122	4008
20180124	경의선	서강대	2029	1976	20180127	4005
20180203	분당선	대모산입구	2089	1915	20180206	4004
20180204	9호선2단계	삼성중앙	1927	2076	20180207	4003
20180120	우이신설선	4.19민주묘지	2031	1969	20180123	4000
20180112	우이신설선	삼양	1834	2166	20180115	4000
20180211	경부선	신도림	1959	2040	20180214	3999
20180120	2호선	용두(동대문구청)	1923	2076	20180123	3999
20180115	분당선	구룡	2066	1931	20180118	3997
20180120	4호선	동작(현충원)	1948	2048	20180123	3996
20180208	경부선	지제	2034	1961	20180211	3995
20180113	9호선	사평	2120	1875	20180116	3995
20180125	3호선	학여울	1970	2024	20180128	3994
20180204	경원선	서빙고	1892	2101	20180207	3993
20180117	공항철도 1호선	영종	2042	1950	20180120	3992
20180115	경원선	서빙고	2029	1960	20180118	3989
20180128	분당선	개포동	2052	1936	20180131	3988
20180201	우이신설선	북한산우이	2098	1887	20180204	3985
20180130	장항선	쌍용(나사렛대)	2044	1941	20180202	3985
20180114	경강선	판교	2023	1961	20180117	3984
20180122	경원선	서빙고	1958	2025	20180125	3983
20180121	5호선	청구	2132	1850	20180124	3982
20180117	경원선	서빙고	1973	2009	20180120	3982
20180204	9호선	신반포	1970	2007	20180207	3977
20180114	경춘선	퇴계원	2071	1906	20180117	3977
20180117	4호선	남태령	2776	1198	20180120	3974
20180204	9호선	샛강	2019	1954	20180207	3973
20180120	분당선	보정	2199	1774	20180123	3973
20180130	경강선	삼동	2147	1825	20180202	3972
20180212	4호선	남태령	2911	1060	20180215	3971
20180118	경의선	홍대입구	1756	2215	20180121	3971
20180113	분당선	보정	2154	1817	20180116	3971
20180205	장항선	아산	2160	1810	20180208	3970
20180121	경춘선	춘천	2265	1704	20180124	3969
20180128	경부선	신도림	1927	2040	20180131	3967
20180131	공항철도 1호선	영종	1956	2009	20180203	3965
20180120	경춘선	별내	1988	1977	20180123	3965
20180201	4호선	남태령	2839	1124	20180204	3963
20180212	경원선	서빙고	1961	2001	20180215	3962
20180114	분당선	개포동	1995	1967	20180117	3962
20180207	경강선	삼동	2206	1754	20180210	3960
20180131	경원선	서빙고	2006	1953	20180203	3959
20180203	경춘선	청평	1995	1958	20180206	3953
20180203	경강선	여주	1987	1966	20180206	3953
20180203	우이신설선	4.19민주묘지	2057	1895	20180206	3952
20180121	6호선	약수	1997	1955	20180124	3952
20180118	경춘선	청평	2039	1913	20180121	3952
20180115	우이신설선	북한산우이	2077	1875	20180118	3952
20180205	경춘선	가평	1941	2010	20180208	3951
20180203	우이신설선	삼양사거리	1913	2037	20180206	3950
20180206	3호선	학여울	1923	2025	20180209	3948
20180201	공항철도 1호선	영종	1980	1967	20180204	3947
20180125	중앙선	용문	1968	1978	20180128	3946
20180126	경원선	동두천	1801	2144	20180129	3945
20180126	중앙선	양수	1804	2139	20180129	3943
20180112	경춘선	갈매	2146	1797	20180115	3943
20180212	공항철도 1호선	영종	2019	1923	20180215	3942
20180125	장항선	쌍용(나사렛대)	2010	1931	20180128	3941
20180211	우이신설선	북한산우이	2086	1853	20180214	3939
20180128	경강선	이천	1857	2082	20180131	3939
20180212	분당선	구룡	2019	1919	20180215	3938
20180122	분당선	구룡	2001	1936	20180125	3937
20180117	경부선	지제	2031	1906	20180120	3937
20180205	경의선	서강대	2008	1928	20180208	3936
20180206	경원선	덕계	2048	1886	20180209	3934
20180204	5호선	청구	2042	1891	20180207	3933
20180204	경부선	신도림	1917	2014	20180207	3931
20180206	장항선	아산	2088	1841	20180209	3929
20180122	경강선	삼동	2142	1786	20180125	3928
20180121	안산선	초지	2112	1815	20180124	3927
20180121	경강선	판교	2033	1894	20180124	3927
20180112	경의선	홍대입구	1617	2309	20180115	3926
20180125	우이신설선	삼양	1854	2071	20180128	3925
20180212	경강선	곤지암	1893	2031	20180215	3924
20180125	장항선	아산	2078	1845	20180128	3923
20180117	경춘선	가평	1891	2032	20180120	3923
20180117	수인선	신포	1941	1981	20180120	3922
20180207	경원선	서빙고	1974	1944	20180210	3918
20180212	3호선	학여울	1919	1997	20180215	3916
20180113	경부선	지제	2136	1777	20180116	3913
20180204	우이신설선	화계	2050	1862	20180207	3912
20180211	5호선	청구	2067	1843	20180214	3910
20180201	경강선	곤지암	1954	1956	20180204	3910
20180121	6호선	독바위	1728	2182	20180124	3910
20180115	공항철도 1호선	인천공항2터미널	2085	1825	20180118	3910
20180124	우이신설선	삼양	1784	2123	20180127	3907
20180123	4호선	동작(현충원)	1957	1948	20180126	3905
20180114	9호선	신목동	2069	1834	20180117	3903
20180113	경춘선	청평	1927	1976	20180116	3903
20180203	9호선	사평	1993	1908	20180206	3901
20180204	경강선	판교	1936	1964	20180207	3900
20180207	장항선	쌍용(나사렛대)	1995	1904	20180210	3899
20180123	경원선	덕계	2021	1878	20180126	3899
20180129	경원선	덕계	2056	1841	20180201	3897
20180129	경부선	지제	2002	1894	20180201	3896
20180114	9호선	샛강	1915	1981	20180117	3896
20180206	경의선	서강대	2000	1893	20180209	3893
20180130	장항선	아산	2111	1780	20180202	3891
20180114	5호선	청구	2032	1858	20180117	3890
20180207	공항철도 1호선	영종	1932	1957	20180210	3889
20180120	중앙선	도심	2089	1800	20180123	3889
20180118	수인선	신포	1899	1986	20180121	3885
20180113	2호선	용두(동대문구청)	1920	1964	20180116	3884
20180129	경의선	디지털미디어시티	2076	1806	20180201	3882
20180131	경강선	곤지암	1970	1911	20180203	3881
20180127	우이신설선	북한산우이	1944	1936	20180130	3880
20180121	경춘선	가평	2031	1849	20180124	3880
20180120	9호선	사평	2016	1864	20180123	3880
20180121	경부선	오산대	1935	1944	20180124	3879
20180129	장항선	쌍용(나사렛대)	2032	1846	20180201	3878
20180205	경원선	덕계	2039	1837	20180208	3876
20180208	경강선	곤지암	1936	1938	20180211	3874
20180124	경춘선	갈매	2086	1788	20180127	3874
20180126	경부선	광명	2124	1749	20180129	3873
20180203	경부선	지제	2050	1822	20180206	3872
20180128	9호선	공항시장	1831	2037	20180131	3868
20180113	경춘선	춘천	2095	1773	20180116	3868
20180131	경부선	지제	2035	1832	20180203	3867
20180125	경원선	소요산	2233	1634	20180128	3867
20180115	경의선	홍대입구	1700	2167	20180118	3867
20180123	3호선	학여울	1886	1978	20180126	3864
20180212	경춘선	청평	1963	1900	20180215	3863
20180121	경강선	여주	2028	1835	20180124	3863
20180205	경춘선	청평	2020	1840	20180208	3860
20180121	수인선	숭의	2005	1855	20180124	3860
20180115	경원선	보산	1850	2009	20180118	3859
20180211	경강선	이천	1819	2039	20180214	3858
20180129	경의선	서강대	1918	1939	20180201	3857
20180127	분당선	매교	1890	1965	20180130	3855
20180128	9호선	신반포	1912	1942	20180131	3854
20180125	경원선	동두천	1791	2058	20180128	3849
20180130	공항철도 1호선	영종	1986	1860	20180202	3846
20180121	경춘선	사릉	1941	1905	20180124	3846
20180118	경춘선	가평	1881	1962	20180121	3843
20180208	경강선	삼동	2078	1761	20180211	3839
20180122	경부선	광명	2068	1769	20180125	3837
20180205	경부선	지제	1980	1856	20180208	3836
20180124	3호선	학여울	1897	1939	20180127	3836
20180125	경춘선	갈매	2068	1766	20180128	3834
20180129	중앙선	용문	1946	1887	20180201	3833
20180119	중앙선	양수	1954	1879	20180122	3833
20180207	수인선	신포	1924	1908	20180210	3832
20180201	경부선	지제	1956	1875	20180204	3831
20180123	장항선	쌍용(나사렛대)	1997	1834	20180126	3831
20180117	경강선	삼동	2128	1701	20180120	3829
20180203	경의선	공덕	2026	1802	20180206	3828
20180128	5호선	청구	2017	1811	20180131	3828
20180119	경원선	보산	2074	1751	20180122	3825
20180203	공항철도 1호선	영종	1992	1832	20180206	3824
20180121	우이신설선	화계	1983	1840	20180124	3823
20180114	6호선	독바위	1711	2112	20180117	3823
20180205	공항철도 1호선	영종	1903	1913	20180208	3816
20180120	경의선	서강대	1861	1954	20180123	3815
20180119	경원선	응봉	2070	1745	20180122	3815
20180122	4호선	남태령	2673	1140	20180125	3813
20180121	경의선	홍대입구	1621	2189	20180124	3810
20180118	경부선	지제	1882	1928	20180121	3810
20180118	4호선	남태령	2655	1154	20180121	3809
20180126	4호선	동작(현충원)	1851	1956	20180129	3807
20180113	경강선	초월	2023	1778	20180116	3801
20180208	경춘선	청평	1977	1821	20180211	3798
20180121	6호선	청구	1838	1960	20180124	3798
20180129	공항철도 1호선	영종	1934	1862	20180201	3796
20180211	6호선	약수	1956	1838	20180214	3794
20180201	경원선	응봉	2012	1782	20180204	3794
20180119	경부선	진위	2121	1673	20180122	3794
20180115	4호선	남태령	2683	1109	20180118	3792
20180121	9호선	신목동	1981	1809	20180124	3790
20180126	경의선	서강대	1911	1878	20180129	3789
20180211	경강선	판교	1920	1868	20180214	3788
20180201	경강선	삼동	2092	1694	20180204	3786
20180131	경강선	삼동	2070	1716	20180203	3786
20180131	수인선	신포	1830	1956	20180203	3786
20180112	공항철도 1호선	영종	1954	1831	20180115	3785
20180124	장항선	쌍용(나사렛대)	1989	1792	20180127	3781
20180123	공항철도 1호선	영종	1912	1869	20180126	3781
20180120	우이신설선	삼양사거리	1901	1879	20180123	3780
20180131	4호선	남태령	2632	1146	20180203	3778
20180130	경원선	응봉	1962	1816	20180202	3778
20180115	수인선	신포	1900	1878	20180118	3778
20180112	경강선	곤지암	1937	1841	20180115	3778
20180212	중앙선	용문	1932	1844	20180215	3776
20180207	경강선	곤지암	1901	1875	20180210	3776
20180130	우이신설선	북한산우이	1970	1806	20180202	3776
20180114	경의선	홍대입구	1638	2136	20180117	3774
20180120	경강선	초월	1990	1782	20180123	3772
20180129	4호선	남태령	2718	1052	20180201	3770
20180128	경강선	판교	1964	1804	20180131	3768
20180207	경춘선	청평	1939	1828	20180210	3767
20180205	3호선	학여울	1858	1909	20180208	3767
20180121	경부선	세마	1942	1825	20180124	3767
20180128	중앙선	용문	1970	1791	20180131	3761
20180128	9호선	샛강	1832	1929	20180131	3761
20180112	분당선	구룡	1942	1819	20180115	3761
20180205	경강선	곤지암	1869	1891	20180208	3760
20180119	안산선	신길온천	1990	1769	20180122	3759
20180207	중앙선	양원	1822	1936	20180210	3758
20180206	경원선	서빙고	1885	1873	20180209	3758
20180201	경의선	홍대입구	1648	2110	20180204	3758
20180212	경강선	삼동	2050	1706	20180215	3756
20180124	경원선	소요산	2150	1604	20180127	3754
20180123	경원선	서빙고	1827	1926	20180126	3753
20180207	중앙선	용문	1916	1836	20180210	3752
20180203	공항철도 1호선	공항화물청사	1835	1915	20180206	3750
20180118	중앙선	양수	1825	1924	20180121	3749
20180203	수인선	신포	1804	1944	20180206	3748
20180208	경의선	홍대입구	1667	2079	20180211	3746
20180112	경원선	덕계	1986	1760	20180115	3746
20180204	중앙선	용문	2054	1690	20180207	3744
20180212	경춘선	가평	1790	1950	20180215	3740
20180112	중앙선	용문	1783	1957	20180115	3740
20180208	우이신설선	북한산우이	1961	1778	20180211	3739
20180203	경의선	수색	1847	1892	20180206	3739
20180127	4호선	남태령	2890	849	20180130	3739
20180208	경원선	응봉	1971	1767	20180211	3738
20180206	과천선	대공원	1799	1937	20180209	3736
20180120	경의선	월롱	2114	1622	20180123	3736
20180207	경부선	지제	1947	1788	20180210	3735
20180124	장항선	아산	1980	1754	20180127	3734
20180203	분당선	보정	2058	1675	20180206	3733
20180122	경의선	홍대입구	1640	2092	20180125	3732
20180114	경춘선	사릉	1924	1807	20180117	3731
20180123	경강선	곤지암	1857	1873	20180126	3730
20180115	경강선	삼동	2021	1709	20180118	3730
20180121	경원선	동두천	1574	2155	20180124	3729
20180125	4호선	동작(현충원)	1825	1900	20180128	3725
20180123	경부선	지제	1925	1799	20180126	3724
20180122	중앙선	양수	1875	1849	20180125	3724
20180205	중앙선	양원	1768	1955	20180208	3723
20180121	수인선	월곶	1923	1800	20180124	3723
20180119	경강선	삼동	2098	1620	20180122	3718
20180120	경강선	곤지암	1951	1765	20180123	3716
20180130	경부선	지제	1934	1781	20180202	3715
20180128	6호선	약수	1885	1829	20180131	3714
20180114	경부선	세마	1864	1848	20180117	3712
20180118	경강선	삼동	2037	1674	20180121	3711
20180203	경의선	월롱	2098	1612	20180206	3710
20180201	수인선	신포	1851	1859	20180204	3710
20180127	9호선	사평	1910	1799	20180130	3709
20180205	경부선	광명	2032	1674	20180208	3706
20180131	우이신설선	신설동	1770	1936	20180203	3706
20180129	경강선	곤지암	1817	1887	20180201	3704
20180208	경춘선	가평	1790	1913	20180211	3703
20180120	공항철도 1호선	공항화물청사	1805	1898	20180123	3703
20180123	중앙선	용문	1823	1879	20180126	3702
20180211	6호선	창신	1965	1736	20180214	3701
20180123	분당선	구룡	1881	1818	20180126	3699
20180201	경춘선	청평	1951	1747	20180204	3698
20180211	경부선	세마	1891	1806	20180214	3697
20180131	경원선	응봉	2040	1656	20180203	3696
20180126	경춘선	갈매	2041	1655	20180129	3696
20180206	4호선	남태령	2681	1013	20180209	3694
20180203	경춘선	가평	1743	1951	20180206	3694
20180113	우이신설선	삼양사거리	1840	1851	20180116	3691
20180128	9호선2단계	삼성중앙	1751	1939	20180131	3690
20180130	경춘선	청평	1989	1700	20180202	3689
20180114	6호선	약수	1871	1818	20180117	3689
20180121	경춘선	청평	1998	1688	20180124	3686
20180131	경춘선	청평	1902	1782	20180203	3684
20180130	경강선	곤지암	1862	1822	20180202	3684
20180120	경의선	디지털미디어시티	1983	1701	20180123	3684
20180205	경강선	삼동	1987	1694	20180208	3681
20180212	우이신설선	북한산우이	1896	1783	20180215	3679
20180211	우이신설선	화계	1884	1795	20180214	3679
20180211	6호선	청구	1799	1879	20180214	3678
20180128	경춘선	퇴계원	1909	1769	20180131	3678
20180124	경춘선	별내	1867	1811	20180127	3678
20180113	경강선	곤지암	1918	1760	20180116	3678
20180207	우이신설선	북한산우이	1932	1744	20180210	3676
20180126	경원선	덕계	1945	1730	20180129	3675
20180203	경춘선	별내	1848	1826	20180206	3674
20180129	경춘선	가평	1847	1827	20180201	3674
20180113	중앙선	도심	1991	1682	20180116	3673
20180127	경강선	여주	1792	1878	20180130	3670
20180114	우이신설선	화계	1926	1744	20180117	3670
20180127	경춘선	가평	1785	1883	20180130	3668
20180113	공항철도 1호선	영종	1852	1816	20180116	3668
20180204	6호선	약수	1885	1780	20180207	3665
20180120	중앙선	양수	1839	1825	20180123	3664
20180117	경원선	응봉	1961	1702	20180120	3663
20180114	2호선	용답	1820	1843	20180117	3663
20180204	6호선	창신	1894	1768	20180207	3662
20180124	중앙선	양수	1559	2099	20180127	3658
20180212	경부선	광명	2042	1615	20180215	3657
20180131	중앙선	양수	1770	1887	20180203	3657
20180125	경의선	서강대	1788	1869	20180128	3657
20180112	경원선	서빙고	1833	1823	20180115	3656
20180122	경원선	응봉	1936	1717	20180125	3653
20180120	6호선	버티고개	1923	1729	20180123	3652
20180205	4호선	남태령	2652	997	20180208	3649
20180206	장항선	쌍용(나사렛대)	1870	1777	20180209	3647
20180203	우이신설선	솔밭공원	1884	1763	20180206	3647
20180130	수인선	신포	1815	1832	20180202	3647
20180203	경강선	초월	1920	1725	20180206	3645
20180123	4호선	남태령	2537	1108	20180126	3645
20180204	9호선	신목동	1911	1732	20180207	3643
20180208	경부선	광명	1996	1644	20180211	3640
20180127	경부선	지제	1958	1680	20180130	3638
20180119	경의선	화전	1948	1690	20180122	3638
20180119	경강선	부발	2049	1589	20180122	3638
20180118	경부선	광명	2008	1630	20180121	3638
20180211	경부선	오산대	1813	1823	20180214	3636
20180120	경의선	강매	1880	1756	20180123	3636
20180125	경원선	덕계	1930	1703	20180128	3633
20180127	경의선	공덕	1909	1723	20180130	3632
20180112	경원선	보산	1939	1693	20180115	3632
20180122	9호선	동작(현충원)	2184	1447	20180125	3631
20180131	경의선	홍대입구	1615	2015	20180203	3630
20180113	경의선	월롱	2102	1528	20180116	3630
20180114	9호선2단계	삼성중앙	1736	1893	20180117	3629
20180126	공항철도 1호선	영종	1799	1829	20180129	3628
20180113	공항철도 1호선	공항화물청사	1734	1894	20180116	3628
20180204	6호선	청구	1783	1844	20180207	3627
20180129	3호선	학여울	1825	1802	20180201	3627
20180114	6호선	청구	1780	1847	20180117	3627
20180124	4호선	동작(현충원)	1784	1842	20180127	3626
20180114	경의선	월롱	1143	2483	20180117	3626
20180129	경원선	서빙고	1763	1861	20180201	3624
20180126	장항선	쌍용(나사렛대)	1896	1727	20180129	3623
20180128	6호선	독바위	1629	1990	20180131	3619
20180211	9호선	신목동	1888	1729	20180214	3617
20180123	경강선	삼동	1960	1656	20180126	3616
20180206	경부선	지제	1819	1796	20180209	3615
20180128	수인선	송도	1800	1815	20180131	3615
20180117	안산선	신길온천	1935	1679	20180120	3614
20180130	경의선	홍대입구	1576	2037	20180202	3613
20180128	분당선	대모산입구	1827	1785	20180131	3612
20180119	7호선	장암	2672	940	20180122	3612
20180115	경원선	응봉	1953	1659	20180118	3612
20180211	9호선2단계	삼성중앙	1768	1842	20180214	3610
20180113	경춘선	별내	1842	1768	20180116	3610
20180206	중앙선	양원	1745	1864	20180209	3609
20180119	우이신설선	신설동	1711	1896	20180122	3607
20180127	경원선	동두천	1721	1883	20180130	3604
20180121	9호선2단계	삼성중앙	1734	1870	20180124	3604
20180112	과천선	대공원	1741	1861	20180115	3602
20180118	경원선	응봉	1932	1669	20180121	3601
20180117	중앙선	양수	1792	1809	20180120	3601
20180128	우이신설선	화계	1828	1772	20180131	3600
20180126	경의선	홍대입구	1522	2077	20180129	3599
20180120	우이신설선	솔밭공원	1877	1722	20180123	3599
20180113	경의선	강매	1829	1768	20180116	3597
20180205	경원선	보산	1764	1831	20180208	3595
20180120	경원선	보산	1837	1756	20180123	3593
20180206	경강선	삼동	1949	1643	20180209	3592
20180206	공항철도 1호선	영종	1788	1804	20180209	3592
20180126	경원선	서빙고	1758	1834	20180129	3592
20180205	장항선	쌍용(나사렛대)	1893	1698	20180208	3591
20180122	수인선	신포	1752	1838	20180125	3590
20180208	경강선	여주	1801	1788	20180211	3589
20180201	우이신설선	신설동	1790	1798	20180204	3588
20180130	경부선	광명	1944	1644	20180202	3588
20180211	수인선	송도	1803	1783	20180214	3586
20180128	경부선	오산대	1796	1790	20180131	3586
20180127	우이신설선	삼양사거리	1779	1807	20180130	3586
20180203	중앙선	도심	1975	1610	20180206	3585
20180211	안산선	초지	1903	1681	20180214	3584
20180124	공항철도 1호선	영종	1807	1777	20180127	3584
20180124	경부선	지제	1865	1718	20180127	3583
20180206	경강선	곤지암	1811	1771	20180209	3582
20180203	장항선	쌍용(나사렛대)	1936	1645	20180206	3581
20180130	우이신설선	신설동	1823	1758	20180202	3581
20180129	경춘선	청평	1799	1781	20180201	3580
20180208	수인선	신포	1746	1829	20180211	3575
20180204	6호선	독바위	1642	1932	20180207	3574
20180207	경의선	홍대입구	1550	2023	20180210	3573
20180204	경의선	월롱	1237	2336	20180207	3573
20180118	안산선	신길온천	1874	1699	20180121	3573
20180113	경부선	광명	2016	1557	20180116	3573
20180211	6호선	독바위	1622	1950	20180214	3572
20180201	중앙선	양원	1767	1803	20180204	3570
20180121	2호선	용답	1760	1809	20180124	3569
20180113	경원선	보산	1874	1692	20180116	3566
20180124	경원선	덕계	1843	1722	20180127	3565
20180124	과천선	경마공원	1793	1772	20180127	3565
20180208	우이신설선	신설동	1736	1827	20180211	3563
20180203	6호선	버티고개	1818	1742	20180206	3560
20180212	경의선	홍대입구	1585	1974	20180215	3559
20180114	경원선	동두천	1569	1990	20180117	3559
20180113	6호선	버티고개	1848	1709	20180116	3557
20180127	5호선	영등포구청	1715	1840	20180130	3555
20180120	4호선	남태령	2683	870	20180123	3553
20180130	경춘선	가평	1779	1771	20180202	3550
20180125	경강선	곤지암	1785	1765	20180128	3550
20180115	중앙선	양수	1789	1761	20180118	3550
20180120	경원선	덕계	1870	1679	20180123	3549
20180113	우이신설선	솔밭공원	1864	1684	20180116	3548
20180127	공항철도 1호선	공항화물청사	1698	1849	20180130	3547
20180129	경부선	광명	1940	1605	20180201	3545
20180208	중앙선	양수	1725	1819	20180211	3544
20180115	경부선	광명	1938	1603	20180118	3541
20180203	경의선	강매	1845	1693	20180206	3538
20180114	수인선	숭의	1849	1689	20180117	3538
20180211	경의선	월롱	1183	2354	20180214	3537
20180117	우이신설선	신설동	1732	1804	20180120	3536
20180125	과천선	경마공원	1712	1823	20180128	3535
20180130	우이신설선	보문	1812	1722	20180202	3534
20180126	경강선	곤지암	1827	1707	20180129	3534
20180125	4호선	남태령	2529	1005	20180128	3534
20180123	경춘선	가평	1754	1779	20180126	3533
20180127	2호선	용두(동대문구청)	1719	1813	20180130	3532
20180114	경춘선	춘천	1962	1570	20180117	3532
20180120	공항철도 1호선	공덕	1493	2038	20180123	3531
20180129	경강선	삼동	1906	1621	20180201	3527
20180203	경원선	보산	1812	1713	20180206	3525
20180115	우이신설선	신설동	1737	1787	20180118	3524
20180131	경부선	광명	1902	1619	20180203	3521
20180124	분당선	구룡	1773	1748	20180127	3521
20180114	6호선	창신	1845	1676	20180117	3521
20180207	경원선	응봉	1900	1620	20180210	3520
20180120	경의선	수색	1732	1787	20180123	3519
20180206	경원선	응봉	1875	1643	20180209	3518
20180128	9호선	신목동	1829	1688	20180131	3517
20180206	중앙선	용문	1766	1749	20180209	3515
20180128	경춘선	가평	1701	1812	20180131	3513
20180204	경춘선	퇴계원	1814	1698	20180207	3512
20180201	경부선	광명	2000	1511	20180204	3511
20180125	분당선	구룡	1795	1716	20180128	3511
20180125	경부선	지제	1810	1700	20180128	3510
20180114	수인선	월곶	1817	1688	20180117	3505
20180128	6호선	창신	1844	1659	20180131	3503
20180125	중앙선	양수	1760	1743	20180128	3503
20180115	경부선	진위	1831	1672	20180118	3503
20180204	경부선	오산대	1714	1787	20180207	3501
20180120	우이신설선	삼양	1689	1809	20180123	3498
20180121	경의선	월롱	1231	2266	20180124	3497
20180201	중앙선	양수	1747	1749	20180204	3496
20180211	경춘선	퇴계원	1791	1704	20180214	3495
20180127	우이신설선	4.19민주묘지	1762	1732	20180130	3494
20180123	우이신설선	북한산우이	1873	1620	20180126	3493
20180122	우이신설선	신설동	1684	1808	20180125	3492
20180204	안산선	초지	1868	1622	20180207	3490
20180127	경춘선	청평	1728	1762	20180130	3490
20180121	6호선	창신	1856	1634	20180124	3490
20180128	안산선	초지	1903	1586	20180131	3489
20180126	경춘선	가평	1595	1894	20180129	3489
20180128	경부선	세마	1800	1687	20180131	3487
20180124	4호선	남태령	2470	1015	20180127	3485
20180124	경강선	삼동	1876	1608	20180127	3484
20180113	경의선	수색	1720	1763	20180116	3483
20180203	경강선	곤지암	1845	1637	20180206	3482
20180118	우이신설선	신설동	1696	1786	20180121	3482
20180205	수인선	신포	1679	1801	20180208	3480
20180125	공항철도 1호선	영종	1770	1710	20180128	3480
20180201	경춘선	가평	1676	1799	20180204	3475
20180126	분당선	구룡	1798	1677	20180129	3475
20180212	경원선	응봉	1868	1605	20180215	3473
20180206	경춘선	가평	1731	1742	20180209	3473
20180117	7호선	장암	2599	874	20180120	3473
20180128	6호선	청구	1679	1793	20180131	3472
20180206	수인선	신포	1703	1768	20180209	3471
20180129	경원선	응봉	1869	1600	20180201	3469
20180118	경의선	화전	1818	1651	20180121	3469
20180114	경강선	여주	1814	1652	20180117	3466
20180115	경강선	여주	1743	1722	20180118	3465
20180125	경원선	서빙고	1681	1783	20180128	3464
20180113	4호선	동작(현충원)	1725	1739	20180116	3464
20180207	경춘선	가평	1719	1744	20180210	3463
20180205	우이신설선	신설동	1686	1777	20180208	3463
20180212	수인선	신포	1721	1741	20180215	3462
20180115	안산선	신길온천	1841	1620	20180118	3461
20180117	경의선	화전	1797	1663	20180120	3460
20180131	안산선	신길온천	1856	1603	20180203	3459
20180211	경의선	홍대입구	1474	1983	20180214	3457
20180126	중앙선	용문	1590	1867	20180129	3457
20180207	경부선	광명	1886	1568	20180210	3454
20180129	우이신설선	북한산우이	1803	1650	20180201	3453
20180128	경춘선	청평	1939	1512	20180131	3451
20180125	경강선	삼동	1884	1565	20180128	3449
20180203	경의선	디지털미디어시티	1797	1648	20180206	3445
20180123	경부선	광명	1870	1573	20180126	3443
20180112	경부선	진위	1952	1491	20180115	3443
20180127	공항철도 1호선	영종	1798	1644	20180130	3442
20180207	우이신설선	신설동	1657	1783	20180210	3440
20180112	경강선	삼동	1925	1513	20180115	3438
20180112	수인선	신포	1693	1745	20180115	3438
20180206	우이신설선	북한산우이	1795	1641	20180209	3436
20180112	경춘선	청평	1732	1698	20180115	3430
20180203	5호선	동대문역사문화공원	1511	1918	20180206	3429
20180122	7호선	장암	2628	801	20180125	3429
20180212	과천선	대공원	1644	1783	20180215	3427
20180128	경춘선	사릉	1728	1697	20180131	3425
20180205	우이신설선	북한산우이	1814	1610	20180208	3424
20180119	중앙선	양원	1735	1688	20180122	3423
20180112	경원선	응봉	1876	1545	20180115	3421
20180206	경부선	광명	1934	1483	20180209	3417
20180124	경원선	서빙고	1702	1715	20180127	3417
20180117	경부선	광명	1872	1544	20180120	3416
20180113	경의선	디지털미디어시티	1719	1697	20180116	3416
20180205	경원선	응봉	1826	1589	20180208	3415
20180122	경강선	여주	1731	1681	20180125	3412
20180113	우이신설선	삼양	1653	1758	20180116	3411
20180113	공항철도 1호선	공덕	1409	1999	20180116	3408
20180114	경춘선	청평	1880	1526	20180117	3406
20180131	경춘선	가평	1709	1692	20180203	3401
20180114	경춘선	가평	1692	1708	20180117	3400
20180203	경의선	서강대	1683	1715	20180206	3398
20180204	수인선	송도	1665	1732	20180207	3397
20180122	경원선	보산	1825	1572	20180125	3397
20180212	우이신설선	신설동	1642	1752	20180215	3394
20180120	경의선	효창공원앞	1668	1723	20180123	3391
20180211	경춘선	사릉	1688	1702	20180214	3390
20180125	우이신설선	북한산우이	1771	1619	20180128	3390
20180204	경춘선	사릉	1723	1666	20180207	3389
20180203	우이신설선	삼양	1628	1760	20180206	3388
20180127	경의선	월롱	1957	1431	20180130	3388
20180119	경춘선	춘천	1850	1537	20180122	3387
20180127	분당선	보정	1853	1533	20180130	3386
20180211	수인선	숭의	1772	1608	20180214	3380
20180118	2호선	신답	1573	1807	20180121	3380
20180117	경부선	진위	1796	1581	20180120	3377
20180118	경부선	진위	1754	1622	20180121	3376
20180211	중앙선	용문	1781	1593	20180214	3374
20180128	경의선	월롱	1032	2342	20180131	3374
20180130	안산선	신길온천	1762	1610	20180202	3372
20180122	안산선	신길온천	1818	1552	20180125	3370
20180211	5호선	충정로(경기대입구)	1692	1675	20180214	3367
20180208	2호선	신답	1577	1789	20180211	3366
20180123	경의선	홍대입구	1446	1920	20180126	3366
20180212	7호선	장암	2558	805	20180215	3363
20180203	4호선	동작(현충원)	1639	1724	20180206	3363
20180114	장항선	쌍용(나사렛대)	1638	1724	20180117	3362
20180208	안산선	신길온천	1800	1559	20180211	3359
20180117	2호선	신답	1544	1815	20180120	3359
20180112	경춘선	가평	1629	1727	20180115	3356
20180123	경원선	응봉	1792	1563	20180126	3355
20180212	중앙선	양수	1681	1673	20180215	3354
20180206	우이신설선	신설동	1633	1721	20180209	3354
20180126	과천선	대공원	1681	1673	20180129	3354
20180203	공항철도 1호선	공덕	1423	1929	20180206	3352
20180126	경강선	삼동	1852	1500	20180129	3352
20180128	2호선	용답	1652	1696	20180131	3348
20180206	경춘선	청평	1746	1601	20180209	3347
20180113	수인선	신포	1548	1797	20180116	3345
20180119	9호선	동작(현충원)	1908	1431	20180122	3339
20180118	중앙선	양원	1650	1689	20180121	3339
20180129	경의선	홍대입구	1458	1880	20180201	3338
20180127	경강선	초월	1832	1506	20180130	3338
20180211	2호선	용답	1646	1690	20180214	3336
20180128	수인선	월곶	1698	1637	20180131	3335
20180124	우이신설선	북한산우이	1733	1602	20180127	3335
20180122	경부선	진위	1756	1578	20180125	3334
20180118	7호선	장암	2577	757	20180121	3334
20180211	경춘선	가평	1703	1629	20180214	3332
20180128	5호선	충정로(경기대입구)	1659	1673	20180131	3332
20180130	2호선	신답	1463	1868	20180202	3331
20180126	경강선	부발	1953	1377	20180129	3330
20180114	5호선	신길	1527	1800	20180117	3327
20180207	안산선	신길온천	1741	1584	20180210	3325
20180203	경원선	덕계	1764	1561	20180206	3325
20180114	3호선	학여울	1600	1724	20180117	3324
20180204	2호선	용답	1652	1671	20180207	3323
20180127	우이신설선	솔밭공원	1721	1601	20180130	3322
20180123	경춘선	청평	1743	1575	20180126	3318
20180114	분당선	대모산입구	1704	1614	20180117	3318
20180203	중앙선	양수	1635	1681	20180206	3316
20180125	과천선	대공원	1601	1715	20180128	3316
20180119	경부선	서동탄	1779	1537	20180122	3316
20180118	경강선	여주	1665	1651	20180121	3316
20180121	공항철도 1호선	영종	1629	1685	20180124	3314
20180212	안산선	신길온천	1776	1537	20180215	3313
20180112	경강선	여주	1636	1676	20180115	3312
20180212	2호선	신답	1520	1791	20180215	3311
20180130	9호선	동작(현충원)	1908	1402	20180202	3310
20180208	경원선	보산	1669	1640	20180211	3309
20180120	경춘선	갈매	1709	1598	20180123	3307
20180122	중앙선	양원	1646	1660	20180125	3306
20180129	우이신설선	신설동	1624	1680	20180201	3304
20180117	중앙선	양원	1659	1642	20180120	3301
20180201	7호선	장암	2489	811	20180204	3300
20180112	경강선	부발	1909	1390	20180115	3299
20180126	경춘선	청평	1668	1630	20180129	3298
20180208	경부선	진위	1726	1569	20180211	3295
20180124	경강선	곤지암	1679	1614	20180127	3293
20180207	2호선	신답	1499	1792	20180210	3291
20180207	경부선	진위	1754	1535	20180210	3289
20180127	장항선	쌍용(나사렛대)	1723	1566	20180130	3289
20180124	중앙선	용문	1628	1661	20180127	3289
20180123	우이신설선	신설동	1589	1700	20180126	3289
20180126	경부선	진위	1853	1435	20180129	3288
20180130	중앙선	양수	1635	1651	20180202	3286
20180211	수인선	월곶	1662	1623	20180214	3285
20180112	우이신설선	북한산우이	1719	1566	20180115	3285
20180117	경강선	여주	1649	1634	20180120	3283
20180130	2호선	도림천	1546	1735	20180202	3281
20180114	분당선	매교	1655	1626	20180117	3281
20180123	경강선	여주	1654	1626	20180126	3280
20180120	경부선	광명	1716	1563	20180123	3279
20180204	9호선	구반포	1531	1747	20180207	3278
20180115	7호선	장암	2535	743	20180118	3278
20180119	2호선	신답	1575	1702	20180122	3277
20180130	7호선	장암	2498	777	20180202	3275
20180207	중앙선	양수	1614	1660	20180210	3274
20180121	5호선	신길	1519	1754	20180124	3273
20180120	5호선	동대문역사문화공원	1415	1858	20180123	3273
20180128	경의선	홍대입구	1426	1846	20180131	3272
20180128	수인선	숭의	1717	1554	20180131	3271
20180120	수인선	신포	1520	1751	20180123	3271
20180208	7호선	장암	2475	794	20180211	3269
20180113	경의선	효창공원앞	1617	1652	20180116	3269
20180204	5호선	오금	1609	1659	20180207	3268
20180201	안산선	신길온천	1728	1540	20180204	3268
20180131	2호선	신답	1528	1736	20180203	3264
20180211	경춘선	청평	1745	1518	20180214	3263
20180115	중앙선	양원	1620	1643	20180118	3263
20180131	중앙선	양원	1623	1639	20180203	3262
20180131	9호선	동작(현충원)	1885	1376	20180203	3261
20180125	경부선	광명	1826	1435	20180128	3261
20180115	2호선	신답	1498	1763	20180118	3261
20180118	경원선	보산	1686	1573	20180121	3259
20180115	9호선	동작(현충원)	1877	1380	20180118	3257
20180122	경춘선	금곡	1666	1589	20180125	3255
20180131	경원선	보산	1672	1579	20180203	3251
20180122	경의선	화전	1701	1550	20180125	3251
20180117	경원선	보산	1678	1570	20180120	3248
20180119	장항선	봉명	1669	1578	20180122	3247
20180112	안산선	신길온천	1756	1491	20180115	3247
20180211	5호선	신길	1542	1704	20180214	3246
20180204	5호선	충정로(경기대입구)	1606	1640	20180207	3246
20180121	5호선	오금	1611	1635	20180124	3246
20180120	수인선	인천	1191	2054	20180123	3245
20180128	5호선	신길	1496	1748	20180131	3244
20180127	6호선	버티고개	1667	1576	20180130	3243
20180113	경원선	덕계	1677	1565	20180116	3242
20180204	분당선	대모산입구	1625	1616	20180207	3241
20180130	경강선	여주	1616	1625	20180202	3241
20180112	경의선	화전	1728	1512	20180115	3240
20180204	경춘선	가평	1636	1602	20180207	3238
20180201	2호선	신답	1465	1773	20180204	3238
20180120	경강선	부발	1748	1487	20180123	3235
20180127	공항철도 1호선	공덕	1340	1894	20180130	3234
20180123	수인선	신포	1593	1641	20180126	3234
20180203	분당선	구룡	1730	1502	20180206	3232
20180212	경강선	여주	1614	1616	20180215	3230
20180114	경부선	지제	1614	1616	20180117	3230
20180211	분당선	매교	1623	1606	20180214	3229
20180121	우이신설선	4.19민주묘지	1696	1533	20180124	3229
20180117	9호선	동작(현충원)	1863	1365	20180120	3228
20180123	경부선	진위	1700	1523	20180126	3223
20180204	수인선	숭의	1661	1561	20180207	3222
20180211	9호선	구반포	1589	1632	20180214	3221
20180128	경원선	동두천	1399	1821	20180131	3220
20180121	분당선	대모산입구	1615	1605	20180124	3220
20180131	경강선	여주	1587	1631	20180203	3218
20180203	경의선	효창공원앞	1603	1614	20180206	3217
20180126	우이신설선	신설동	1592	1624	20180129	3216
20180122	2호선	신답	1472	1743	20180125	3215
20180114	우이신설선	4.19민주묘지	1637	1578	20180117	3215
20180205	7호선	장암	2504	710	20180208	3214
20180127	경의선	서강대	1557	1653	20180130	3210
20180121	5호선	영등포구청	1626	1581	20180124	3207
20180204	경춘선	청평	1753	1453	20180207	3206
20180112	7호선	장암	2375	829	20180115	3204
20180212	경부선	진위	1707	1495	20180215	3202
20180124	과천선	대공원	1556	1646	20180127	3202
20180211	경원선	동두천	1359	1842	20180214	3201
20180114	5호선	오금	1609	1592	20180117	3201
20180129	안산선	신길온천	1709	1489	20180201	3198
20180131	7호선	장암	2439	757	20180203	3196
20180121	5호선	충정로(경기대입구)	1537	1656	20180124	3193
20180127	경춘선	별내	1603	1587	20180130	3190
20180204	수인선	월곶	1614	1575	20180207	3189
20180201	경원선	보산	1649	1540	20180204	3189
20180113	중앙선	양수	1565	1624	20180116	3189
20180207	경원선	보산	1662	1526	20180210	3188
20180126	경강선	여주	1587	1601	20180129	3188
20180123	경의선	화전	1655	1533	20180126	3188
20180114	5호선	충정로(경기대입구)	1600	1588	20180117	3188
20180117	경춘선	금곡	1653	1533	20180120	3186
20180206	7호선	장암	2403	773	20180209	3176
20180204	경원선	동두천	1404	1771	20180207	3175
20180206	경의선	홍대입구	1429	1745	20180209	3174
20180113	경의선	서울역	1489	1684	20180116	3173
20180201	경부선	진위	1655	1517	20180204	3172
20180208	우이신설선	보문	1570	1600	20180211	3170
20180203	경춘선	춘천	1691	1479	20180206	3170
20180127	중앙선	도심	1694	1476	20180130	3170
20180208	경강선	부발	1654	1515	20180211	3169
20180201	경강선	여주	1582	1586	20180204	3168
20180123	7호선	장암	2440	727	20180126	3167
20180119	경춘선	금곡	1605	1561	20180122	3166
20180211	5호선	을지로4가	1491	1674	20180214	3165
20180205	안산선	신길온천	1709	1456	20180208	3165
20180127	경강선	곤지암	1674	1491	20180130	3165
20180124	경의선	홍대입구	1362	1803	20180127	3165
20180129	수인선	신포	1579	1584	20180201	3163
20180124	경부선	광명	1765	1398	20180127	3163
20180121	분당선	매교	1568	1595	20180124	3163
20180201	9호선	동작(현충원)	1789	1371	20180204	3160
20180204	경의선	홍대입구	1403	1756	20180207	3159
20180129	7호선	장암	2434	725	20180201	3159
20180206	안산선	신길온천	1641	1516	20180209	3157
20180126	우이신설선	북한산우이	1653	1504	20180129	3157
20180206	중앙선	양수	1530	1626	20180209	3156
20180204	경부선	세마	1645	1511	20180207	3156
20180115	경춘선	금곡	1653	1502	20180118	3155
20180207	7호선	장암	2394	760	20180210	3154
20180205	경강선	여주	1580	1574	20180208	3154
20180120	경의선	서울역	1541	1613	20180123	3154
20180126	7호선	장암	2406	745	20180129	3151
20180113	경강선	부발	1751	1400	20180116	3151
20180118	9호선	동작(현충원)	1782	1366	20180121	3148
20180128	9호선	구반포	1505	1642	20180131	3147
20180121	경춘선	별내	1587	1560	20180124	3147
20180124	우이신설선	신설동	1490	1654	20180127	3144
20180212	경강선	부발	1615	1528	20180215	3143
20180131	경부선	진위	1666	1477	20180203	3143
20180114	9호선	구반포	1493	1647	20180117	3140
20180112	우이신설선	신설동	1499	1637	20180115	3136
20180212	9호선	동작(현충원)	1722	1413	20180215	3135
20180131	경강선	부발	1604	1530	20180203	3134
20180125	경원선	응봉	1654	1477	20180128	3131
20180122	경강선	부발	1598	1532	20180125	3130
20180205	중앙선	양수	1568	1561	20180208	3129
20180128	5호선	오금	1568	1561	20180131	3129
20180125	경춘선	청평	1574	1555	20180128	3129
20180204	5호선	신길	1439	1689	20180207	3128
20180123	중앙선	양수	1532	1596	20180126	3128
20180130	중앙선	양원	1499	1623	20180202	3122
20180121	9호선	구반포	1515	1607	20180124	3122
20180205	경부선	진위	1630	1488	20180208	3118
20180113	5호선	동대문역사문화공원	1424	1694	20180116	3118
20180125	우이신설선	신설동	1515	1602	20180128	3117
20180123	안산선	신길온천	1675	1439	20180126	3114
20180206	경원선	보산	1589	1521	20180209	3110
20180123	중앙선	양원	1526	1582	20180126	3108
20180121	장항선	쌍용(나사렛대)	1541	1566	20180124	3107
20180124	경춘선	가평	1521	1585	20180127	3106
20180127	우이신설선	삼양	1539	1564	20180130	3103
20180121	중앙선	양수	1628	1473	20180124	3101
20180129	2호선	신답	1430	1665	20180201	3095
20180201	경의선	화전	1601	1493	20180204	3094
20180121	경원선	보산	1487	1605	20180124	3092
20180205	2호선	신답	1417	1674	20180208	3091
20180129	경강선	여주	1603	1487	20180201	3090
20180124	수인선	신포	1545	1544	20180127	3089
20180130	경춘선	금곡	1624	1464	20180202	3088
20180129	경원선	보산	1596	1491	20180201	3087
20180114	우이신설선	삼양사거리	1546	1539	20180117	3085
20180205	우이신설선	보문	1470	1614	20180208	3084
20180115	경부선	서동탄	1646	1438	20180118	3084
20180208	9호선	동작(현충원)	1783	1298	20180211	3081
20180131	2호선	도림천	1436	1645	20180203	3081
20180129	중앙선	양수	1580	1501	20180201	3081
20180206	2호선	신답	1445	1634	20180209	3079
20180128	경강선	여주	1577	1502	20180131	3079
20180121	경부선	지제	1585	1493	20180124	3078
20180131	경의선	화전	1572	1505	20180203	3077
20180120	경원선	서빙고	1543	1532	20180123	3075
20180117	경부선	서동탄	1638	1437	20180120	3075
20180126	안산선	신길온천	1643	1431	20180129	3074
20180211	5호선	오금	1572	1500	20180214	3072
20180211	우이신설선	4.19민주묘지	1551	1520	20180214	3071
20180115	장항선	봉명	1540	1531	20180118	3071
20180126	경원선	응봉	1640	1430	20180129	3070
20180117	우이신설선	보문	1495	1575	20180120	3070
20180117	경강선	부발	1584	1484	20180120	3068
20180126	수인선	신포	1504	1562	20180129	3066
20180130	경원선	보산	1595	1470	20180202	3065
20180125	7호선	장암	2372	693	20180128	3065
20180127	경의선	강매	1623	1441	20180130	3064
20180127	경의선	수색	1555	1508	20180130	3063
20180122	장항선	봉명	1540	1520	20180125	3060
20180212	경원선	보산	1624	1434	20180215	3058
20180207	우이신설선	보문	1496	1561	20180210	3057
20180211	분당선	대모산입구	1551	1505	20180214	3056
20180205	2호선	도림천	1442	1614	20180208	3056
20180118	경춘선	금곡	1585	1471	20180121	3056
20180127	4호선	동작(현충원)	1507	1547	20180130	3054
20180115	경의선	화전	1567	1486	20180118	3053
20180131	경춘선	금곡	1584	1468	20180203	3052
20180127	3호선	학여울	1509	1542	20180130	3051
20180119	우이신설선	보문	1519	1532	20180122	3051
20180203	경강선	부발	1675	1375	20180206	3050
20180115	경강선	부발	1567	1483	20180118	3050
20180212	우이신설선	보문	1471	1578	20180215	3049
20180204	분당선	매교	1518	1529	20180207	3047
20180201	2호선	도림천	1442	1605	20180204	3047
20180127	경의선	효창공원앞	1520	1525	20180130	3045
20180129	과천선	대공원	1450	1594	20180201	3044
20180119	일산선	대곡	1756	1288	20180122	3044
20180118	경강선	부발	1584	1460	20180121	3044
20180205	경의선	홍대입구	1355	1688	20180208	3043
20180123	2호선	신답	1386	1657	20180126	3043
20180131	우이신설선	보문	1421	1620	20180203	3041
20180208	경춘선	금곡	1528	1511	20180211	3039
20180124	경부선	진위	1579	1460	20180127	3039
20180113	경춘선	갈매	1580	1455	20180116	3035
20180206	경부선	진위	1598	1436	20180209	3034
20180124	경원선	응봉	1668	1366	20180127	3034
20180128	분당선	매교	1507	1526	20180131	3033
20180125	경춘선	가평	1462	1571	20180128	3033
20180114	경원선	보산	1521	1512	20180117	3033
20180206	우이신설선	보문	1451	1580	20180209	3031
20180128	우이신설선	4.19민주묘지	1626	1405	20180131	3031
20180122	경춘선	천마산	1585	1445	20180125	3030
20180201	경강선	부발	1580	1447	20180204	3027
20180125	경의선	홍대입구	1312	1713	20180128	3025
20180127	경원선	덕계	1593	1431	20180130	3024
20180201	우이신설선	보문	1459	1564	20180204	3023
20180124	경춘선	청평	1621	1401	20180127	3022
20180207	9호선	동작(현충원)	1730	1291	20180210	3021
20180127	경의선	디지털미디어시티	1511	1510	20180130	3021
20180119	경춘선	천마산	1583	1437	20180122	3020
20180203	경부선	광명	1702	1315	20180206	3017
20180128	우이신설선	삼양사거리	1487	1530	20180131	3017
20180121	우이신설선	삼양사거리	1514	1499	20180124	3013
20180204	우이신설선	삼양사거리	1489	1522	20180207	3011
20180201	경부선	서동탄	1635	1373	20180204	3008
20180127	5호선	동대문역사문화공원	1383	1625	20180130	3008
20180123	경원선	보산	1547	1460	20180126	3007
20180205	경강선	부발	1507	1499	20180208	3006
20180201	경춘선	금곡	1558	1447	20180204	3005
20180125	경부선	진위	1586	1417	20180128	3003
20180124	안산선	신길온천	1570	1432	20180127	3002
20180123	우이신설선	보문	1448	1549	20180126	2997
20180122	경부선	서동탄	1633	1357	20180125	2990
20180203	경원선	서빙고	1508	1480	20180206	2988
20180131	경부선	서동탄	1619	1365	20180203	2984
20180130	경의선	화전	1537	1442	20180202	2979
20180125	경강선	여주	1504	1475	20180128	2979
20180128	공항철도 1호선	영종	1413	1565	20180131	2978
20180118	경부선	서동탄	1610	1368	20180121	2978
20180125	안산선	신길온천	1569	1408	20180128	2977
20180114	경강선	곤지암	1488	1483	20180117	2971
20180125	수인선	신포	1438	1532	20180128	2970
20180117	경춘선	천마산	1556	1414	20180120	2970
20180212	경부선	서동탄	1621	1348	20180215	2969
20180130	경부선	진위	1565	1402	20180202	2967
20180126	경원선	보산	1608	1358	20180129	2966
20180114	경의선	공덕	1538	1428	20180117	2966
20180205	9호선	동작(현충원)	1729	1236	20180208	2965
20180129	우이신설선	보문	1473	1492	20180201	2965
20180122	경춘선	춘천	1532	1432	20180125	2964
20180114	공항철도 1호선	영종	1426	1537	20180117	2963
20180129	9호선	동작(현충원)	1680	1279	20180201	2959
20180117	일산선	대곡	1717	1241	20180120	2958
20180211	경강선	여주	1495	1462	20180214	2957
20180115	우이신설선	보문	1470	1486	20180118	2956
20180112	2호선	신답	1372	1581	20180115	2953
20180112	중앙선	양원	1499	1453	20180115	2952
20180203	경춘선	갈매	1530	1419	20180206	2949
20180127	경춘선	춘천	1544	1404	20180130	2948
20180124	7호선	장암	2271	677	20180127	2948
20180121	경의선	공덕	1528	1418	20180124	2946
20180118	우이신설선	보문	1416	1530	20180121	2946
20180117	장항선	봉명	1509	1437	20180120	2946
20180120	안산선	신길온천	1573	1372	20180123	2945
20180207	경강선	부발	1531	1412	20180210	2943
20180206	경강선	여주	1495	1448	20180209	2943
20180119	3호선	지축	1371	1569	20180122	2940
20180113	안산선	신길온천	1580	1360	20180116	2940
20180113	경원선	서빙고	1437	1503	20180116	2940
20180121	우이신설선	솔밭공원	1498	1439	20180124	2937
20180129	경부선	진위	1509	1425	20180201	2934
20180127	중앙선	양수	1518	1416	20180130	2934
20180204	우이신설선	4.19민주묘지	1506	1425	20180207	2931
20180121	경강선	곤지암	1473	1456	20180124	2929
20180211	우이신설선	삼양사거리	1475	1453	20180214	2928
20180129	중앙선	양원	1459	1469	20180201	2928
20180129	경강선	부발	1466	1460	20180201	2926
20180117	3호선	지축	1397	1529	20180120	2926
20180127	경원선	보산	1509	1416	20180130	2925
20180127	경부선	광명	1592	1332	20180130	2924
20180121	5호선	을지로4가	1376	1548	20180124	2924
20180122	우이신설선	보문	1431	1491	20180125	2922
20180212	중앙선	양원	1442	1476	20180215	2918
20180121	중앙선	도심	1468	1448	20180124	2916
20180118	일산선	대곡	1670	1244	20180121	2914
20180126	우이신설선	보문	1424	1487	20180129	2911
20180125	우이신설선	보문	1381	1529	20180128	2910
20180114	경춘선	별내	1448	1461	20180117	2909
20180208	경부선	서동탄	1554	1354	20180211	2908
20180122	일산선	대곡	1690	1215	20180125	2905
20180122	3호선	지축	1322	1583	20180125	2905
20180120	경부선	서동탄	1494	1410	20180123	2904
20180212	장항선	봉명	1454	1448	20180215	2902
20180206	9호선	동작(현충원)	1689	1209	20180209	2898
20180204	5호선	영등포구청	1452	1445	20180207	2897
20180117	2호선	도림천	1389	1507	20180120	2896
20180212	경의선	화전	1512	1383	20180215	2895
20180122	2호선	도림천	1364	1528	20180125	2892
20180114	중앙선	도심	1487	1404	20180117	2891
20180206	2호선	도림천	1370	1520	20180209	2890
20180112	중앙선	양수	1449	1440	20180115	2889
20180208	일산선	대곡	1655	1233	20180211	2888
20180128	경부선	지제	1521	1364	20180131	2885
20180211	공항철도 1호선	영종	1410	1473	20180214	2883
20180207	2호선	도림천	1367	1514	20180210	2881
20180115	2호선	도림천	1364	1516	20180118	2880
20180208	장항선	봉명	1441	1438	20180211	2879
20180207	경강선	여주	1473	1406	20180210	2879
20180118	장항선	봉명	1453	1425	20180121	2878
20180130	경춘선	천마산	1465	1412	20180202	2877
20180126	2호선	신답	1385	1492	20180129	2877
20180115	경춘선	천마산	1499	1376	20180118	2875
20180120	9호선	동작(현충원)	1623	1250	20180123	2873
20180131	3호선	지축	1343	1528	20180203	2871
20180114	우이신설선	솔밭공원	1462	1409	20180117	2871
20180127	경강선	부발	1565	1303	20180130	2868
20180124	경원선	보산	1485	1371	20180127	2856
20180125	중앙선	양원	1406	1449	20180128	2855
20180204	경원선	보산	1444	1408	20180207	2852
20180129	경의선	화전	1459	1393	20180201	2852
20180204	경강선	여주	1481	1370	20180207	2851
20180118	2호선	도림천	1338	1512	20180121	2850
20180114	5호선	을지로4가	1280	1570	20180117	2850
20180130	경강선	부발	1498	1350	20180202	2848
20180204	경강선	곤지암	1438	1407	20180207	2845
20180121	경강선	초월	1430	1415	20180124	2845
20180120	경원선	응봉	1570	1275	20180123	2845
20180118	경춘선	천마산	1446	1399	20180121	2845
20180123	9호선	동작(현충원)	1680	1163	20180126	2843
20180115	일산선	대곡	1643	1199	20180118	2842
20180115	3호선	지축	1315	1526	20180118	2841
20180124	2호선	신답	1310	1530	20180127	2840
20180118	3호선	지축	1291	1549	20180121	2840
20180120	분당선	구룡	1467	1368	20180123	2835
20180205	과천선	대공원	1363	1471	20180208	2834
20180130	경부선	서동탄	1520	1314	20180202	2834
20180121	경의선	서강대	1482	1349	20180124	2831
20180128	경춘선	별내	1453	1377	20180131	2830
20180129	장항선	봉명	1396	1432	20180201	2828
20180121	공항철도 1호선	공항화물청사	1317	1509	20180124	2826
20180129	2호선	도림천	1364	1461	20180201	2825
20180205	경춘선	금곡	1503	1321	20180208	2824
20180112	경부선	서동탄	1528	1295	20180115	2823
20180208	경춘선	천마산	1507	1315	20180211	2822
20180124	경강선	여주	1412	1410	20180127	2822
20180118	경춘선	춘천	1509	1313	20180121	2822
20180207	경부선	서동탄	1526	1295	20180210	2821
20180204	공항철도 1호선	공항화물청사	1347	1474	20180207	2821
20180201	경춘선	천마산	1436	1384	20180204	2820
20180201	일산선	대곡	1638	1182	20180204	2820
20180206	경강선	부발	1488	1331	20180209	2819
20180126	경의선	화전	1509	1310	20180129	2819
20180119	2호선	도림천	1358	1461	20180122	2819
20180211	공항철도 1호선	공항화물청사	1289	1529	20180214	2818
20180128	경춘선	춘천	1505	1313	20180131	2818
20180113	분당선	구룡	1456	1359	20180116	2815
20180207	경춘선	금곡	1448	1366	20180210	2814
20180114	경강선	초월	1416	1397	20180117	2813
20180212	2호선	도림천	1327	1485	20180215	2812
20180123	경강선	부발	1468	1344	20180126	2812
20180131	장항선	봉명	1398	1411	20180203	2809
20180212	경춘선	금곡	1479	1328	20180215	2807
20180208	3호선	지축	1318	1487	20180211	2805
20180204	경춘선	춘천	1511	1294	20180207	2805
20180128	경강선	곤지암	1380	1425	20180131	2805
20180125	경원선	보산	1456	1342	20180128	2798
20180211	경원선	보산	1290	1506	20180214	2796
20180128	우이신설선	솔밭공원	1433	1360	20180131	2793
20180124	중앙선	양원	1393	1397	20180127	2790
20180204	장항선	쌍용(나사렛대)	1390	1398	20180207	2788
20180201	장항선	봉명	1389	1399	20180204	2788
20180130	3호선	지축	1292	1496	20180202	2788
20180124	우이신설선	보문	1355	1433	20180127	2788
20180112	9호선	동작(현충원)	1607	1181	20180115	2788
20180112	경춘선	금곡	1435	1352	20180115	2787
20180207	장항선	봉명	1380	1406	20180210	2786
20180126	9호선	동작(현충원)	1637	1147	20180129	2784
20180114	공항철도 1호선	공항화물청사	1325	1459	20180117	2784
20180112	장항선	봉명	1450	1333	20180115	2783
20180208	경의선	화전	1429	1351	20180211	2780
20180207	경춘선	천마산	1434	1346	20180210	2780
20180211	경춘선	별내	1395	1384	20180214	2779
20180112	우이신설선	보문	1353	1423	20180115	2776
20180125	2호선	신답	1292	1483	20180128	2775
20180113	수인선	인천	929	1846	20180116	2775
20180125	경강선	부발	1485	1283	20180128	2768
20180121	경부선	광명	1638	1130	20180124	2768
20180113	공항철도 1호선	인천공항2터미널	1430	1337	20180116	2767
20180128	경원선	보산	1355	1411	20180131	2766
20180123	2호선	도림천	1285	1480	20180126	2765
20180114	경부선	광명	1687	1077	20180117	2764
20180212	3호선	지축	1292	1471	20180215	2763
20180204	중앙선	도심	1475	1286	20180207	2761
20180207	3호선	지축	1295	1465	20180210	2760
20180205	경의선	화전	1409	1351	20180208	2760
20180130	일산선	대곡	1594	1166	20180202	2760
20180128	5호선	을지로4가	1257	1502	20180131	2759
20180121	4호선	동작(현충원)	1320	1437	20180124	2757
20180123	경부선	서동탄	1491	1265	20180126	2756
20180123	경춘선	금곡	1400	1356	20180126	2756
20180114	중앙선	양수	1454	1301	20180117	2755
20180211	경의선	공덕	1447	1306	20180214	2753
20180128	공항철도 1호선	공항화물청사	1272	1481	20180131	2753
20180212	일산선	대곡	1580	1172	20180215	2752
20180114	경의선	강매	1404	1347	20180117	2751
20180206	경의선	화전	1417	1330	20180209	2747
20180131	일산선	대곡	1558	1184	20180203	2742
20180114	경의선	서강대	1375	1366	20180117	2741
20180125	9호선	동작(현충원)	1581	1159	20180128	2740
20180211	경부선	지제	1437	1298	20180214	2735
20180204	우이신설선	솔밭공원	1404	1331	20180207	2735
20180201	3호선	지축	1245	1489	20180204	2734
20180114	4호선	동작(현충원)	1274	1456	20180117	2730
20180115	경춘선	춘천	1451	1278	20180118	2729
20180113	4호선	남태령	1970	759	20180116	2729
20180130	장항선	봉명	1330	1394	20180202	2724
20180124	9호선	동작(현충원)	1595	1125	20180127	2720
20180203	경원선	응봉	1472	1246	20180206	2718
20180125	2호선	도림천	1289	1429	20180128	2718
20180204	경의선	공덕	1431	1285	20180207	2716
20180121	경의선	강매	1305	1410	20180124	2715
20180117	경춘선	춘천	1391	1324	20180120	2715
20180204	경강선	초월	1350	1362	20180207	2712
20180205	3호선	지축	1209	1502	20180208	2711
20180112	2호선	도림천	1310	1400	20180115	2710
20180129	경춘선	금곡	1408	1301	20180201	2709
20180115	수인선	인천	1015	1694	20180118	2709
20180206	장항선	봉명	1383	1324	20180209	2707
20180208	2호선	도림천	1297	1407	20180211	2704
20180204	공항철도 1호선	영종	1274	1429	20180207	2703
20180121	경의선	디지털미디어시티	1371	1332	20180124	2703
20180120	경부선	진위	1462	1236	20180123	2698
20180206	경부선	서동탄	1465	1231	20180209	2696
20180121	우이신설선	삼양	1325	1371	20180124	2696
20180119	경강선	이매	1608	1085	20180122	2693
20180113	경부선	서동탄	1330	1362	20180116	2692
20180205	경부선	서동탄	1486	1204	20180208	2690
20180121	6호선	버티고개	1316	1374	20180124	2690
20180129	3호선	지축	1235	1454	20180201	2689
20180129	경부선	서동탄	1467	1220	20180201	2687
20180126	중앙선	양원	1346	1341	20180129	2687
20180211	경춘선	춘천	1467	1219	20180214	2686
20180204	5호선	을지로4가	1277	1409	20180207	2686
20180127	수인선	신포	1287	1399	20180130	2686
20180128	장항선	쌍용(나사렛대)	1357	1328	20180131	2685
20180124	2호선	도림천	1251	1433	20180127	2684
20180211	5호선	영등포구청	1356	1325	20180214	2681
20180121	수인선	인천	1054	1627	20180124	2681
20180131	경춘선	천마산	1402	1278	20180203	2680
20180128	경의선	공덕	1401	1277	20180131	2678
20180123	3호선	지축	1227	1451	20180126	2678
20180121	2호선	용두(동대문구청)	1311	1367	20180124	2678
20180124	경강선	부발	1392	1283	20180127	2675
20180207	경의선	화전	1357	1314	20180210	2671
20180127	경원선	서빙고	1318	1347	20180130	2665
20180212	경춘선	천마산	1402	1262	20180215	2664
20180203	안산선	신길온천	1406	1258	20180206	2664
20180204	경부선	지제	1370	1290	20180207	2660
20180120	경춘선	천마산	1393	1267	20180123	2660
20180207	일산선	대곡	1578	1081	20180210	2659
20180121	경원선	덕계	1387	1272	20180124	2659
20180211	경의선	서강대	1345	1310	20180214	2655
20180117	수인선	인천	980	1675	20180120	2655
20180203	경부선	서동탄	1313	1341	20180206	2654
20180126	경부선	서동탄	1446	1208	20180129	2654
20180204	우이신설선	삼양	1258	1395	20180207	2653
20180211	중앙선	양수	1323	1328	20180214	2651
20180128	경강선	부발	1105	1546	20180131	2651
20180112	경춘선	춘천	1435	1213	20180115	2648
20180211	6호선	버티고개	1319	1327	20180214	2646
20180205	경춘선	천마산	1393	1253	20180208	2646
20180128	5호선	영등포구청	1337	1309	20180131	2646
20180119	수인선	인천	930	1716	20180122	2646
20180211	경강선	곤지암	1331	1312	20180214	2643
20180201	경춘선	춘천	1447	1196	20180204	2643
20180126	2호선	도림천	1264	1379	20180129	2643
20180119	장항선	신창(순천향대)	1457	1181	20180122	2638
20180206	경춘선	금곡	1374	1256	20180209	2630
20180205	장항선	봉명	1296	1334	20180208	2630
20180112	일산선	대곡	1501	1125	20180115	2626
20180129	일산선	대곡	1502	1122	20180201	2624
20180123	장항선	봉명	1296	1328	20180126	2624
20180211	2호선	용두(동대문구청)	1327	1292	20180214	2619
20180114	5호선	영등포구청	1338	1280	20180117	2618
20180114	분당선	보정	1348	1267	20180117	2615
20180203	경의선	서울역	1181	1433	20180206	2614
20180113	경의선	화전	1422	1190	20180116	2612
20180125	경춘선	금곡	1329	1281	20180128	2610
20180211	우이신설선	솔밭공원	1343	1265	20180214	2608
20180127	경춘선	갈매	1379	1226	20180130	2605
20180118	경강선	이매	1577	1028	20180121	2605
20180131	경춘선	춘천	1356	1246	20180203	2602
20180121	9호선	사평	1280	1322	20180124	2602
20180211	장항선	쌍용(나사렛대)	1268	1331	20180214	2599
20180113	경부선	진위	1417	1182	20180116	2599
20180206	3호선	지축	1174	1418	20180209	2592
20180122	경강선	이매	1551	1039	20180125	2590
20180123	일산선	대곡	1492	1097	20180126	2589
20180126	경춘선	금곡	1345	1242	20180129	2587
20180114	경의선	효창공원앞	1199	1384	20180117	2583
20180208	경강선	이매	1544	1038	20180211	2582
20180206	경춘선	천마산	1346	1233	20180209	2579
20180128	중앙선	도심	1373	1205	20180131	2578
20180121	분당선	보정	1335	1243	20180124	2578
20180212	경강선	이매	1545	1032	20180215	2577
20180128	경의선	서강대	1340	1236	20180131	2576
20180114	공항철도 1호선	인천공항2터미널	1303	1271	20180117	2574
20180113	경원선	응봉	1373	1201	20180116	2574
20180205	일산선	대곡	1498	1069	20180208	2567
20180211	중앙선	도심	1362	1204	20180214	2566
20180114	공항철도 1호선	공덕	1162	1403	20180117	2565
20180207	경강선	이매	1514	1050	20180210	2564
20180114	경원선	덕계	1332	1229	20180117	2561
20180114	경강선	부발	1138	1422	20180117	2560
20180113	우이신설선	보문	1285	1275	20180116	2560
20180124	경춘선	금곡	1324	1235	20180127	2559
20180127	경의선	서울역	1228	1328	20180130	2556
20180121	경강선	부발	1108	1447	20180124	2555
20180115	경강선	이매	1531	1022	20180118	2553
20180131	경강선	이매	1522	1030	20180203	2552
20180204	9호선	사평	1248	1301	20180207	2549
20180204	경부선	광명	1524	1024	20180207	2548
20180121	공항철도 1호선	공덕	1134	1413	20180124	2547
20180204	분당선	보정	1355	1191	20180207	2546
20180204	2호선	용두(동대문구청)	1214	1332	20180207	2546
20180131	수인선	인천	917	1629	20180203	2546
20180204	경춘선	별내	1268	1276	20180207	2544
20180208	경춘선	춘천	1293	1248	20180211	2541
20180203	우이신설선	보문	1254	1287	20180206	2541
20180112	장항선	신창(순천향대)	1517	1023	20180115	2540
20180128	경부선	광명	1569	969	20180131	2538
20180114	6호선	버티고개	1256	1282	20180117	2538
20180124	경의선	화전	1344	1193	20180127	2537
20180206	일산선	대곡	1470	1066	20180209	2536
20180201	수인선	인천	874	1658	20180204	2532
20180130	경강선	이매	1497	1035	20180202	2532
20180204	중앙선	양수	1299	1231	20180207	2530
20180117	경강선	이매	1517	1013	20180120	2530
20180114	경의선	디지털미디어시티	1329	1199	20180117	2528
20180124	장항선	봉명	1272	1255	20180127	2527
20180125	경부선	서동탄	1359	1167	20180128	2526
20180204	경강선	부발	1083	1442	20180207	2525
20180201	경강선	이매	1512	1013	20180204	2525
20180130	수인선	인천	923	1601	20180202	2524
20180124	경부선	서동탄	1411	1107	20180127	2518
20180211	경의선	강매	1252	1263	20180214	2515
20180208	수인선	인천	892	1621	20180211	2513
20180125	경의선	화전	1297	1214	20180128	2511
20180128	경의선	효창공원앞	1210	1300	20180131	2510
20180123	경춘선	춘천	1254	1256	20180126	2510
20180120	경의선	화전	1364	1144	20180123	2508
20180121	경의선	효창공원앞	1221	1284	20180124	2505
20180122	수인선	인천	907	1597	20180125	2504
20180127	안산선	신길온천	1335	1167	20180130	2502
20180204	경의선	서강대	1242	1259	20180207	2501
20180212	수인선	인천	900	1597	20180215	2497
20180118	수인선	인천	899	1593	20180121	2492
20180204	공항철도 1호선	공덕	1088	1403	20180207	2491
20180211	경강선	초월	1217	1273	20180214	2490
20180211	9호선	사평	1195	1293	20180214	2488
20180205	경강선	이매	1466	1022	20180208	2488
20180129	경춘선	춘천	1290	1195	20180201	2485
20180112	경춘선	천마산	1290	1195	20180115	2485
20180123	경춘선	천마산	1292	1191	20180126	2483
20180125	일산선	대곡	1433	1049	20180128	2482
20180211	경의선	효창공원앞	1206	1275	20180214	2481
20180211	경강선	부발	1084	1393	20180214	2477
20180120	장항선	신창(순천향대)	1304	1173	20180123	2477
20180114	우이신설선	삼양	1201	1275	20180117	2476
20180126	일산선	대곡	1456	1017	20180129	2473
20180128	4호선	동작(현충원)	1150	1321	20180131	2471
20180128	경강선	초월	1198	1273	20180131	2471
20180121	수인선	신포	1275	1196	20180124	2471
20180211	공항철도 1호선	공덕	1088	1382	20180214	2470
20180129	경춘선	천마산	1316	1154	20180201	2470
20180125	3호선	지축	1137	1333	20180128	2470
20180128	9호선	사평	1170	1298	20180131	2468
20180203	수인선	인천	919	1548	20180206	2467
20180211	분당선	보정	1301	1161	20180214	2462
20180120	일산선	대곡	1348	1114	20180123	2462
20180114	수인선	인천	992	1470	20180117	2462
20180112	3호선	지축	1171	1290	20180115	2461
20180211	우이신설선	삼양	1206	1247	20180214	2453
20180128	6호선	버티고개	1169	1280	20180131	2449
20180128	우이신설선	삼양	1211	1229	20180131	2440
20180206	경강선	이매	1424	1014	20180209	2438
20180114	9호선	사평	1194	1244	20180117	2438
20180128	분당선	보정	1297	1135	20180131	2432
20180114	수인선	신포	1217	1208	20180117	2425
20180128	2호선	용두(동대문구청)	1196	1228	20180131	2424
20180204	6호선	버티고개	1232	1190	20180207	2422
20180127	분당선	구룡	1288	1130	20180130	2418
20180125	장항선	봉명	1216	1202	20180128	2418
20180124	일산선	대곡	1404	1014	20180127	2418
20180128	경원선	덕계	1218	1195	20180131	2413
20180204	경의선	효창공원앞	1138	1273	20180207	2411
20180205	수인선	인천	897	1512	20180208	2409
20180203	수인선	남동인더스파크	1241	1167	20180206	2408
20180113	9호선	동작(현충원)	1342	1064	20180116	2406
20180120	7호선	장암	1523	882	20180123	2405
20180212	경춘선	춘천	1245	1154	20180215	2399
20180120	우이신설선	신설동	1168	1231	20180123	2399
20180120	중앙선	양원	1205	1194	20180123	2399
20180130	경춘선	춘천	1259	1138	20180202	2397
20180123	경강선	이매	1431	965	20180126	2396
20180120	우이신설선	보문	1219	1174	20180123	2393
20180129	경강선	이매	1414	976	20180201	2390
20180211	경부선	광명	1403	986	20180214	2389
20180128	공항철도 1호선	공덕	1010	1378	20180131	2388
20180124	경춘선	천마산	1232	1155	20180127	2387
20180205	경춘선	춘천	1236	1150	20180208	2386
20180128	경의선	강매	1215	1170	20180131	2385
20180207	수인선	인천	845	1538	20180210	2383
20180120	수인선	남동인더스파크	1204	1177	20180123	2381
20180113	경춘선	천마산	1266	1115	20180116	2381
20180125	경춘선	천마산	1249	1121	20180128	2370
20180204	경원선	덕계	1194	1175	20180207	2369
20180112	경강선	이매	1421	944	20180115	2365
20180126	경강선	이매	1403	961	20180129	2364
20180126	장항선	봉명	1228	1135	20180129	2363
20180114	2호선	용두(동대문구청)	1169	1191	20180117	2360
20180119	장항선	배방	1251	1099	20180122	2350
20180126	3호선	지축	1079	1269	20180129	2348
20180121	경의선	수색	1142	1205	20180124	2347
20180120	경춘선	금곡	1208	1137	20180123	2345
20180115	장항선	신창(순천향대)	1134	1210	20180118	2344
20180211	5호선	동대문역사문화공원	1071	1271	20180214	2342
20180203	9호선	동작(현충원)	1340	1002	20180206	2342
20180126	경춘선	춘천	1265	1068	20180129	2333
20180113	경강선	삼동	1263	1068	20180116	2331
20180124	경강선	이매	1383	947	20180127	2330
20180211	경원선	덕계	1215	1112	20180214	2327
20180204	경의선	강매	1160	1167	20180207	2327
20180127	우이신설선	보문	1150	1176	20180130	2326
20180113	7호선	장암	1461	864	20180116	2325
20180203	7호선	장암	1507	816	20180206	2323
20180121	장항선	신창(순천향대)	1101	1219	20180124	2320
20180128	수인선	인천	931	1384	20180131	2315
20180112	수인선	인천	838	1477	20180115	2315
20180113	일산선	대곡	1257	1057	20180116	2314
20180129	수인선	인천	849	1463	20180201	2312
20180125	경강선	이매	1348	964	20180128	2312
20180128	중앙선	양수	1188	1123	20180131	2311
20180203	경의선	화전	1238	1072	20180206	2310
20180113	우이신설선	신설동	1143	1167	20180116	2310
20180127	경원선	응봉	1264	1045	20180130	2309
20180128	장항선	신창(순천향대)	1165	1143	20180131	2308
20180204	경의선	디지털미디어시티	1191	1113	20180207	2304
20180203	경부선	진위	1239	1063	20180206	2302
20180127	경의선	화전	1323	974	20180130	2297
20180124	3호선	지축	1036	1259	20180127	2295
20180211	4호선	동작(현충원)	1077	1208	20180214	2285
20180121	안산선	신길온천	1162	1123	20180124	2285
20180127	수인선	인천	844	1439	20180130	2283
20180121	9호선	동작(현충원)	1240	1042	20180124	2282
20180122	장항선	신창(순천향대)	1073	1207	20180125	2280
20180113	중앙선	양원	1146	1131	20180116	2277
20180211	수인선	인천	867	1407	20180214	2274
20180127	경부선	서동탄	1155	1119	20180130	2274
20180120	2호선	신답	1150	1123	20180123	2273
20180114	9호선	동작(현충원)	1232	1041	20180117	2273
20180113	2호선	신답	1101	1165	20180116	2266
20180203	우이신설선	신설동	1073	1191	20180206	2264
20180113	수인선	남동인더스파크	1186	1076	20180116	2262
20180128	경의선	디지털미디어시티	1117	1143	20180131	2260
20180207	경춘선	춘천	1159	1100	20180210	2259
20180120	경강선	삼동	1253	1005	20180123	2258
20180211	경의선	수색	1120	1137	20180214	2257
20180119	경의선	파주	1351	901	20180122	2252
20180211	경의선	디지털미디어시티	1126	1125	20180214	2251
20180203	경춘선	금곡	1184	1066	20180206	2250
20180126	경춘선	천마산	1230	1020	20180129	2250
20180129	장항선	신창(순천향대)	1123	1122	20180201	2245
20180114	경춘선	갈매	1168	1072	20180117	2240
20180203	중앙선	양원	1121	1106	20180206	2227
20180123	수인선	인천	820	1407	20180126	2227
20180127	9호선	동작(현충원)	1237	989	20180130	2226
20180121	경의선	서울역	1177	1049	20180124	2226
20180120	장항선	배방	1191	1029	20180123	2220
20180203	일산선	대곡	1265	952	20180206	2217
20180120	중앙선	팔당	1124	1089	20180123	2213
20180114	안산선	신길온천	1118	1094	20180117	2212
20180203	경춘선	천마산	1174	1035	20180206	2209
20180131	장항선	신창(순천향대)	1120	1082	20180203	2202
20180203	경강선	삼동	1175	1021	20180206	2196
20180121	경부선	서동탄	1086	1108	20180124	2194
20180122	경의선	파주	1316	866	20180125	2182
20180212	장항선	신창(순천향대)	1061	1120	20180215	2181
20180120	3호선	지축	1066	1115	20180123	2181
20180121	경원선	응봉	1147	1028	20180124	2175
20180121	경춘선	갈매	1136	1035	20180124	2171
20180127	수인선	남동인더스파크	1114	1052	20180130	2166
20180120	장항선	봉명	1107	1057	20180123	2164
20180203	2호선	신답	1069	1093	20180206	2162
20180126	장항선	신창(순천향대)	1229	933	20180129	2162
20180114	경부선	서동탄	1089	1071	20180117	2160
20180127	중앙선	양원	1102	1057	20180130	2159
20180128	경춘선	갈매	1165	993	20180131	2158
20180114	중앙선	팔당	1063	1095	20180117	2158
20180204	우이신설선	보문	1032	1123	20180207	2155
20180126	수인선	인천	786	1366	20180129	2152
20180121	중앙선	팔당	1120	1031	20180124	2151
20180204	수인선	신포	1106	1044	20180207	2150
20180204	경의선	수색	1071	1078	20180207	2149
20180119	경강선	신둔도예촌	1154	994	20180122	2148
20180114	경의선	수색	1084	1064	20180117	2148
20180206	수인선	인천	800	1347	20180209	2147
20180113	경춘선	금곡	1124	1018	20180116	2142
20180123	경의선	파주	1227	908	20180126	2135
20180121	경춘선	천마산	1083	1048	20180124	2131
20180115	경의선	파주	1233	896	20180118	2129
20180114	경원선	응봉	1073	1052	20180117	2125
20180119	경부선	직산	1050	1073	20180122	2123
20180114	경부선	진위	1055	1068	20180117	2123
20180130	과천선	경마공원	1046	1076	20180202	2122
20180211	경춘선	갈매	1118	998	20180214	2116
20180203	장항선	신창(순천향대)	1111	1002	20180206	2113
20180117	장항선	신창(순천향대)	1076	1037	20180120	2113
20180113	장항선	신창(순천향대)	1125	986	20180116	2111
20180117	경의선	파주	1210	900	20180120	2110
20180208	경강선	신둔도예촌	1100	1006	20180211	2106
20180120	경의선	파주	1301	803	20180123	2104
20180114	경의선	서울역	1093	1006	20180117	2099
20180204	5호선	동대문역사문화공원	973	1125	20180207	2098
20180127	우이신설선	신설동	1020	1076	20180130	2096
20180127	경부선	진위	1155	934	20180130	2089
20180114	장항선	신창(순천향대)	968	1117	20180117	2085
20180127	경강선	삼동	1122	961	20180130	2083
20180206	경춘선	춘천	1074	1005	20180209	2079
20180211	수인선	신포	1074	1001	20180214	2075
20180131	경의선	파주	1218	848	20180203	2066
20180125	수인선	인천	749	1317	20180128	2066
20180128	경의선	수색	1015	1048	20180131	2063
20180112	경부선	직산	1036	1027	20180115	2063
20180127	경춘선	천마산	1077	985	20180130	2062
20180128	수인선	신포	1062	995	20180131	2057
20180212	경의선	파주	1267	788	20180215	2055
20180211	우이신설선	보문	992	1062	20180214	2054
20180114	우이신설선	보문	1029	1023	20180117	2052
20180118	장항선	신창(순천향대)	1044	1004	20180121	2048
20180112	장항선	배방	1163	882	20180115	2045
20180204	4호선	동작(현충원)	985	1055	20180207	2040
20180121	우이신설선	보문	1038	1002	20180124	2040
20180113	장항선	봉명	1043	997	20180116	2040
20180118	경의선	파주	1216	820	20180121	2036
20180114	경춘선	천마산	1009	1026	20180117	2035
20180204	분당선	구룡	997	1036	20180207	2033
20180211	안산선	신길온천	1066	966	20180214	2032
20180211	분당선	구룡	1010	1018	20180214	2028
20180121	분당선	구룡	1007	1019	20180124	2026
20180124	경춘선	춘천	1086	939	20180127	2025
20180113	경의선	파주	1313	708	20180116	2021
20180205	장항선	신창(순천향대)	998	1021	20180208	2019
20180208	중앙선	국수	1050	967	20180211	2017
20180114	분당선	구룡	988	1028	20180117	2016
20180131	장항선	배방	1030	976	20180203	2006
20180128	분당선	구룡	984	1022	20180131	2006
20180121	경부선	진위	996	1010	20180124	2006
20180113	장항선	배방	1049	957	20180116	2006
20180115	장항선	배방	996	1008	20180118	2004
20180118	장항선	배방	1017	986	20180121	2003
20180201	경의선	파주	1206	796	20180204	2002
20180125	장항선	신창(순천향대)	1049	953	20180128	2002
20180204	경춘선	갈매	1048	953	20180207	2001
20180204	4호선	남태령	1228	771	20180207	1999
20180128	우이신설선	보문	1001	997	20180131	1998
20180113	3호선	지축	920	1073	20180116	1993
20180121	경의선	화전	952	1039	20180124	1991
20180121	5호선	동대문역사문화공원	936	1055	20180124	1991
20180128	안산선	신길온천	1037	951	20180131	1988
20180128	경원선	응봉	1004	980	20180131	1984
20180122	경강선	신둔도예촌	1037	947	20180125	1984
20180208	경의선	파주	1207	776	20180211	1983
20180122	장항선	배방	1010	973	20180125	1983
20180120	경부선	직산	1062	917	20180123	1979
20180112	경의선	파주	1203	771	20180115	1974
20180204	장항선	신창(순천향대)	942	1026	20180207	1968
20180114	경의선	화전	937	1030	20180117	1967
20180131	경강선	신둔도예촌	1028	936	20180203	1964
20180124	수인선	인천	687	1277	20180127	1964
20180204	수인선	인천	749	1214	20180207	1963
20180128	경의선	화전	900	1062	20180131	1962
20180125	경춘선	춘천	1026	935	20180128	1961
20180115	과천선	경마공원	999	958	20180118	1957
20180121	우이신설선	신설동	941	1012	20180124	1953
20180127	2호선	신답	953	999	20180130	1952
20180208	장항선	신창(순천향대)	977	973	20180211	1950
20180117	장항선	배방	1030	919	20180120	1949
20180117	경의선	신촌	831	1116	20180120	1947
20180114	5호선	동대문역사문화공원	914	1033	20180117	1947
20180206	과천선	경마공원	960	985	20180209	1945
20180203	장항선	봉명	995	950	20180206	1945
20180127	일산선	대곡	1055	889	20180130	1944
20180125	경의선	파주	1141	803	20180128	1944
20180203	중앙선	팔당	991	952	20180206	1943
20180211	9호선	동작(현충원)	1075	865	20180214	1940
20180118	경강선	신둔도예촌	1014	925	20180121	1939
20180207	경의선	파주	1184	752	20180210	1936
20180203	3호선	지축	891	1045	20180206	1936
20180203	경춘선	대성리	837	1099	20180206	1936
20180128	5호선	동대문역사문화공원	898	1038	20180131	1936
20180207	경강선	신둔도예촌	1025	910	20180210	1935
20180112	경강선	신둔도예촌	1042	893	20180115	1935
20180123	과천선	경마공원	957	977	20180126	1934
20180122	경부선	직산	913	1019	20180125	1932
20180121	경춘선	금곡	973	959	20180124	1932
20180211	경원선	응봉	979	952	20180214	1931
20180122	경의선	신촌	853	1076	20180125	1929
20180201	장항선	신창(순천향대)	985	941	20180204	1926
20180211	경부선	서동탄	963	962	20180214	1925
20180115	경강선	신둔도예촌	1021	904	20180118	1925
20180114	우이신설선	신설동	928	997	20180117	1925
20180203	경강선	이매	1205	717	20180206	1922
20180120	경강선	신둔도예촌	988	934	20180123	1922
20180204	경의선	서울역	971	949	20180207	1920
20180129	경강선	신둔도예촌	1019	899	20180201	1918
20180211	7호선	장암	1152	764	20180214	1916
20180201	경강선	신둔도예촌	999	917	20180204	1916
20180113	경강선	이매	1211	702	20180116	1913
20180117	경강선	신둔도예촌	1000	909	20180120	1909
20180121	7호선	장암	1180	728	20180124	1908
20180207	장항선	신창(순천향대)	994	913	20180210	1907
20180117	경부선	직산	928	977	20180120	1905
20180128	경부선	진위	931	964	20180131	1895
20180115	경부선	직산	874	1021	20180118	1895
20180130	경의선	신촌	834	1058	20180202	1892
20180211	4호선	남태령	1175	715	20180214	1890
20180128	경의선	서울역	1021	868	20180131	1889
20180212	과천선	경마공원	962	924	20180215	1886
20180127	장항선	신창(순천향대)	1023	863	20180130	1886
20180208	경의선	신촌	763	1118	20180211	1881
20180131	경부선	직산	912	969	20180203	1881
20180212	경의선	신촌	774	1105	20180215	1879
20180211	경춘선	천마산	943	935	20180214	1878
20180206	경의선	파주	1161	717	20180209	1878
20180205	경의선	파주	1128	745	20180208	1873
20180203	경의선	파주	1171	702	20180206	1873
20180204	9호선	동작(현충원)	1054	818	20180207	1872
20180119	경의선	신촌	747	1125	20180122	1872
20180115	경의선	신촌	792	1080	20180118	1872
20180207	경의선	신촌	796	1073	20180210	1869
20180130	경강선	신둔도예촌	1004	864	20180202	1868
20180127	7호선	장암	1177	691	20180130	1868
20180128	경부선	서동탄	924	943	20180131	1867
20180121	수인선	남동인더스파크	939	928	20180124	1867
20180211	중앙선	팔당	945	919	20180214	1864
20180204	경부선	서동탄	976	887	20180207	1863
20180129	경의선	파주	1081	781	20180201	1862
20180127	장항선	배방	998	863	20180130	1861
20180120	경강선	이매	1209	651	20180123	1860
20180113	중앙선	팔당	937	919	20180116	1856
20180121	일산선	대곡	1021	834	20180124	1855
20180118	경의선	신촌	789	1065	20180121	1854
20180126	경강선	신둔도예촌	995	858	20180129	1853
20180212	경강선	신둔도예촌	986	863	20180215	1849
20180123	장항선	신창(순천향대)	915	933	20180126	1848
20180122	과천선	경마공원	919	924	20180125	1843
20180118	경부선	직산	878	965	20180121	1843
20180128	경춘선	천마산	920	920	20180131	1840
20180131	경의선	신촌	749	1090	20180203	1839
20180208	장항선	배방	925	913	20180211	1838
20180206	장항선	신창(순천향대)	913	925	20180209	1838
20180129	장항선	배방	921	917	20180201	1838
20180211	경의선	서울역	868	969	20180214	1837
20180204	경원선	응봉	929	905	20180207	1834
20180128	9호선	동작(현충원)	983	850	20180131	1833
20180127	경춘선	대성리	743	1086	20180130	1829
20180113	경부선	직산	968	861	20180116	1829
20180126	경부선	직산	923	899	20180129	1822
20180211	경의선	화전	873	948	20180214	1821
20180127	경의선	파주	1140	679	20180130	1819
20180205	경의선	신촌	719	1099	20180208	1818
20180201	경부선	직산	885	932	20180204	1817
20180130	경의선	파주	1074	743	20180202	1817
20180121	중앙선	양원	858	958	20180124	1816
20180205	경강선	신둔도예촌	959	856	20180208	1815
20180125	경강선	신둔도예촌	942	863	20180128	1805
20180201	장항선	배방	927	875	20180204	1802
20180114	장항선	배방	759	1042	20180117	1801
20180114	4호선	남태령	1121	678	20180117	1799
20180126	경의선	파주	1092	705	20180129	1797
20180123	경강선	신둔도예촌	947	849	20180126	1796
20180206	경강선	신둔도예촌	986	808	20180209	1794
20180128	중앙선	팔당	930	864	20180131	1794
20180129	과천선	경마공원	907	886	20180201	1793
20180112	경의선	신촌	701	1092	20180115	1793
20180204	경춘선	천마산	916	875	20180207	1791
20180212	장항선	배방	889	901	20180215	1790
20180130	장항선	신창(순천향대)	916	874	20180202	1790
20180114	경강선	이매	1150	638	20180117	1788
20180114	장항선	봉명	886	902	20180117	1788
20180201	중앙선	국수	917	864	20180204	1781
20180201	중앙선	양정	933	844	20180204	1777
20180203	장항선	배방	958	818	20180206	1776
20180121	4호선	남태령	1117	659	20180124	1776
20180204	중앙선	팔당	879	896	20180207	1775
20180201	경의선	신촌	705	1070	20180204	1775
20180131	중앙선	양정	938	837	20180203	1775
20180124	장항선	신창(순천향대)	904	871	20180127	1775
20180130	장항선	배방	902	866	20180202	1768
20180207	장항선	배방	909	857	20180210	1766
20180204	안산선	신길온천	898	868	20180207	1766
20180205	과천선	경마공원	916	847	20180208	1763
20180212	경부선	직산	837	924	20180215	1761
20180128	3호선	학여울	858	903	20180131	1761
20180113	경강선	신둔도예촌	925	834	20180116	1759
20180127	경춘선	금곡	912	844	20180130	1756
20180203	경강선	신둔도예촌	915	836	20180206	1751
20180127	경부선	직산	945	806	20180130	1751
20180114	7호선	장암	1116	634	20180117	1750
20180128	4호선	남태령	1094	654	20180131	1748
20180129	경부선	직산	817	929	20180201	1746
20180206	경의선	신촌	676	1069	20180209	1745
20180128	경춘선	금곡	915	830	20180131	1745
20180130	중앙선	양정	958	784	20180202	1742
20180128	우이신설선	신설동	842	896	20180131	1738
20180126	장항선	배방	950	788	20180129	1738
20180211	장항선	신창(순천향대)	870	867	20180214	1737
20180208	경부선	직산	846	890	20180211	1736
20180113	경춘선	대성리	752	984	20180116	1736
20180114	중앙선	양원	847	887	20180117	1734
20180120	경춘선	대성리	720	1010	20180123	1730
20180204	경의선	화전	842	883	20180207	1725
20180204	우이신설선	신설동	864	858	20180207	1722
20180127	장항선	봉명	886	835	20180130	1721
20180123	경부선	직산	839	881	20180126	1720
20180121	장항선	배방	776	944	20180124	1720
20180124	경의선	파주	1006	712	20180127	1718
20180131	중앙선	국수	914	803	20180203	1717
20180120	2호선	도림천	842	869	20180123	1711
20180114	경춘선	금곡	857	853	20180117	1710
20180130	경부선	직산	840	868	20180202	1708
20180128	중앙선	양원	838	865	20180131	1703
20180207	경부선	직산	838	860	20180210	1698
20180121	경부선	직산	779	918	20180124	1697
20180123	경의선	신촌	720	976	20180126	1696
20180127	경강선	이매	1079	613	20180130	1692
20180205	장항선	배방	845	846	20180208	1691
20180124	경강선	신둔도예촌	883	806	20180127	1689
20180121	경의선	파주	873	816	20180124	1689
20180204	경춘선	금곡	864	821	20180207	1685
20180121	2호선	신답	786	899	20180124	1685
20180121	경강선	이매	1087	598	20180124	1685
20180114	경부선	직산	771	914	20180117	1685
20180203	2호선	도림천	821	861	20180206	1682
20180129	경의선	신촌	686	992	20180201	1678
20180123	장항선	배방	843	830	20180126	1673
20180211	경부선	진위	839	826	20180214	1665
20180204	수인선	남동인더스파크	849	816	20180207	1665
20180128	7호선	장암	1052	613	20180131	1665
20180130	중앙선	국수	871	792	20180202	1663
20180203	경부선	직산	865	796	20180206	1661
20180121	장항선	봉명	830	830	20180124	1660
20180204	경부선	진위	837	820	20180207	1657
20180121	중앙선	운길산	826	830	20180124	1656
20180211	경강선	이매	1043	611	20180214	1654
20180128	장항선	배방	716	935	20180131	1651
20180114	일산선	대곡	943	707	20180117	1650
20180119	중앙선	양정	861	787	20180122	1648
20180114	경의선	파주	871	777	20180117	1648
20180211	우이신설선	신설동	811	833	20180214	1644
20180127	3호선	지축	776	868	20180130	1644
20180204	중앙선	양원	823	814	20180207	1637
20180128	경강선	이매	1078	558	20180131	1636
20180125	경의선	신촌	668	966	20180128	1634
20180114	경강선	삼동	889	744	20180117	1633
20180126	경의선	신촌	655	976	20180129	1631
20180128	수인선	남동인더스파크	798	827	20180131	1625
20180211	중앙선	양원	803	817	20180214	1620
20180206	장항선	배방	815	805	20180209	1620
20180205	경부선	직산	770	847	20180208	1617
20180207	중앙선	국수	868	746	20180210	1614
20180205	중앙선	국수	855	759	20180208	1614
20180114	2호선	신답	749	856	20180117	1605
20180204	경강선	이매	1026	577	20180207	1603
20180118	중앙선	양정	867	735	20180121	1602
20180115	중앙선	양정	842	758	20180118	1600
20180128	경의선	파주	834	761	20180131	1595
20180124	경의선	신촌	663	931	20180127	1594
20180114	수인선	남동인더스파크	772	822	20180117	1594
20180120	중앙선	운길산	795	798	20180123	1593
20180127	경강선	신둔도예촌	830	758	20180130	1588
20180204	장항선	배방	709	878	20180207	1587
20180204	7호선	장암	1035	549	20180207	1584
20180211	경춘선	금곡	785	797	20180214	1582
20180124	경부선	직산	791	788	20180127	1579
20180117	중앙선	양정	843	734	20180120	1577
20180211	일산선	대곡	869	707	20180214	1576
20180113	2호선	도림천	779	789	20180116	1568
20180127	중앙선	팔당	762	805	20180130	1567
20180208	중앙선	양정	840	721	20180211	1561
20180211	수인선	남동인더스파크	773	786	20180214	1559
20180124	장항선	배방	785	769	20180127	1554
20180204	일산선	대곡	879	672	20180207	1551
20180127	2호선	도림천	770	781	20180130	1551
20180204	경의선	파주	836	712	20180207	1548
20180211	장항선	봉명	740	802	20180214	1542
20180118	중앙선	국수	778	759	20180121	1537
20180205	중앙선	양정	822	711	20180208	1533
20180204	장항선	봉명	774	759	20180207	1533
20180125	경부선	직산	766	767	20180128	1533
20180211	경강선	삼동	828	697	20180214	1525
20180121	경강선	삼동	817	708	20180124	1525
20180114	중앙선	운길산	734	786	20180117	1520
20180207	중앙선	양정	812	707	20180210	1519
20180119	중앙선	팔당	770	749	20180122	1519
20180211	2호선	신답	722	792	20180214	1514
20180211	장항선	배방	683	831	20180214	1514
20180128	2호선	신답	715	798	20180131	1513
20180206	경부선	직산	711	798	20180209	1509
20180204	경부선	직산	713	796	20180207	1509
20180119	경춘선	신내	738	770	20180122	1508
20180204	경강선	삼동	795	711	20180207	1506
20180121	3호선	지축	712	794	20180124	1506
20180122	중앙선	국수	763	742	20180125	1505
20180125	장항선	배방	793	711	20180128	1504
20180128	일산선	대곡	833	670	20180131	1503
20180117	중앙선	국수	755	748	20180120	1503
20180115	중앙선	국수	763	740	20180118	1503
20180114	3호선	지축	702	801	20180117	1503
20180122	중앙선	양정	822	679	20180125	1501
20180212	중앙선	양정	794	706	20180215	1500
20180207	경춘선	신내	706	793	20180210	1499
20180206	중앙선	국수	796	703	20180209	1499
20180129	중앙선	양정	808	690	20180201	1498
20180208	경춘선	신내	692	804	20180211	1496
20180120	중앙선	국수	725	760	20180123	1485
20180211	경의선	파주	795	677	20180214	1472
20180128	경춘선	대성리	1093	379	20180131	1472
20180119	중앙선	국수	713	751	20180122	1464
20180118	경춘선	신내	711	744	20180121	1455
20180123	중앙선	양정	778	675	20180126	1453
20180128	경강선	삼동	766	681	20180131	1447
20180206	경춘선	신내	707	737	20180209	1444
20180211	경춘선	대성리	1061	382	20180214	1443
20180121	경강선	신둔도예촌	760	681	20180124	1441
20180206	중앙선	양정	765	666	20180209	1431
20180203	중앙선	국수	688	743	20180206	1431
20180117	경춘선	신내	679	747	20180120	1426
20180201	경춘선	신내	702	719	20180204	1421
20180122	경춘선	신내	692	726	20180125	1418
20180128	경부선	직산	652	760	20180131	1412
20180115	경춘선	신내	713	697	20180118	1410
20180211	경부선	직산	644	760	20180214	1404
20180212	중앙선	국수	702	701	20180215	1403
20180130	경춘선	신내	708	693	20180202	1401
20180125	중앙선	양정	730	669	20180128	1399
20180204	경강선	신둔도예촌	700	691	20180207	1391
20180128	장항선	봉명	674	713	20180131	1387
20180117	중앙선	팔당	708	678	20180120	1386
20180113	중앙선	운길산	698	685	20180116	1383
20180114	경강선	신둔도예촌	684	694	20180117	1378
20180119	중앙선	운길산	700	676	20180122	1376
20180205	경춘선	신내	650	725	20180208	1375
20180126	중앙선	양정	735	640	20180129	1375
20180131	중앙선	팔당	696	675	20180203	1371
20180122	중앙선	팔당	694	677	20180125	1371
20180131	경춘선	신내	659	711	20180203	1370
20180121	경춘선	대성리	914	451	20180124	1365
20180129	중앙선	국수	687	676	20180201	1363
20180212	경춘선	신내	700	659	20180215	1359
20180113	중앙선	국수	673	686	20180116	1359
20180126	경춘선	대성리	528	827	20180129	1355
20180118	중앙선	팔당	695	660	20180121	1355
20180208	중앙선	팔당	689	662	20180211	1351
20180112	중앙선	양정	724	625	20180115	1349
20180201	중앙선	팔당	674	672	20180204	1346
20180118	중앙선	운길산	711	635	20180121	1346
20180204	중앙선	운길산	689	656	20180207	1345
20180204	2호선	신답	627	713	20180207	1340
20180203	중앙선	운길산	697	643	20180206	1340
20180115	중앙선	팔당	685	655	20180118	1340
20180128	3호선	지축	595	738	20180131	1333
20180204	3호선	지축	594	737	20180207	1331
20180117	중앙선	운길산	714	616	20180120	1330
20180121	경춘선	강촌	774	551	20180124	1325
20180130	중앙선	팔당	681	642	20180202	1323
20180123	중앙선	국수	655	665	20180126	1320
20180114	경춘선	대성리	933	383	20180117	1316
20180118	중앙선	아신	677	637	20180121	1314
20180204	경춘선	대성리	969	344	20180207	1313
20180124	중앙선	양정	715	595	20180127	1310
20180120	경춘선	강촌	591	710	20180123	1301
20180211	중앙선	운길산	661	637	20180214	1298
20180211	3호선	지축	612	680	20180214	1292
20180119	중앙선	아신	648	635	20180122	1283
20180203	경춘선	강촌	558	722	20180206	1280
20180119	경춘선	대성리	581	698	20180122	1279
20180211	경강선	신둔도예촌	658	616	20180214	1274
20180117	중앙선	아신	616	653	20180120	1269
20180115	중앙선	아신	663	606	20180118	1269
20180114	경춘선	강촌	738	529	20180117	1267
20180128	중앙선	운길산	667	593	20180131	1260
20180112	중앙선	국수	644	614	20180115	1258
20180123	중앙선	팔당	625	626	20180126	1251
20180122	중앙선	아신	648	602	20180125	1250
20180129	경춘선	신내	632	607	20180201	1239
20180115	중앙선	운길산	640	589	20180118	1229
20180207	중앙선	팔당	620	608	20180210	1228
20180123	경춘선	신내	612	614	20180126	1226
20180212	중앙선	팔당	613	610	20180215	1223
20180120	중앙선	양정	644	577	20180123	1221
20180122	중앙선	운길산	662	558	20180125	1220
20180211	중앙선	국수	615	602	20180214	1217
20180128	경강선	신둔도예촌	626	586	20180131	1212
20180126	중앙선	국수	597	611	20180129	1208
20180204	경춘선	강촌	702	502	20180207	1204
20180120	중앙선	아신	623	575	20180123	1198
20180112	경춘선	신내	562	631	20180115	1193
20180203	중앙선	양정	628	559	20180206	1187
20180131	중앙선	운길산	637	547	20180203	1184
20180119	경의선	곡산	593	587	20180122	1180
20180127	중앙선	국수	584	595	20180130	1179
20180124	중앙선	국수	583	596	20180127	1179
20180121	중앙선	국수	589	588	20180124	1177
20180117	경의선	곡산	601	572	20180120	1173
20180131	중앙선	아신	596	572	20180203	1168
20180208	경의선	곡산	574	589	20180211	1163
20180201	중앙선	아신	567	595	20180204	1162
20180112	경춘선	대성리	497	664	20180115	1161
20180115	경의선	곡산	596	564	20180118	1160
20180211	경춘선	강촌	645	514	20180214	1159
20180114	중앙선	국수	576	580	20180117	1156
20180126	경춘선	신내	558	597	20180129	1155
20180118	경의선	곡산	575	579	20180121	1154
20180205	중앙선	팔당	592	561	20180208	1153
20180201	경춘선	대성리	517	636	20180204	1153
20180203	중앙선	아신	571	580	20180206	1151
20180129	중앙선	아신	579	564	20180201	1143
20180125	중앙선	국수	579	564	20180128	1143
20180208	중앙선	아신	577	565	20180211	1142
20180212	중앙선	아신	578	561	20180215	1139
20180201	경의선	곡산	582	554	20180204	1136
20180204	중앙선	국수	574	561	20180207	1135
20180201	중앙선	운길산	600	535	20180204	1135
20180112	중앙선	팔당	581	554	20180115	1135
20180113	경춘선	강촌	478	651	20180116	1129
20180130	중앙선	아신	557	568	20180202	1125
20180128	경춘선	강촌	620	505	20180131	1125
20180123	중앙선	아신	569	556	20180126	1125
20180206	중앙선	아신	562	552	20180209	1114
20180127	중앙선	운길산	593	521	20180130	1114
20180208	중앙선	운길산	583	530	20180211	1113
20180125	경춘선	신내	577	536	20180128	1113
20180212	경의선	곡산	564	547	20180215	1111
20180124	중앙선	아신	567	544	20180127	1111
20180121	경춘선	김유정	538	570	20180124	1108
20180117	경춘선	대성리	546	562	20180120	1108
20180207	중앙선	아신	556	551	20180210	1107
20180129	중앙선	팔당	548	558	20180201	1106
20180206	중앙선	팔당	571	532	20180209	1103
20180120	경춘선	신내	564	536	20180123	1100
20180113	중앙선	양정	603	495	20180116	1098
20180126	중앙선	팔당	568	529	20180129	1097
20180118	경춘선	대성리	543	553	20180121	1096
20180128	중앙선	국수	538	557	20180131	1095
20180120	경춘선	김유정	554	541	20180123	1095
20180130	중앙선	운길산	562	531	20180202	1093
20180124	경춘선	신내	516	575	20180127	1091
20180130	경의선	곡산	550	535	20180202	1085
20180113	중앙선	아신	546	532	20180116	1078
20180122	경의선	곡산	537	535	20180125	1072
20180205	중앙선	아신	552	519	20180208	1071
20180112	중앙선	아신	541	518	20180115	1059
20180131	경의선	곡산	513	543	20180203	1056
20180123	경의선	곡산	531	524	20180126	1055
20180206	중앙선	운길산	577	476	20180209	1053
20180125	중앙선	팔당	537	516	20180128	1053
20180130	경춘선	대성리	633	415	20180202	1048
20180120	중앙선	원덕	515	533	20180123	1048
20180112	중앙선	운길산	550	491	20180115	1041
20180207	중앙선	운길산	546	487	20180210	1033
20180122	경춘선	대성리	514	510	20180125	1024
20180124	중앙선	팔당	513	510	20180127	1023
20180205	경의선	곡산	530	491	20180208	1021
20180126	중앙선	아신	514	507	20180129	1021
20180129	경춘선	대성리	452	566	20180201	1018
20180212	중앙선	운길산	536	479	20180215	1015
20180125	중앙선	아신	490	520	20180128	1010
20180120	경의선	신촌	462	539	20180123	1001
20180206	경의선	곡산	504	495	20180209	999
20180123	중앙선	운길산	548	451	20180126	999
20180211	경춘선	김유정	501	497	20180214	998
20180112	경의선	곡산	515	483	20180115	998
20180205	중앙선	운길산	520	467	20180208	987
20180121	중앙선	아신	509	478	20180124	987
20180207	경의선	곡산	488	498	20180210	986
20180124	경의선	곡산	498	486	20180127	984
20180129	중앙선	운길산	516	467	20180201	983
20180120	경춘선	백양리	495	484	20180123	979
20180113	경춘선	신내	477	500	20180116	977
20180127	중앙선	양정	555	418	20180130	973
20180206	경춘선	대성리	468	501	20180209	969
20180131	경춘선	대성리	490	477	20180203	967
20180204	중앙선	아신	482	484	20180207	966
20180208	경춘선	강촌	477	484	20180211	961
20180212	경춘선	대성리	488	470	20180215	958
20180113	경의선	신촌	446	508	20180116	954
20180119	중앙선	원덕	445	505	20180122	950
20180118	중앙선	원덕	483	465	20180121	948
20180207	경춘선	대성리	534	413	20180210	947
20180205	경춘선	대성리	475	466	20180208	941
20180208	경춘선	대성리	474	465	20180211	939
20180114	경춘선	김유정	461	478	20180117	939
20180115	경춘선	대성리	461	477	20180118	938
20180127	중앙선	아신	442	494	20180130	936
20180114	중앙선	아신	482	454	20180117	936
20180203	경춘선	신내	479	449	20180206	928
20180129	경의선	곡산	473	454	20180201	927
20180203	경춘선	김유정	435	489	20180206	924
20180113	경춘선	백양리	497	426	20180116	923
20180126	중앙선	운길산	483	438	20180129	921
20180113	중앙선	원덕	466	440	20180116	906
20180113	경춘선	김유정	447	457	20180116	904
20180125	경의선	곡산	452	448	20180128	900
20180122	중앙선	원덕	472	427	20180125	899
20180128	경춘선	김유정	465	431	20180131	896
20180125	중앙선	운길산	468	428	20180128	896
20180127	경춘선	강촌	407	488	20180130	895
20180211	2호선	도림천	418	471	20180214	889
20180203	경의선	신촌	412	475	20180206	887
20180126	경의선	곡산	438	446	20180129	884
20180123	경춘선	대성리	457	427	20180126	884
20180121	2호선	도림천	428	454	20180124	882
20180121	경춘선	백양리	509	370	20180124	879
20180117	중앙선	원덕	441	438	20180120	879
20180128	중앙선	아신	440	437	20180131	877
20180208	중앙선	원덕	436	434	20180211	870
20180203	경춘선	백양리	465	405	20180206	870
20180115	중앙선	원덕	448	422	20180118	870
20180121	중앙선	양정	505	363	20180124	868
20180114	2호선	도림천	431	434	20180117	865
20180119	경춘선	강촌	478	379	20180122	857
20180121	경춘선	신내	409	445	20180124	854
20180114	경춘선	신내	412	435	20180117	847
20180114	중앙선	원덕	456	388	20180117	844
20180114	중앙선	양정	487	357	20180117	844
20180121	중앙선	원덕	460	382	20180124	842
20180124	중앙선	운길산	452	389	20180127	841
20180127	경의선	신촌	367	466	20180130	833
20180204	2호선	도림천	368	458	20180207	826
20180119	경춘선	백양리	385	439	20180122	824
20180127	경춘선	신내	402	421	20180130	823
20180118	경춘선	강촌	427	395	20180121	822
20180119	중앙선	오빈	417	400	20180122	817
20180119	경춘선	김유정	398	415	20180122	813
20180211	중앙선	아신	422	388	20180214	810
20180128	중앙선	양정	464	344	20180131	808
20180127	경춘선	백양리	404	403	20180130	807
20180204	중앙선	양정	448	354	20180207	802
20180113	중앙선	오빈	418	383	20180116	801
20180211	중앙선	양정	436	364	20180214	800
20180207	중앙선	원덕	424	376	20180210	800
20180128	경춘선	신내	395	403	20180131	798
20180120	경춘선	상천	357	440	20180123	797
20180122	경춘선	백양리	459	337	20180125	796
20180211	경춘선	신내	401	391	20180214	792
20180121	경의선	신촌	381	411	20180124	792
20180120	경의선	곡산	401	390	20180123	791
20180118	경춘선	김유정	398	393	20180121	791
20180128	2호선	도림천	354	435	20180131	789
20180122	중앙선	오빈	405	383	20180125	788
20180205	중앙선	원덕	389	398	20180208	787
20180125	경춘선	대성리	336	451	20180128	787
20180130	중앙선	원덕	418	367	20180202	785
20180201	중앙선	원덕	401	378	20180204	779
20180112	중앙선	오빈	374	404	20180115	778
20180211	경춘선	백양리	402	371	20180214	773
20180123	중앙선	오빈	396	376	20180126	772
20180212	경춘선	백양리	421	343	20180215	764
20180204	경춘선	김유정	387	376	20180207	763
20180112	중앙선	원덕	374	389	20180115	763
20180203	중앙선	원덕	365	396	20180206	761
20180118	중앙선	오빈	374	387	20180121	761
20180117	경춘선	김유정	369	392	20180120	761
20180128	경춘선	백양리	428	324	20180131	752
20180201	경춘선	강촌	348	402	20180204	750
20180117	경춘선	강촌	395	355	20180120	750
20180117	중앙선	오빈	378	369	20180120	747
20180131	경춘선	강촌	433	313	20180203	746
20180121	경춘선	상천	464	282	20180124	746
20180130	중앙선	오빈	367	375	20180202	742
20180114	경춘선	상천	453	289	20180117	742
20180212	중앙선	원덕	383	357	20180215	740
20180118	경춘선	백양리	399	340	20180121	739
20180113	경의선	곡산	355	379	20180116	734
20180131	중앙선	원덕	365	364	20180203	729
20180122	경춘선	강촌	395	334	20180125	729
20180114	경춘선	백양리	436	293	20180117	729
20180204	경춘선	신내	347	381	20180207	728
20180125	중앙선	오빈	363	362	20180128	725
20180124	중앙선	오빈	367	358	20180127	725
20180115	경춘선	강촌	357	364	20180118	721
20180130	경춘선	강촌	371	346	20180202	717
20180206	중앙선	원덕	363	351	20180209	714
20180129	중앙선	오빈	375	339	20180201	714
20180201	경춘선	김유정	344	369	20180204	713
20180203	경의선	곡산	365	347	20180206	712
20180115	경춘선	김유정	352	359	20180118	711
20180112	경춘선	백양리	382	326	20180115	708
20180211	경의선	신촌	330	377	20180214	707
20180130	경춘선	김유정	366	341	20180202	707
20180115	중앙선	오빈	371	335	20180118	706
20180211	중앙선	원덕	385	317	20180214	702
20180120	중앙선	오빈	342	355	20180123	697
20180129	경춘선	백양리	348	346	20180201	694
20180131	중앙선	오빈	354	338	20180203	692
20180126	중앙선	원덕	344	346	20180129	690
20180127	중앙선	원덕	337	350	20180130	687
20180122	경춘선	김유정	344	341	20180125	685
20180205	경춘선	백양리	356	326	20180208	682
20180115	경춘선	백양리	354	326	20180118	680
20180211	경춘선	상천	428	250	20180214	678
20180129	중앙선	원덕	352	325	20180201	677
20180201	중앙선	오빈	346	330	20180204	676
20180201	경춘선	상천	315	358	20180204	673
20180208	중앙선	오빈	354	318	20180211	672
20180205	경춘선	강촌	357	315	20180208	672
20180124	경춘선	대성리	375	295	20180127	670
20180128	경의선	신촌	315	349	20180131	664
20180114	경의선	곡산	352	311	20180117	663
20180204	경춘선	백양리	398	261	20180207	659
20180112	경춘선	강촌	292	364	20180115	656
20180114	경의선	신촌	308	347	20180117	655
20180212	경춘선	강촌	341	313	20180215	654
20180129	경춘선	강촌	371	278	20180201	649
20180130	경춘선	백양리	364	281	20180202	645
20180127	경의선	곡산	323	322	20180130	645
20180117	경춘선	백양리	373	271	20180120	644
20180203	경춘선	상천	312	325	20180206	637
20180121	경의선	곡산	324	311	20180124	635
20180204	경의선	신촌	336	298	20180207	634
20180204	중앙선	원덕	338	295	20180207	633
20180123	경춘선	김유정	306	326	20180126	632
20180126	경춘선	백양리	337	287	20180129	624
20180125	중앙선	원덕	326	298	20180128	624
20180128	경춘선	상천	378	245	20180131	623
20180123	중앙선	원덕	313	309	20180126	622
20180127	경춘선	김유정	298	323	20180130	621
20180112	경춘선	김유정	307	314	20180115	621
20180208	경춘선	김유정	324	296	20180211	620
20180128	중앙선	원덕	340	279	20180131	619
20180123	경춘선	강촌	339	280	20180126	619
20180126	경춘선	강촌	273	342	20180129	615
20180131	경춘선	김유정	310	303	20180203	613
20180206	경춘선	강촌	332	280	20180209	612
20180127	중앙선	오빈	304	306	20180130	610
20180208	경춘선	상천	304	300	20180211	604
20180120	경강선	세종대왕릉	306	298	20180123	604
20180212	경춘선	김유정	315	288	20180215	603
20180115	경춘선	상천	295	308	20180118	603
20180113	경춘선	상천	266	337	20180116	603
20180118	경춘선	상천	308	294	20180121	602
20180124	중앙선	원덕	303	297	20180127	600
20180205	중앙선	오빈	315	280	20180208	595
20180122	경춘선	상천	313	282	20180125	595
20180208	경춘선	백양리	299	294	20180211	593
20180129	경춘선	김유정	299	293	20180201	592
20180212	중앙선	오빈	308	281	20180215	589
20180119	경강선	세종대왕릉	291	298	20180122	589
20180207	경춘선	강촌	286	300	20180210	586
20180207	경춘선	백양리	307	277	20180210	584
20180113	경강선	세종대왕릉	298	285	20180116	583
20180128	중앙선	오빈	301	281	20180131	582
20180124	경춘선	백양리	329	250	20180127	579
20180207	중앙선	오빈	288	290	20180210	578
20180131	경춘선	상천	310	261	20180203	571
20180212	경춘선	상천	299	271	20180215	570
20180121	중앙선	오빈	298	272	20180124	570
20180119	경춘선	상천	281	289	20180122	570
20180203	중앙선	오빈	264	303	20180206	567
20180131	경춘선	백양리	301	266	20180203	567
20180123	경춘선	백양리	294	269	20180126	563
20180117	경춘선	상천	285	272	20180120	557
20180203	경강선	세종대왕릉	272	283	20180206	555
20180204	경춘선	상천	325	228	20180207	553
20180206	중앙선	오빈	278	272	20180209	550
20180127	경춘선	상천	242	304	20180130	546
20180130	경춘선	상천	267	277	20180202	544
20180124	경춘선	강촌	281	261	20180127	542
20180128	경의선	곡산	260	281	20180131	541
20180206	경춘선	백양리	302	236	20180209	538
20180206	경춘선	김유정	267	270	20180209	537
20180126	중앙선	오빈	266	266	20180129	532
20180125	경춘선	강촌	273	256	20180128	529
20180114	중앙선	오빈	276	251	20180117	527
20180207	경춘선	김유정	264	261	20180210	525
20180205	경춘선	상천	266	258	20180208	524
20180121	경강선	세종대왕릉	274	249	20180124	523
20180201	경춘선	백양리	244	278	20180204	522
20180126	경춘선	김유정	257	264	20180129	521
20180125	경춘선	김유정	255	254	20180128	509
20180212	경강선	세종대왕릉	269	237	20180215	506
20180204	경의선	곡산	280	223	20180207	503
20180206	경춘선	상천	254	246	20180209	500
20180125	경춘선	백양리	269	230	20180128	499
20180115	경강선	세종대왕릉	260	238	20180118	498
20180129	경춘선	상천	253	244	20180201	497
20180127	경강선	세종대왕릉	251	244	20180130	495
20180211	경의선	곡산	251	243	20180214	494
20180123	경춘선	상천	222	267	20180126	489
20180117	경강선	세종대왕릉	242	236	20180120	478
20180114	경춘선	굴봉산	283	192	20180117	475
20180118	경강선	세종대왕릉	244	225	20180121	469
20180203	경춘선	굴봉산	185	281	20180206	466
20180201	경강선	세종대왕릉	236	227	20180204	463
20180208	경강선	세종대왕릉	235	225	20180211	460
20180124	경춘선	김유정	224	236	20180127	460
20180129	경강선	세종대왕릉	236	223	20180201	459
20180131	경강선	세종대왕릉	242	215	20180203	457
20180122	경강선	세종대왕릉	242	214	20180125	456
20180126	경강선	세종대왕릉	232	221	20180129	453
20180204	중앙선	오빈	220	230	20180207	450
20180204	경강선	세종대왕릉	221	228	20180207	449
20180205	경춘선	김유정	218	230	20180208	448
20180123	경강선	세종대왕릉	236	212	20180126	448
20180114	경강선	세종대왕릉	240	208	20180117	448
20180112	경강선	세종대왕릉	224	224	20180115	448
20180207	경춘선	상천	225	222	20180210	447
20180128	경강선	세종대왕릉	241	204	20180131	445
20180130	경강선	세종대왕릉	234	206	20180202	440
20180125	경춘선	상천	234	205	20180128	439
20180112	경춘선	상천	222	211	20180115	433
20180113	경춘선	굴봉산	181	249	20180116	430
20180126	경춘선	상천	209	218	20180129	427
20180205	경강선	세종대왕릉	213	213	20180208	426
20180125	경강선	세종대왕릉	232	193	20180128	425
20180124	경춘선	상천	223	202	20180127	425
20180124	경강선	세종대왕릉	216	208	20180127	424
20180207	경강선	세종대왕릉	211	212	20180210	423
20180206	경강선	세종대왕릉	211	197	20180209	408
20180120	중앙선	신원	245	163	20180123	408
20180120	경춘선	굴봉산	158	246	20180123	404
20180208	중앙선	신원	204	194	20180211	398
20180121	경춘선	굴봉산	209	188	20180124	397
20180204	경춘선	굴봉산	239	157	20180207	396
20180128	경춘선	굴봉산	243	150	20180131	393
20180119	중앙선	신원	226	161	20180122	387
20180211	중앙선	오빈	193	193	20180214	386
20180211	경강선	세종대왕릉	208	177	20180214	385
20180115	중앙선	신원	190	186	20180118	376
20180117	중앙선	신원	195	173	20180120	368
20180211	경춘선	굴봉산	219	148	20180214	367
20180131	중앙선	신원	173	189	20180203	362
20180122	경춘선	굴봉산	189	171	20180125	360
20180118	중앙선	신원	185	174	20180121	359
20180203	중앙선	신원	193	164	20180206	357
20180127	경춘선	굴봉산	130	227	20180130	357
20180119	경춘선	굴봉산	177	178	20180122	355
20180117	경춘선	굴봉산	173	176	20180120	349
20180122	중앙선	신원	182	153	20180125	335
20180115	경춘선	굴봉산	148	185	20180118	333
20180201	중앙선	신원	171	159	20180204	330
20180123	중앙선	신원	148	181	20180126	329
20180130	중앙선	신원	168	158	20180202	326
20180123	경춘선	굴봉산	178	147	20180126	325
20180212	중앙선	신원	159	161	20180215	320
20180121	중앙선	신원	204	114	20180124	318
20180131	경춘선	굴봉산	142	174	20180203	316
20180212	경춘선	굴봉산	144	170	20180215	314
20180201	경춘선	굴봉산	159	155	20180204	314
20180129	중앙선	신원	153	160	20180201	313
20180206	중앙선	신원	162	149	20180209	311
20180118	경춘선	굴봉산	151	153	20180121	304
20180204	중앙선	신원	179	120	20180207	299
20180114	중앙선	신원	162	137	20180117	299
20180205	중앙선	신원	163	134	20180208	297
20180211	중앙선	신원	172	124	20180214	296
20180207	중앙선	신원	154	140	20180210	294
20180128	중앙선	신원	178	114	20180131	292
20180205	경춘선	굴봉산	126	163	20180208	289
20180129	경춘선	굴봉산	129	151	20180201	280
20180124	경춘선	굴봉산	143	132	20180127	275
20180113	중앙선	신원	142	133	20180116	275
20180112	경춘선	굴봉산	144	128	20180115	272
20180127	중앙선	신원	145	126	20180130	271
20180124	중앙선	신원	141	129	20180127	270
20180207	경춘선	굴봉산	155	110	20180210	265
20180125	중앙선	신원	135	130	20180128	265
20180125	경춘선	굴봉산	132	122	20180128	254
20180115	수인선	달월	155	95	20180118	250
20180112	중앙선	신원	121	124	20180115	245
20180126	중앙선	신원	135	109	20180129	244
20180126	경춘선	굴봉산	126	117	20180129	243
20180117	수인선	달월	153	89	20180120	242
20180119	수인선	달월	144	96	20180122	240
20180122	수인선	달월	148	83	20180125	231
20180206	경춘선	굴봉산	124	105	20180209	229
20180201	수인선	달월	144	80	20180204	224
20180131	수인선	달월	141	82	20180203	223
20180123	수인선	달월	132	91	20180126	223
20180208	경춘선	굴봉산	101	120	20180211	221
20180208	수인선	달월	141	79	20180211	220
20180112	수인선	달월	129	90	20180115	219
20180212	수인선	달월	137	79	20180215	216
20180129	수인선	달월	134	78	20180201	212
20180118	수인선	달월	131	80	20180121	211
20180130	경춘선	굴봉산	113	92	20180202	205
20180207	수인선	달월	130	74	20180210	204
20180205	수인선	달월	130	73	20180208	203
20180206	수인선	달월	123	76	20180209	199
20180124	수인선	달월	131	67	20180127	198
20180125	수인선	달월	123	72	20180128	195
20180126	수인선	달월	114	71	20180129	185
20180130	수인선	달월	119	65	20180202	184
20180120	수인선	달월	57	59	20180123	116
20180121	수인선	달월	55	55	20180124	110
20180113	수인선	달월	54	51	20180116	105
20180122	경원선	옥수	64	38	20180125	102
20180119	경원선	옥수	71	29	20180122	100
20180115	경원선	옥수	64	33	20180118	97
20180117	경원선	옥수	58	36	20180120	94
20180127	수인선	달월	44	49	20180130	93
20180122	중앙선	지평	54	38	20180125	92
20180123	경원선	옥수	47	40	20180126	87
20180208	중앙선	지평	50	35	20180211	85
20180130	경원선	옥수	53	32	20180202	85
20180126	경원선	옥수	60	24	20180129	84
20180118	경원선	옥수	51	31	20180121	82
20180113	경원선	옥수	44	38	20180116	82
20180112	경원선	옥수	56	25	20180115	81
20180203	수인선	달월	38	42	20180206	80
20180201	경원선	옥수	42	37	20180204	79
20180129	경원선	옥수	51	28	20180201	79
20180120	경원선	옥수	44	35	20180123	79
20180201	중앙선	지평	41	37	20180204	78
20180208	경원선	옥수	53	22	20180211	75
20180131	중앙선	지평	39	36	20180203	75
20180212	경원선	옥수	48	25	20180215	73
20180211	경원선	옥수	50	23	20180214	73
20180131	경원선	옥수	46	27	20180203	73
20180120	중앙선	지평	41	32	20180123	73
20180212	중앙선	지평	37	35	20180215	72
20180207	경원선	옥수	47	24	20180210	71
20180207	중앙선	지평	37	33	20180210	70
20180206	중앙선	지평	43	27	20180209	70
20180114	수인선	달월	29	41	20180117	70
20180205	중앙선	지평	35	34	20180208	69
20180126	중앙선	지평	36	32	20180129	68
20180124	경원선	옥수	44	24	20180127	68
20180123	중앙선	지평	37	31	20180126	68
20180115	중앙선	지평	36	32	20180118	68
20180127	경원선	옥수	43	24	20180130	67
20180205	경원선	옥수	33	32	20180208	65
20180204	수인선	달월	34	31	20180207	65
20180119	중앙선	지평	33	32	20180122	65
20180118	중앙선	지평	39	26	20180121	65
20180121	중앙선	지평	31	33	20180124	64
20180113	중앙선	지평	26	38	20180116	64
20180125	경원선	옥수	46	17	20180128	63
20180117	중앙선	지평	32	31	20180120	63
20180114	경원선	옥수	48	15	20180117	63
20180211	중앙선	지평	33	27	20180214	60
20180129	중앙선	지평	33	27	20180201	60
20180130	중앙선	지평	37	21	20180202	58
20180124	중앙선	지평	34	24	20180127	58
20180128	수인선	달월	30	27	20180131	57
20180125	중앙선	지평	34	23	20180128	57
20180203	경원선	옥수	39	17	20180206	56
20180206	경원선	옥수	32	22	20180209	54
20180112	중앙선	지평	32	22	20180115	54
20180204	경원선	옥수	42	11	20180207	53
20180203	중앙선	지평	26	27	20180206	53
20180127	중앙선	지평	23	29	20180130	52
20180114	중앙선	지평	28	23	20180117	51
20180121	경원선	옥수	40	10	20180124	50
20180211	수인선	달월	27	21	20180214	48
20180128	경원선	옥수	35	13	20180131	48
20180128	중앙선	지평	27	19	20180131	46
20180204	중앙선	지평	26	15	20180207	41
20180207	3호선	충무로	5	0	20180210	5
20180212	3호선	충무로	4	0	20180215	4
20180208	3호선	충무로	4	0	20180211	4
20180203	경의선	서울역	4	0	20180206	4
20180129	3호선	충무로	4	0	20180201	4
20180118	3호선	충무로	4	0	20180121	4
20180206	3호선	충무로	3	0	20180209	3
20180205	3호선	충무로	3	0	20180208	3
20180131	3호선	충무로	3	0	20180203	3
20180130	3호선	충무로	3	0	20180202	3
20180126	6호선	연신내	3	0	20180129	3
20180125	3호선	충무로	3	0	20180128	3
20180120	6호선	연신내	3	0	20180123	3
20180119	3호선	충무로	3	0	20180122	3
20180112	3호선	충무로	3	0	20180115	3
20180204	3호선	충무로	2	0	20180207	2
20180203	6호선	연신내	2	0	20180206	2
20180129	6호선	연신내	2	0	20180201	2
20180127	3호선	충무로	2	0	20180130	2
20180126	3호선	충무로	2	0	20180129	2
20180123	3호선	충무로	2	0	20180126	2
20180123	6호선	연신내	2	0	20180126	2
20180122	경의선	서울역	2	0	20180125	2
20180122	3호선	충무로	2	0	20180125	2
20180119	경의선	김포공항	2	0	20180122	2
20180118	경의선	검암	2	0	20180121	2
20180117	3호선	충무로	2	0	20180120	2
20180113	경의선	공덕	2	0	20180116	2
20180112	6호선	연신내	2	0	20180115	2
20180212	경원선	창동	1	0	20180215	1
20180212	경의선	서울역	1	0	20180215	1
20180212	경의선	김포공항	1	0	20180215	1
20180212	6호선	연신내	1	0	20180215	1
20180211	경의선	김포공항	1	0	20180214	1
20180208	경원선	창동	1	0	20180211	1
20180208	경의선	김포공항	1	0	20180211	1
20180208	경의선	계양	1	0	20180211	1
20180207	6호선	연신내	1	0	20180210	1
20180207	경의선	검암	1	0	20180210	1
20180207	경의선	서울역	1	0	20180210	1
20180206	경의선	김포공항	1	0	20180209	1
20180205	경의선	검암	1	0	20180208	1
20180205	경의선	서울역	1	0	20180208	1
20180204	6호선	연신내	1	0	20180207	1
20180203	3호선	충무로	1	0	20180206	1
20180201	6호선	연신내	1	0	20180204	1
20180201	경의선	서울역	1	0	20180204	1
20180201	3호선	충무로	1	0	20180204	1
20180131	경의선	김포공항	1	0	20180203	1
20180130	경의선	공덕	1	0	20180202	1
20180130	6호선	연신내	1	0	20180202	1
20180129	경의선	계양	1	0	20180201	1
20180128	3호선	충무로	1	0	20180131	1
20180127	경의선	김포공항	1	0	20180130	1
20180125	경의선	김포공항	1	0	20180128	1
20180124	3호선	충무로	1	0	20180127	1
20180124	경의선	검암	1	0	20180127	1
20180123	경의선	서울역	1	0	20180126	1
20180123	경의선	김포공항	1	0	20180126	1
20180123	경의선	계양	1	0	20180126	1
20180122	6호선	연신내	1	0	20180125	1
20180122	경의선	검암	1	0	20180125	1
20180121	3호선	충무로	1	0	20180124	1
20180121	경원선	창동	1	0	20180124	1
20180120	경의선	검암	1	0	20180123	1
20180120	3호선	충무로	1	0	20180123	1
20180119	6호선	연신내	1	0	20180122	1
20180118	6호선	연신내	1	0	20180121	1
20180118	경의선	공덕	1	0	20180121	1
20180115	경의선	검암	1	0	20180118	1
20180115	경의선	홍대입구	1	0	20180118	1
20180115	경원선	창동	1	0	20180118	1
20180115	3호선	충무로	1	0	20180118	1
20180114	경의선	김포공항	1	0	20180117	1
20180113	경의선	김포공항	1	0	20180116	1
20180113	경의선	서울역	1	0	20180116	1
